ACCEPT	OK
ACCE_ABSORB	Bonus absorpce
ACCE_COMBINE	Kombinovn
ACCE_MAIN	erpa 1
ACCE_RESULT	Vsledek
ACCE_SERVE	erpa 2
ATTACH_METIN_INFO	Pejete si pout kmen ducha?
ATTACH_METIN_TITLE	Pout kmen ducha
ATTENDANCE_TITLE	Udlost Boss Reaper
ATTR_67_ADD	Pidat bonus
ATTR_67_ADD_TITLE	Pidat bonus
ATTR_67_MATERIAL_SLOT_TITLE	Stepy sly
ATTR_67_REGIST_SLOT_TITLE	Clov pedmt
ATTR_67_SUPPORT_SLOT_TITLE	Psada
AURA_MAIN	Kostm s aurou
AURA_SUB	Materil
AUTO_AUTO_ATTACK	tok
AUTO_AUTO_POSITION	Lektvary
AUTO_AUTO_RANGE	Aut. zamen
AUTO_AUTO_SKILL	Schopnosti
AUTO_CLEAR	Smazat
AUTO_END	Stop
AUTO_OFF	Vyp.
AUTO_ON	Zap.
AUTO_POSITION_SETTING	Lektvary
AUTO_SAVE	Uloit
AUTO_SETTING	Nastaven
AUTO_SKILL_SETTING	Schopnosti
AUTO_START	Start
AUTO_TITLE	Automatick lov
BANNER_ATTENDANCE_BUTTON	Udlost Boss Reaper
BANNER_BLACK_AND_WHITE_BUTTON	Souboj vtc
BANNER_CATCHKING_BUTTON	Chy krle
BANNER_EASTER_BUTTON	VELIKONOCE
BANNER_FISH_BUTTON	RYBSK SKLDAKA
BANNER_FLOWER_BUTTON	SLA KVTIN
BANNER_FOOTBALL_BUTTON	FOTBAL
BANNER_HALLOWEEN_BUTTON	HALLOWEEN
BANNER_LUCKY_EVENT	LOV P͊ER
BANNER_MINIBOSS_BUTTON	Apokalypsa Zvrokruhu
BANNER_MINI_GAME_FINDM	MEMO TRIA P͊ER
BANNER_MONSTERBACK_BUTTON	Obnovit Body ivota
BANNER_MYSTERY_BOX_BUTTON	UDLOST KOIST I
BANNER_MYSTERY_BOX_BUTTON_2	UDLOST KOIST II
BANNER_NEW_XMAS_BUTTON	VNOCE
BANNER_OKEY_BUTTON	Udlost Okey
BANNER_OLYMPIC_BUTTON	HRDINA
BANNER_RAMADAN_BUTTON	RAMADAN
BANNER_ROULETTE_BUTTON	Krvav ritul
BANNER_SOUL_BUTTON	HONBA DU
BANNER_SUMMER_BUTTON	LETN AKCE
BANNER_VALENTINE_BUTTON	VALENTNSK SVTEK
BANNER_YUTNORI_BUTTON	Yutnori
BATTLE_FIELD_INFO	Bitevn zna
BATTLE_FIELD_OPERATION_TIME	Do bitevnch zn lze vstoupit mezi %s:00 a %s:00.
BATTLE_FIELD_OPERATION_TIME_ALL	Momentln oteveno pro vstup.
BATTLE_FIELD_OPERATION_TIME_END	Bitevn zna bude otevena jet %s hodin.
BATTLE_FIELD_OPERATION_TIME_NA	Momentln uzaveno pro vstup.
BATTLE_FIELD_OPERATION_TIME_OPEN	Pro vstup se oteve za %s hodin a bude otevena %s hodin.
BATTLE_FILED_RANK	Hodnost
BATTLE_FILED_RANK_EMPIRE	Krlovstv
BATTLE_FILED_RANK_NAME	Nzev
BATTLE_FILED_RANK_POINT	Body
BNW_GAME_UI_COM	Protivnk
BNW_RANK_UI_COUNT	Dary
BNW_RANK_UI_NAME	Jmno
BNW_RANK_UI_RANK	Umstn
CANCEL	Zruit
CHANGE_ATTR_SELECT	Zmnit bonus
CHANGE_PASSWORD_CONFIRM	Potvrdit nov heslo
CHANGE_PASSWORD_NEW	Nov heslo
CHANGE_PASSWORD_OLD	Star heslo
CHANGE_PASSWORD_TITLE	Zmna hesla
CHARACTER_ACTION	Akce
CHARACTER_EMOTICON	Emoce
CHARACTER_MAIN	Postava
CHARACTER_MUTUAL_ACTION	Interaktivn akce
CHARACTER_NORMAL_ACTION	Normln akce
CHARACTER_QUEST	kol
CHARACTER_SKILL	Schopnosti
CHARACTER_SPECTIAL_ACTION	Speciln akce
CHAT_FILTER	Filtr konverzace
CHAT_FILTER_DICE	Kostka
CLOSE	Zavt
COMB_APPEARANCE	Cl
COMB_ATTRIBUTE	Zdroj
COMB_MAIN	Cl
COMB_MATERIAL	Zdroj
COMB_SKILLBOOK_TILE	Obchodovat s knihami
COMB_TITLE	
COSTUME_TITLE	Kostmy
COSTUME_WINDOW_TITLE	Kostmy
CREATE_ATT_GRADE	SIL
CREATE_CREATE	Vytvoit
CREATE_DEX_GRADE	POH
CREATE_HP	VIT
CREATE_LAST_POINT	Body
CREATE_MAN	Mu
CREATE_NAME	Jmno
CREATE_NEXT	Dle
CREATE_PREV	Zpt
CREATE_SEX	Pohlav
CREATE_SHAPE	Vzhled
CREATE_SP	INT
CREATE_STAT_RESET	Zpt
CREATE_WOMAN	ena
CUBE_INFO_TITLE	Pruka zulechovn
CUBE_RENEWAL_BELT_IMPROVE	Zvit anci
CUBE_RENEWAL_TITLE	Zulechtn
CUBE_REQUIRE_MATERIAL	Poadovan materily
CUBE_REQUIRE_MATERIAL_OR	nebo
CUBE_TITLE	Okno zulechovn
CURRENT_POINT	Aktuln body: %s
CZ_REWARD_WINDOW_TITLE	Chrm Zvrokruhu
DO_CHANGE_ATTR	Pout
DO_REFINE	Zulechtit
DRAGONSOUL_ACTIVATE	Aktivovat
DRAGONSOUL_CHANGE_ATTR_WINDOW_TITLE	Zmna bonusu pro Mtick Dra kmen
DRAGONSOUL_PAGE_BUTTON_1	Surov
DRAGONSOUL_PAGE_BUTTON_2	Brouen
DRAGONSOUL_PAGE_BUTTON_3	Vzcn
DRAGONSOUL_PAGE_BUTTON_4	Starovk
DRAGONSOUL_PAGE_BUTTON_5	Legendrn
DRAGONSOUL_PAGE_BUTTON_6	Mtick
DRAGONSOUL_REFINE_WINDOW_TITLE	Okno zulechovn
DRAGONSOUL_TAP_TITLE_1	Dra diamant
DRAGONSOUL_TAP_TITLE_2	Dra rubn
DRAGONSOUL_TAP_TITLE_3	Dra nefrit
DRAGONSOUL_TAP_TITLE_4	Dra safr
DRAGONSOUL_TAP_TITLE_5	Dra grant
DRAGONSOUL_TAP_TITLE_6	Dra onyx
DRAGONSOUL_TITLE	Alchymie Drach kamen
DUTCHAUCTION_BUTTON	Jdi!
DUTCHAUCTION_TITLE	Bleskov aukce
EMPIRE_A	Shinsoo
EMPIRE_ALL	Vechna
EMPIRE_B	Chunjo
EMPIRE_C	Jinno
EMPIRE_EXIT	Ukonit
EMPIRE_NEXT	Dle
EMPIRE_PREV	Zpt
EMPIRE_SELECT	Zvolit
END_TIME	Aktivn udlost
ENTER_BATTLE_FIELD	Vstoupit
EVENT_ALARM_TITLE	Pehled udlosti
EVENT_NAME_TITLE	Nzev
EVENT_REWARD_TITLE	Odmna
EXCHANGE_ACCEPT	OK
EXCHANGE_TITLE	Obchodovn
EXIT_BATTLE_FIELD	Opravdu chce opustit bitevn znu?
EXIT_BATTLE_FIELD_ON_DEAD	Chce opustit bitevn znu s %d body?
EXPIRED_TIME	Udlost byla ukonena.
FISHING_RENEWAL_TITLE	Chytat ryby
FRAGMENT_COMB_TITLE	Kombinovat Knihy schopnost
GAMEOPTION_TITLE	Nastaven hry
GAME_EXIT_OBSERVER	Ukonit divck modus
GAME_GUILD_WAR_JOIN	Pidat se k vlce cech
GAME_HELP	Npovda
GAME_QUEST	koly
GAME_SKILL_UP	Zvit schopnost
GAME_STAT_UP	Zvit status
GEMSHOP_LEFTTIME	Zbvajc as
GEMSHOP_TITLA	GAYA TRIT
GRADE	Stupe
GRADE_SELECT	Stupe
GRAPHICONOFF_DROP_ITEM_APPLY	Pout
GRAPHICONOFF_DROP_ITEM_LEVEL	Padn pedmt
GRAPHICONOFF_DROP_ITEM_LEVEL1	1
GRAPHICONOFF_DROP_ITEM_LEVEL1_TOOLTIP	Zobrazit efekt & nzev
GRAPHICONOFF_DROP_ITEM_LEVEL2	2
GRAPHICONOFF_DROP_ITEM_LEVEL2_TOOLTIP	Skrt efekt
GRAPHICONOFF_DROP_ITEM_LEVEL3	3
GRAPHICONOFF_DROP_ITEM_LEVEL3_TOOLTIP	Skrt efekt & nzev
GRAPHICONOFF_DROP_ITEM_LEVEL4	4
GRAPHICONOFF_DROP_ITEM_LEVEL4_TOOLTIP	Skrt pedmty & zobrazit nzev na kurzor
GRAPHICONOFF_DROP_ITEM_LEVEL5	5
GRAPHICONOFF_DROP_ITEM_LEVEL5_TOOLTIP	Skrt pedmty & nzev
GRAPHICONOFF_EFFECT_APPLY	Pout
GRAPHICONOFF_EFFECT_LEVEL	Efekty
GRAPHICONOFF_EFFECT_LEVEL1	1
GRAPHICONOFF_EFFECT_LEVEL1_TOOLTIP	Zobrazit ve
GRAPHICONOFF_EFFECT_LEVEL2	2
GRAPHICONOFF_EFFECT_LEVEL2_TOOLTIP	Pouze efekty tv a per
GRAPHICONOFF_EFFECT_LEVEL3	3
GRAPHICONOFF_EFFECT_LEVEL3_TOOLTIP	Pouze efekty tv a ostatnch hr
GRAPHICONOFF_EFFECT_LEVEL4	4
GRAPHICONOFF_EFFECT_LEVEL4_TOOLTIP	Pouze tv
GRAPHICONOFF_EFFECT_LEVEL5	5
GRAPHICONOFF_EFFECT_LEVEL5_TOOLTIP	Skrt ve
GRAPHICONOFF_NPC_NAME_STATUS	Jmna NPC
GRAPHICONOFF_NPC_NAME_STATUS_OFF	Vyp.
GRAPHICONOFF_NPC_NAME_STATUS_OFF_TOOLTIP	Skrt jmna NPC
GRAPHICONOFF_NPC_NAME_STATUS_ON	Zap.
GRAPHICONOFF_NPC_NAME_STATUS_ON_TOOLTIP	Zobrazit jmna NPC
GRAPHICONOFF_PET_STATUS	Mazlci
GRAPHICONOFF_PET_STATUS_OFF	Vyp.
GRAPHICONOFF_PET_STATUS_OFF_TOOLTIP	Skrt mazlky
GRAPHICONOFF_PET_STATUS_ON	Zap.
GRAPHICONOFF_PET_STATUS_ON_TOOLTIP	Zobrazit mazlky
GRAPHICONOFF_PRIVATE_SHOP_APPLY	Pout
GRAPHICONOFF_PRIVATE_SHOP_LEVEL	Soukrom stnky
GRAPHICONOFF_PRIVATE_SHOP_LEVEL1	1
GRAPHICONOFF_PRIVATE_SHOP_LEVEL1_TOOLTIP	Zobrazit ve
GRAPHICONOFF_PRIVATE_SHOP_LEVEL2	2
GRAPHICONOFF_PRIVATE_SHOP_LEVEL2_TOOLTIP	Zobrazit ve v irokm okol
GRAPHICONOFF_PRIVATE_SHOP_LEVEL3	3
GRAPHICONOFF_PRIVATE_SHOP_LEVEL3_TOOLTIP	Zobrazit ve ve stednm okol
GRAPHICONOFF_PRIVATE_SHOP_LEVEL4	4
GRAPHICONOFF_PRIVATE_SHOP_LEVEL4_TOOLTIP	Zobrazit ve v blzkm okol
GRAPHICONOFF_PRIVATE_SHOP_LEVEL5	5
GRAPHICONOFF_PRIVATE_SHOP_LEVEL5_TOOLTIP	Zobrazit ve v tsn blzkosti
GUILDWINDOW_BASE_BUFF	Cechovn bonus
GUILD_ATTENDANCE_LOCA1	Prvn ast: 1x Medaile statenosti
GUILD_ATTENDANCE_LOCA2	10 a vce: 1x Medaile statenosti
GUILD_ATTENDANCE_LOCA3	20 a vce: 2x Medaile statenosti
GUILD_ATTENDANCE_LOCA4	30 a vce: 4x Medaile statenosti
GUILD_ATTENDANCE_LOCA5	40 a vce: 6x Medaile statenosti
GUILD_ATTENDANCE_LOCA6	50 a vce: 8x Medaile statenosti
GUILD_ATTENDANCE_LOCA7	60 a vce: 10x Medaile statenosti
GUILD_ATTENDANCE_LOCA8	70 a vce: 12x Medaile statenosti
GUILD_ATTENDANCE_LOCA9	Potek: denn v 05:00
GUILD_ATTENDANCE_TITLE	Odmna za ast
GUILD_BANKINFO_CLOSE	Zavt
GUILD_BANKINFO_NAME	len
GUILD_BANKINFO_TITLE	Zznamy cechovnho skladit
GUILD_BANKINFO_TYPE	Pedmt/mna
GUILD_BANKINFO_USETYPE	Akce
GUILD_BANK_CLOSE	Zavt
GUILD_BANK_INFO	Strnka:
GUILD_BANK_NUMBER	slo banky
GUILD_BASEINFO_BANK	Cechovn skladit
GUILD_BASEINFO_BANKLASTOUT	Pedmt odebrn
GUILD_BASEINFO_BUILDING	Cechovn budova
GUILD_BASEINFO_DEAL	Prodat zem cechu
GUILD_BASEINFO_FACTORY	Cechovn kov
GUILD_BASEINFO_GOLDMANAGE	Transakce
GUILD_BASEINFO_GUILDLAND	zem cechu
GUILD_BASEINFO_LANDABANDON	Opustit zem cechu
GUILD_BASEINFO_LANDSCAPE	Ostatn
GUILD_BASEINFO_LOCALE	Umstn
GUILD_BASEINFO_MONEY	Bilance
GUILD_BASEINFO_MONEYBANKINFO	Informace o cechovn pokladn
GUILD_BASEINFO_MONEYIN	Uloen
GUILD_BASEINFO_MONEYLASTOUT	Posledn vbr
GUILD_BASEINFO_MONEYOUT	Vbr
GUILD_BASEINFO_POWER	Olt sly
GUILD_BASEINFO_SMEITER	Cechovn alchymista
GUILD_BASEINFO_TITLE	Informace o zem
GUILD_BASEINFO_VOTE	Hlasovat
GUILD_BASENAME	Zkladn jmno
GUILD_BOARD_ID	Jmno
GUILD_BOARD_REFRESH	Aktualizovat
GUILD_BOARD_TEXT	Zprva
GUILD_BUILDING_CATEGORY_TITLE	Stavebn jednotky
GUILD_BUILDING_CHANGE	Zmnit
GUILD_BUILDING_CHANGE_DELETE	Smazat
GUILD_BUILDING_CHANGE_FIX	Rekonstrukce cechu
GUILD_BUILDING_CHANGE_LIST	Seznamu cechovnch budov
GUILD_BUILDING_DIRECTION	Orientace
GUILD_BUILDING_FIX	Rekonstrukce
GUILD_BUILDING_GRADE	Hodnost
GUILD_BUILDING_INFO	Informace o budov a nkladech
GUILD_BUILDING_LIST_TITLE	Seznam budov
GUILD_BUILDING_LOG	Kmen
GUILD_BUILDING_NAME	Nzev budovy
GUILD_BUILDING_OPERATE	Obsluhovat
GUILD_BUILDING_PLY	Peklika
GUILD_BUILDING_POSITION	Poloha
GUILD_BUILDING_PREVIEW	Nhled
GUILD_BUILDING_PRICE	Cena
GUILD_BUILDING_REFRESH	Aktualizovat
GUILD_BUILDING_STONE	Kmen
GUILD_BUILDING_TITLE	Stavba domu cechu
GUILD_CRYSTAL	Kil
GUILD_DEPOSIT	Zaplatit
GUILD_DONATE_BUTTON_OVER_TEXT	Nhodn pedmt
GUILD_DONATE_COUNT	Dostupn dary: %d/%d
GUILD_DONATE_GET_MEDAL_OF_HONOR	%d
GUILD_DONATE_GUILD_EXP	Cechovn BZK
GUILD_DONATE_HIGH_MATERIAL	Velk dar
GUILD_DONATE_MEDAL_OF_HONOR	Medaile statenosti
GUILD_DONATE_MIDDLE_MATERIAL	Stedn dar
GUILD_DONATE_MY_MEDAL_OF_HONOR	M Medaile statenosti
GUILD_DONATE_NORMAL_MATERIAL	120 000 Yang
GUILD_DONATE_TAB_HIGH	Velk dar
GUILD_DONATE_TAB_MIDDLE	Stedn dar
GUILD_DONATE_TAB_NORMAL	Mal dar
GUILD_DONATE_TITLE	Dar BZK
GUILD_DRAGONLAIR_RANKING	Hodnocen
GUILD_DRAGONLAIR_RANKING_COUNT	Hodn.
GUILD_DRAGONLAIR_RANKING_MEMBER	len
GUILD_DRAGONLAIR_RANKING_NAME	Cech
GUILD_DRAGONLAIR_RANKING_TIME	as
GUILD_DROP_RESOURCE1	zde
GUILD_DROP_RESOURCE2	Nechat spadnout zdroj
GUILD_GEM	Drahokam
GUILD_GRADE_CHANGE_GRADE_NAME	Nov jmno hodnosti
GUILD_GRADE_NUM	slo
GUILD_GRADE_PERMISSION_BANK	Me pouvat cechovn pokladnu a skladit
GUILD_GRADE_PERMISSION_DELETE	Odebrat z cechu
GUILD_GRADE_PERMISSION_JOIN	Me pijmat hre do cechu
GUILD_GRADE_PERMISSION_NOTICE	Me poslat cechovn zprvy
GUILD_GRADE_PERMISSION_SKILL	Schopnosti cechu
GUILD_GRADE_PERMISSION_WAR	Me vybrat leny jako bojovnky
GUILD_GRADE_RANK	Hodnost
GUILD_GRADE_WRITE	Pst
GUILD_INFO	Informace o cechu
GUILD_INFO_CUR_EXP	Zkuenost
GUILD_INFO_DECALRE_WAR	Vyhlsit vlku
GUILD_INFO_ENEMY_GUILD	Neptelsk cech
GUILD_INFO_ENEMY_GUILD_EMPTY	dn
GUILD_INFO_LEVEL	Cechovn rove
GUILD_INFO_MARK	Logo cechu
GUILD_INFO_MASTER	Vedouc
GUILD_INFO_MASTER_VALUE	Vedouc
GUILD_INFO_MEMBER_AVG_LEVEL	Prm. rove
GUILD_INFO_MEMBER_NUM	Poet len
GUILD_INFO_NAME	Nzev cechu
GUILD_INFO_NAME_VALUE	Toto je nzev cechu
GUILD_INFO_OFFER_EXP	Invest.
GUILD_INFO_REST_EXP	Potebn zkuenost
GUILD_INFO_UPLOAD_MARK	Uploadovat logo
GUILD_INFO_UPLOAD_SYMBOL	Uploadovat logo
GUILD_LANDDEAL_VOTE	Prodat zem cechu
GUILD_LANDDEAL_VOTE_DEALGOLD	Yang:
GUILD_LANDDEAL_VOTE_DEALGUILDNAME	Nzev cechu:
GUILD_MARK	Logo cechu
GUILD_MASTER_CHANGE_TITLEBAR	Vzdt se veden cechu
GUILD_MEMBER_JOB	Rasa
GUILD_MEMBER_KNIGHT	Bojovnk
GUILD_MEMBER_LEVEL	rove
GUILD_MEMBER_NAME	Jmno
GUILD_MEMBER_OUT_TITLEBAR	Odebrat lena
GUILD_MEMBER_PACE_ATTENDANCE	ast ({0}/{1})
GUILD_MEMBER_RANK	Hodnost
GUILD_MEMBER_SPECIFIC_GRAVITY	Invest.
GUILD_MEMBER_VOTE_CHECK	Podvat se na hlasy
GUILD_METIN_STONE	Kmen metin
GUILD_MINENAL	Minerl
GUILD_MONEY	Yang
GUILD_NAME	Cech
GUILD_RESOURCE_INFO	Informace o zdrojch
GUILD_SKILLPAGE_LADDER	Body umstn
GUILD_SKILLPAGE_RANK	Hodn.
GUILD_SKILL_ACTIVE	Aktivn
GUILD_SKIlL_HEAL_GSP	Nabt
GUILD_SKILL_PASSIVE	Pasivn
GUILD_SKILL_POWER	Energie
GUILD_SKILL_STATE	Schopnosti cechu
GUILD_SYMBOL	Prapor cechu
GUILD_WAR_ACCEPT	Akceptovat vyhlen vlky
GUILD_WAR_ALLSCORE	Vechny vlky
GUILD_WAR_BATTLE_TYPE	Druh boje
GUILD_WAR_CTF	Vlajka
GUILD_WAR_DECLARE	Vyhlsit vlku cech
GUILD_WAR_ENEMY	Protivnk
GUILD_WAR_GAINSCORE	Body
GUILD_WAR_GAINSCORE_FIFTY	50
GUILD_WAR_GAINSCORE_HUNDRED	100
GUILD_WAR_GAINSCORE_THIRTY	30
GUILD_WAR_GAMETIME	as boje
GUILD_WAR_GAMETIME_SIXTY	60 min.
GUILD_WAR_GAMETIME_TEN	10 min.
GUILD_WAR_GAMETIME_THIRTY	30 min.
GUILD_WAR_JOINMEMBER	lenov
GUILD_WAR_JOINMEMBER_COUNT	lenov
GUILD_WAR_JOINMEMBER_FIFTEEN	15
GUILD_WAR_JOINMEMBER_FIVE	5
GUILD_WAR_JOINMEMBER_TEN	10
GUILD_WAR_NORMAL	Pole
GUILD_WAR_REPORT	Vlen report
GUILD_WAR_REPORTLIST	Pehled (Bitvy: B, vtezstv: V, prohry: P, remzy: R)
GUILD_WAR_SCORE	Vlen report
GUILD_WAR_SKILL	Schopnosti cechu
GUILD_WAR_TYPE_DEFENSE	ttov bitva
GUILD_WAR_TYPE_DIE	Bitva v arn
GUILD_WAR_TYPE_FLAG	Zajmout vlajku
GUILD_WAR_TYPE_NORMAL	Poln bitva
GUILD_WAR_TYPE_TIGER	Rozdrcen
GUILD_WAR_TYPE_TIME	asov tok
GUILD_WAR_WARP	Arena
GUILD_WAR_WIN	Kola
GUILD_WAR_WIN_FIVE	5
GUILD_WAR_WIN_ONE	1
GUILD_WAR_WIN_THREE	3
GUILD_WATER	Voda
GUILD_WATER_STONE	Vodn kmen
GUILD_WITHDRAW	Vzt
HELP_ATTACK	Aktivuje jeden tok na jedno kliknut myi.
HELP_ATTACK_KEY	tok: stiskni mezernk nebo lev tlatko myi
HELP_AUTO_ATTACK	Aktivuje automatick toen na kliknut myi.
HELP_CAMERA	Pohled kamery
HELP_CHANGE_PK_MODE	Zmnit ton md: zmte nastaven levho tlatka myi
HELP_CHARACTER_BUTTON1	(Okno postavy, Invent,
HELP_CHARACTER_BUTTON2	Seznam ptel a Monosti)
HELP_CHAT	Pro konverzaci k urit skupin dej ped zprvu nsledujc:  !(zavolat), #(skupinov chat) nebo %(cechovn chat).
HELP_CLICK_OTHER_PLAYER	Klikni pravm tlatkem na jinho hre pro obchod, vytvoen skupiny nebo vzvu k souboji.
HELP_CONTROL_CAMERA_BY_MIDDLEBUTTON	Vchoz pohled kamery: stedn tlatko myi
HELP_CONTROL_CAMERA_BY_RIGHTBUTTON	Alternativn pohled kamery: prav nebo lev tlatko myi
HELP_EMOTINO	Vyjdi sv emoce pomoc klves <CTRL> + <1~9>.
HELP_EXP	Zkuenost
HELP_FURY	Item Shop ve he
HELP_GUILD_WINDOW	Otevt okno cechu: stistknutm klves Alt + G
HELP_HELP	Zobrazit npovdu: stisknutm klvesy H
HELP_HELP_KEY	Vchoz nastaven jsou zobrazeny na obrazovce npovdy.
HELP_HP	Body ivota (ZB)
HELP_KEYSETTING	Nastaven klves me provst v nastaven hry.
HELP_MESSENGER_WINDOW	Otevt Seznam ptel: pomoc klves Alt + M
HELP_MINIMAP	Zobraz minimapu.
HELP_MINIMAP_QUEST	Mise jsou zobrazeny na velk i mal map jako blikajc ikony.
HELP_MOUSE_LEFT	Funkce levho tlatka myi
HELP_MOUSE_RIGHT	Funkce pravho tlatka myi
HELP_MOVE_KEY	Pohyb: k pohybu pouij klvesy W, S, A, D nebo ipky
HELP_OFF_QUESTSCROLL	Zobraz/skryj svitky kol pomoc <CTRL> + Q.
HELP_OPEN_CHARACTER	Otevt okno postavy: pomoc klvesy C
HELP_OPEN_CHAT	Otevt okno chatu: pomoc klvesy Enter
HELP_OPEN_INVENTORY	Otevt Invent: pomoc klvesy I
HELP_OPEN_LOG	Otevt log chatu: pomoc klvesy L
HELP_OPEN_MINIMAP	Otevt Minimapu: pomoc klves Shift + M
HELP_OPEN_QUEST	Otevt okno s koly: pomoc klvesy N
HELP_OPEN_SKILL	Otevt okno schopnosti: pomoc klvesy V
HELP_OPEN_WHISPER	Otevt epot: pomoc klves Shift + Enter
HELP_OPEN_ZONEMAP	Otev velkou mapu: pomoc klvesy M
HELP_PICK_ITEM	Zvedat pedmty: pomoc klves ^ nebo Y nebo levm tlatkem myi
HELP_QUICKSLOT	Pole rychlho pstupu
HELP_SCREEN_CAPTURE	Uloit Snmek obrazovky: pomoc klvesy Print (bude uloen v souboru "Metin2\screenshot")
HELP_SERVER	Zobraz server a kanl.
HELP_SHOW_ALL_NAME	Zobrazit Jmna: pomoc klvesy Alt
HELP_SKILL	Zde me pout schopnost pomoc pravho tlatka myi.
HELP_SP	Magick Body (MB)
HELP_SYSTEM_BUTTON	Systmov klvesy
INVENTORY_PAGE_BUTTON_TOOLTIP_1	1. Invent
INVENTORY_PAGE_BUTTON_TOOLTIP_2	2. Invent
INVENTORY_PAGE_BUTTON_TOOLTIP_3	3. invent
INVENTORY_PAGE_BUTTON_TOOLTIP_4	4. invent
INVENTORY_TITLE	Invent
ITEM_MALL	Item Shop
KEYCHANGE_ACTION_WINDOW	Akce
KEYCHANGE_ATTACK	tok
KEYCHANGE_AUTORUN	Aut. bh
KEYCHANGE_AUTO_WINDOW	Automatick lov
KEYCHANGE_BASEACTION	Standardn klvesy
KEYCHANGE_CAM_DOWN1	Kamera (dol)
KEYCHANGE_CAM_DOWN2	Kamera (dol)
KEYCHANGE_CAM_LEFT1	Kamera (vlevo)
KEYCHANGE_CAM_LEFT2	Kamera (vlevo)
KEYCHANGE_CAM_RIGHT1	Kamera (vpravo)
KEYCHANGE_CAM_RIGHT2	Kamera (vpravo)
KEYCHANGE_CAM_UP1	Kamera (nahoru)
KEYCHANGE_CAM_UP2	Kamera (nahoru)
KEYCHANGE_CAM_ZOOM_IN1	Kamera (zvten)
KEYCHANGE_CAM_ZOOM_IN2	Kamera (zvtit)
KEYCHANGE_CAM_ZOOM_OUT1	Kamera (zmenen)
KEYCHANGE_CAM_ZOOM_OUT2	Kamera (zmenit)
KEYCHANGE_CANCLE	Storno
KEYCHANGE_CHAT_WINDOW	Historie konverzace
KEYCHANGE_CLEAR	Standardn
KEYCHANGE_DDS_WINDOW	DSS
KEYCHANGE_DOWN1	Dozadu
KEYCHANGE_DOWN2	Dozadu
KEYCHANGE_DSS1	DS [Nebe]
KEYCHANGE_DSS2	DS [Zem]
KEYCHANGE_EMOTION1	Emoce (smutn)
KEYCHANGE_EMOTION2	Emoce (Yang)
KEYCHANGE_EMOTION3	Emoce (hudba)
KEYCHANGE_EMOTION4	Emoce (srdce)
KEYCHANGE_EMOTION5	Emoce (srdce)
KEYCHANGE_EMOTION6	Emoce (bomba)
KEYCHANGE_EMOTION7	Emoce (npad)
KEYCHANGE_EMOTION8	Emoce (boue)
KEYCHANGE_EMOTION9	Emoce (omlouvm se)
KEYCHANGE_GUILD_WINDOW	Cech
KEYCHANGE_HELP_WINDOW	Npovda
KEYCHANGE_IMPOSSIBLE_CHANGE	[CTRL], [ALT], [SHIFT] zde nejsou povoleny!
KEYCHANGE_INGAMEEVENT	UDLOST
KEYCHANGE_INTERFACE	Okno
KEYCHANGE_INVENTORY_WINDOW	Invent
KEYCHANGE_KEY_SETTING	Nastaven klvesnice
KEYCHANGE_LEFT1	Vlevo
KEYCHANGE_LEFT2	Vlevo
KEYCHANGE_MESSENGER_WINDOW	Ptel
KEYCHANGE_MINIMAP_MINER	Minimapa (-)
KEYCHANGE_MINIMAP_PLUS	Minimapa (+)
KEYCHANGE_MINIMAP_WINDOW	Velk mapa
KEYCHANGE_MONSTER_CARD_WINDOW	Karta pery
KEYCHANGE_NEXT_TARGET	Dal cl
KEYCHANGE_PARTY_MATCH_WINDOW	Skupinov hledn
KEYCHANGE_PET_WINDOW	Mazlk
KEYCHANGE_QUEST_SCROLL_ONOFF	Svitky kol
KEYCHANGE_QUEST_WINDOW	koly
KEYCHANGE_QUICKSLOT1	rove 1
KEYCHANGE_QUICKSLOT2	rove 2
KEYCHANGE_QUICKSLOT3	rove 3
KEYCHANGE_QUICKSLOT4	rove 4
KEYCHANGE_RIDE	Nasednout
KEYCHANGE_RIDE_BYE	Odeslat kon
KEYCHANGE_RIDE_HORSE	Nasednout
KEYCHANGE_RIDE_PEED	Nakrmit kon
KEYCHANGE_RIGHT1	Vpravo
KEYCHANGE_RIGHT2	Vpravo
KEYCHANGE_ROOT1	Sebrat
KEYCHANGE_ROOT2	Sebrat
KEYCHANGE_SAVE	Uloit
KEYCHANGE_SCREENSHOT	Snmek obrazovky
KEYCHANGE_SHOW_NAME	Zobrazit jmna
KEYCHANGE_SKILL_WINDOW	Schopnosti
KEYCHANGE_SLOT1	Pozice 1
KEYCHANGE_SLOT2	Pozice 2
KEYCHANGE_SLOT3	Pozice 3
KEYCHANGE_SLOT4	Pozice 4
KEYCHANGE_SLOT5	Pozice 5
KEYCHANGE_SLOT6	Pozice 6
KEYCHANGE_SLOT7	Pozice 7
KEYCHANGE_SLOT8	Pozice 8
KEYCHANGE_SLOT_KET	Rychl volba
KEYCHANGE_STATUS_WINDOW	Postava
KEYCHANGE_UP1	Dopedu
KEYCHANGE_UP2	Dopedu
LANGUAGE_AE	Arabsky
LANGUAGE_CZ	esky
LANGUAGE_DE	Nmecky
LANGUAGE_DK	Dnsky
LANGUAGE_EN	Anglicky
LANGUAGE_ES	panlsky
LANGUAGE_FR	Francouzsky
LANGUAGE_GR	ecky
LANGUAGE_HU	Maarsky
LANGUAGE_IT	Italsky
LANGUAGE_NL	Holandsky
LANGUAGE_PL	Polsky
LANGUAGE_PT	Portugalsky
LANGUAGE_RO	Rumunsky
LANGUAGE_RU	Rusky
LANGUAGE_TR	Turecky
LOAD_ERROR	Soubor je pokozen. Prosm nainstaluj Client znovu. Te stiskni klvesu ESC.
LOGIN_CONNECT	Pipojit
LOGIN_CONNECTING	Bude spojen se serverem.
LOGIN_DEFAULT_SERVERADDR	Nzev serveru, kanl 1
LOGIN_EXIT	Ukonit
LOGIN_ID	Uivatelsk jmno
LOGIN_PASSWORD	Heslo
LOGIN_REGION_TITLE	Zvolit msto na vystaven tenky
LOGIN_SELECT_BUTTON	Zvolit
LOGIN_SELECT_EXIT	Ukonit
LOGIN_SELECT_OK	OK
LOGIN_SELECT_TITLE	Zvolit server
LUCKY_BOX_NOTICE_YANG	Poplatek v Yanzch za tst novho pedmtu
LUCKY_BOX_RECV_BUTTON	Pijmout pedmt
LUCKY_BOX_RECV_NAME	Obsahuje:
LUCKY_BOX_RETRY_BUTTON	tst novho pedmtu
LUCKY_BOX_TITLE_NAME	Truhla tst
MAILBOX_POST_ALL_DELETE_BUTTON	Smazat ve
MAILBOX_POST_ALL_RECEIVE	Zskat ve
MAILBOX_POST_READ_BLOCK	Blokovat
MAILBOX_POST_READ_DELETE	Smazat
MAILBOX_POST_READ_FROM	Od
MAILBOX_POST_READ_MAIN_TITLE	Zprva
MAILBOX_POST_READ_RECV	Zskat
MAILBOX_POST_READ_TITLE	Pedmt
MAILBOX_POST_SEND_TITLE	Zprva
MAILBOX_POST_WRITE_BUTTON_TEXT	Odeslat
MAILBOX_POST_WRITE_CLOSE_TEXT	Zavt
MAILBOX_POST_WRITE_CONFIRM_TEXT	Zkontrolovat pjemce
MAILBOX_POST_WRITE_SEND_TEXT	Odeslat
MAILBOX_POST_WRITE_TITLE	Pedmt
MAILBOX_POST_WRITE_TO	Pro
MAILBOX_TITLE	Doruen pota
MALL_PASSWORD_TITLE	Heslo
MALL_TITLE	Sklad Item Shop
MARKET_TITLE	Nahrt
MARKLIST_REFRESH	Aktualizovat
MARKLIST_TITLE	Zaregistrovat logo cechu
MC_EXCHANGE_BUTTON	Zamnit
MC_MISSION_INIT_BUTTON	Zresetovat rove mise
MC_MOTION_BUTTON	Pohyb
MC_POLY_BUTTON	Transformovat
MC_PROMOTION_BUTTON	Vylepit
MC_REQUEST_MISSION_BUTTON	Pijmout misi
MC_REWARD_CARD_BUTTON	Sebrat kartu pery
MC_SHUFFLE_BUTTON	Zamchat karty mis
MC_SUMMON_BUTTON	Vyvolat
MC_TAB_BUTTON_CARD_MISSION	Karta mise
MC_TAB_BUTTON_PARTY	Sbrka bludit
MC_TAB_BUTTON_SOLO	Otevt Sbrku svta
MC_WARP_BUTTON	Teleportace
MESSAGE	Toto je zprva
MESSENGER_ADD_FRIEND	Pidat ptele
MESSENGER_BLOCK_FRIEND	Blokovat
MESSENGER_DELETE_FRIEND	Smazat
MESSENGER_MOBILE	Poslat SMS
MESSENGER_OPEN_GUILD	Otevt okno cechu
MESSENGER_TITLE	Ptel
MESSENGER_USE_GUILD_MOVE_SKILL	Pouij cechovn schopnost pohybu
MESSENGER_WHISPER	eptat
MINIGAME_FISH_EVENT_USE_COUNT	Mnostv
MINIMIZE	Minimalizovat
MINI_BOSS_DUNGEON_DESC_BTN	Pravidla udlosti
MINI_BOSS_DUNGEON_TITLE_NAME	Nzev
MINI_BOSS_DUNGEON_TITLE_NUM	Hodnost
MINI_BOSS_DUNGEON_TITLE_POINT	Body apokalypsy
MINI_BOSS_DUNGEON_TOOTIP_01	Pehled bludit
MINI_BOSS_DUNGEON_TOOTIP_02	Apokalypsa pro rovn 40-80
MINI_BOSS_DUNGEON_TOOTIP_03	Apokalypsa pro rovn 81+
MINI_BOSS_DUNGEON_TOOTIP_04	Vstoupit
MINI_BOSS_DUNGEON_TOOTIP_05	Zbvajc as
MINI_BOSS_DUNGEON_TOOTIP_06	M Body apokalypsy
MINI_BOSS_DUNGEON_TOOTIP_07	Zbvajc apokalypsy
MINI_BOSS_DUNGEON_TOOTIP_08	M odmna
MINI_BOSS_TITLE	Apokalypsa Zvrokruhu
MINI_GAME_BLACK_AND_WHITE_DONATE	Darovat
MINI_GAME_BLACK_AND_WHITE_GAME_TITLE	Souboj vtc
MINI_GAME_BLACK_AND_WHITE_RANK_BUTTON	ebek
MINI_GAME_BLACK_AND_WHITE_REWARD_TRADE	Ceny
MINI_GAME_BLACK_AND_WHITE_START_BUTTON	Start
MINI_GAME_BLACK_AND_WHITE_WAITTING_TITLE	Souboj vtc
MINI_GAME_CATCHKING_CHALLENGE	Szka
MINI_GAME_CATCHKING_HELP_TEXT	Pravidla
MINI_GAME_CATCHKING_HIGH_SCORE	Nejlep skre
MINI_GAME_CATCHKING_MYNUMBER	M karty
MINI_GAME_CATCHKING_POPUP_CONFIRM	Zobrazit/skrt okno
MINI_GAME_CATCHKING_RETRY	Hrt znovu
MINI_GAME_CATCHKING_REWARD	Tv odmna
MINI_GAME_CATCHKING_SCORE	Body
MINI_GAME_CATCHKING_SELECTION_NUMBER	Odhalen karty
MINI_GAME_CATCHKING_START_TEXT	Start
MINI_GAME_CATCHKING_TITLE	Chy krle
MINI_GAME_FINDM_HINT_BTN	Npovda
MINI_GAME_FINDM_START_BTN	Zat hrt
MINI_GAME_FINDM_TITLE	Memo tria per
MINI_GAME_FINDM_TRY_COUNT_TEXT	Pokusy
MINI_GAME_FINDM_UPGRADE_BAR1	Pedmt
MINI_GAME_FINDM_UPGRADE_BAR2	Poplatek (Yangy)
MINI_GAME_FINDM_UPGRADE_RECV	Zskat pedmt
MINI_GAME_FINDM_UPGRADE_RETRY	Zkusit vylepen
MINI_GAME_FINDM_UPGRADE_TITLE	Vylepit odmnu
MINI_GAME_FISH_HELP_TEXT	Npovda
MINI_GAME_FISH_START_TEXT	Start
MINI_GAME_FISH_TITLE	Rybsk skldaka
MINI_GAME_RUMI_DISCARD_TEXT	Zabezpeen md
MINI_GAME_RUMI_EXIT	Konec
MINI_GAME_RUMI_LBUTTON_DESC	Lev klik pro pidn karty
MINI_GAME_RUMI_RBUTTON_DESC	Prav klik pro zahozen karty
MINI_GAME_RUMI_SCORE	Skre
MINI_GAME_RUMI_START_TEXT	Start
MINI_GAME_RUMI_TITLE	Metin 2 - karetn hra Okey
MINI_GAME_YUTNORI_COM_TEXT	Pota
MINI_GAME_YUTNORI_PLAYER_TEXT	Hr
MINI_GAME_YUTNORI_PROBABILITY	ance
MINI_GAME_YUTNORI_PROB_DESC	Zvol skre Yut pro zven ance, e padne.
MINI_GAME_YUTNORI_REMAIN_COUNT	Pohyby!
MINI_GAME_YUTNORI_REWARD_TEXT	Odmna
MINI_GAME_YUTNORI_SCORE	Skre
MINI_GAME_YUTNORI_START_TEXT	Start
MINI_GAME_YUTNORI_THROW	Hodit
MINI_GAME_YUTNORI_TITLE	Yutnori
MINI_GAME_YUTNORI_YUTSEM1	Do
MINI_GAME_YUTNORI_YUTSEM2	Gae
MINI_GAME_YUTNORI_YUTSEM3	Geol
MINI_GAME_YUTNORI_YUTSEM4	Yut
MINI_GAME_YUTNORI_YUTSEM5	Mo
MINI_GAME_YUTNORI_YUTSEM6	Back Do
MISTS_ISLAND_EMPIRE_NAME	Nzev krlovstv
MISTS_ISLAND_EMPIRE_SCORE	Skre krlovstv
MISTS_ISLAND_END_TIME	as ukonen
MISTS_ISLAND_EXIT	Opustit
MISTS_ISLAND_INFO_TEXT	Poad/Stav
MISTS_ISLAND_RANK	Poad
MISTS_ISLAND_SCORE	Skre
MISTS_ISLAND_TITLE_RANK	Poad/Stav
MISTS_ISLAND_TITLE_SCORE	Pehled
MOUSEBUTTON_ATTACK	toit
MOUSEBUTTON_AUTO_ATTACK	Automaticky toit
MOUSEBUTTON_CAMERA	Kamera
MOUSEBUTTON_SKILL	Schopnosti
MUSICLIST_TITLE	Vbr hudby
MYSHOP_DECO_CANCEL	Zavt
MYSHOP_DECO_DEFAULT	Vchoz
MYSHOP_DECO_NEXT	Dal
MYSHOP_DECO_OK	Potvrdit
MYSHOP_DECO_PREV	Zpt
MYSHOP_DECO_SELECT_MODEL	Zvol si vzhled svho obchodu.
MYSHOP_DECO_SELECT_TITLE	Zvol si vzhled svho jmna.
NO	Ne
OK	OK
OPPOSITES	Odmtnout
OPTION_ALWAYS_SHOW_NAME	Jmno
OPTION_ALWAYS_SHOW_NAME_OFF	omezen
OPTION_ALWAYS_SHOW_NAME_ON	vdy
OPTION_BLOCK	Blokovat
OPTION_BLOCK_EXCHANGE	Obchodovat
OPTION_BLOCK_FRIEND	Ptel
OPTION_BLOCK_GUILD	Cech
OPTION_BLOCK_PARTY	Skupina
OPTION_BLOCK_PARTY_REQUEST	Dotaz
OPTION_BLOCK_WHISPER	eptat
OPTION_CAMERA_DISTANCE	Kamera
OPTION_CAMERA_DISTANCE_LONG	Daleko
OPTION_CAMERA_DISTANCE_SHORT	Blzko
OPTION_DELETE_MOBILE_BUTTON	Smazat slo mobilu
OPTION_EFFECT	Zobrazen zsah
OPTION_ENV_EFFECT	Prosted
OPTION_ENV_EFFECT_OFF	Vyp.
OPTION_ENV_EFFECT_ON	Zap.
OPTION_FOG	Mlha
OPTION_FOG_DENSE	Hodn
OPTION_FOG_LIGHT	Mlo
OPTION_FOG_MIDDLE	Stedn
OPTION_FOG_OFF	Vyp.
OPTION_FOG_ON	Zap.
OPTION_INPUT_MOBILE_BUTTON	Vloit slo mobilu
OPTION_KEY_SETTING	Klvesnice
OPTION_LANGUAGE_CHANGE	Pout
OPTION_LANGUAGE_SELECT	Jazyk
OPTION_MOBILE	Mobil
OPTION_MOB_INFO	Info o pee
OPTION_MOB_INFO_AGGR	Agresivn
OPTION_MOB_INFO_LEVEL	rove
OPTION_MUSIC	Hudba
OPTION_MUSIC_CHANGE	Zmnit
OPTION_MUSIC_DEFAULT_THEMA	Standardn titul Metinu2
OPTION_NAME_COLOR	Nzev barvy
OPTION_NAME_COLOR_EMPIRE	Barva e
OPTION_NAME_COLOR_NORMAL	Normln
OPTION_NIGHT_MODE	Noc
OPTION_NIGHT_MODE_OFF	Vyp.
OPTION_NIGHT_MODE_ON	Zap.
OPTION_PVPMODE	Modus PvP
OPTION_PVPMODE_FREE	Voln
OPTION_PVPMODE_FREE_TOOLTIP	Sm toit na vechny hre
OPTION_PVPMODE_GUILD	Cech
OPTION_PVPMODE_GUILD_TOOLTIP	Sm toit na vechny hre krom len vlastnho cechu.
OPTION_PVPMODE_PEACE	Mr
OPTION_PVPMODE_PEACE_TOOLTIP	Neme zatoit na hre z tvho krlovstv.
OPTION_PVPMODE_REVENGE	Neptelsky
OPTION_PVPMODE_REVENGE_TOOLTIP	Me toit pouze hre s jinm smlenm.
OPTION_SALESTEXT	Jmno obchodu
OPTION_SALESTEXT_VIEW_OFF	skrt
OPTION_SALESTEXT_VIEW_ON	ukzat
OPTION_SETTING	Otevt
OPTION_SNOW_MODE	Snen
OPTION_SNOW_MODE_OFF	Vyp.
OPTION_SNOW_MODE_ON	Zap.
OPTION_SNOW_TEXTURE_MODE	Snh
OPTION_SNOW_TEXTURE_MODE_OFF	Vyp.
OPTION_SNOW_TEXTURE_MODE_ON	Zap.
OPTION_SOUND	Efekty
OPTION_TARGET_BOARD	Clov menu
OPTION_TARGET_BOARD_NO_VIEW	Zavt
OPTION_TARGET_BOARD_VIEW	Zobrazit
OPTION_TITLE	Nastaven
OPTION_VIEW_CHAT	dek v chatu
OPTION_VIEW_CHAT_OFF	skrt
OPTION_VIEW_CHAT_ON	ukzat
PARTY_MATCH_TEXT_DUNGEON_NAME	Bludit
PARTY_MATCH_TEXT_DUNGEON_SELECT	Zvol si bludit
PARTY_MATCH_TEXT_ENTREE_LEVEL	rove: %d
PARTY_MATCH_TEXT_LEVEL_LIMIT	Poadavky na rove:
PARTY_MATCH_TEXT_REQUEST_MATCH	Hledat
PARTY_MATCH_TEXT_REQUEST_MATCH_CANCEL	Storno
PARTY_MATCH_TEXT_REQUIRED_ITEMS	Poadovan pedmt
PARTY_MEMBER_INFO_NAME	Jmno lena cechu
PASSWORD_DESC_1	Zadejte sv heslo
PASSWORD_DESC_2	k oteven skladu.
PASSWORD_DESC_3	Ji sis zmnil heslo?
PASSWORD_DESC_4	Pokud ne, heslo je '000000'.
PASSWORD_DESC_5	Sv heslo si zm ve skladiti.
PASSWORD_TITLE	Pam- PW
PET_AGE_TEXT	Vk mazlka
PET_ATTR_CHANGE_ITEM_TEXT	Zaarovat mazlka
PET_ATTR_CHANGE_TITLE	Zmnit typ mazlka
PET_ATTR_CONFIRMATION	Zmnit
PET_ATTR_DETERMINE_TITLE	Nov typ mazlka
PET_ATTR_OK	Zavt
PET_CHANGE_TEXT	Mazlk
PET_FEED_TITLE	Nakrmit
PET_FFED_BUTTON_TEXT	Nakrmit
PET_HATCHING_BUTTON	Vylhnout
PET_HATCHING_NIK	Jmno mazlka
PET_HATCHING_WINDOW_TITLE	Inkubtor
PET_INFORMATION_ABILITIES	Bonusy
PET_INFORMATION_AGE	Vk
PET_INFORMATION_COSTUME_BONUS	Bonus kostmu
PET_INFORMATION_DEFENCE	Obrana
PET_INFORMATION_EVOL_BUTTON	Vyvinout
PET_INFORMATION_EXP	Zkuenosti
PET_INFORMATION_EXP_BUTTON	Zk. pedmtu
PET_INFORMATION_HP	ZB
PET_INFORMATION_LEVEL	rove
PET_INFORMATION_LIFE	Doba trvn
PET_INFORMATION_LIFETIME_BUTTON	Nakrmit
PET_INFORMATION_LIFE_TIME	Hodin
PET_INFORMATION_SKILL	Schopnost
PET_INFORMATION_SP	MB
PET_INFORMATION_TITLE	Mazlk
PET_NAME_CHANGE_BUTTON	Zmnit
PET_NAME_CHANGE_WINDOW_TITLE	Zmnit jmno
PET_REVIVE_BUTTON	Oivit
PET_REVIVE_CANCEL_BUTTON	Storno
PET_REVIVE_MATERIAL_TITLE	Materil
PET_REVIVE_REUSLT_TEXT	Vsledek
PET_REVIVE_TARGET	Mazlk k oiven
PET_REVIVE_TITLE	Oivit mazlka
PICK_MONEY_TITLE	Dlit
PRIVATESHOPSEARCH_BUY	Koupit
PRIVATESHOPSEARCH_COUNT	Mnostv
PRIVATESHOPSEARCH_ITEMNAME	Nzev
PRIVATESHOPSEARCH_ITEMTYPE	Pedmty
PRIVATESHOPSEARCH_JOB	Tda
PRIVATESHOPSEARCH_LEVEL	rove
PRIVATESHOPSEARCH_PRICE	Cena
PRIVATESHOPSEARCH_REFINE	rove pedmtu
PRIVATESHOPSEARCH_SEARCH	Hledat
PRIVATESHOPSEARCH_SEARCH_BAR	Hledat
PRIVATESHOPSEARCH_SELECT	Zvolit
PRIVATESHOPSEARCH_SELLER	Prodejce
PRIVATE_SHOP_CLOSE_BUTTON	Zavt obchod
PRIVATE_SHOP_NAME	Jmno obchodu
PRIVATE_SHOP_TITLE	Otevt obchod
QUEST_UI_TEXT_COLLECTION	Biologovy koly
QUEST_UI_TEXT_DAILY	Denn kol
QUEST_UI_TEXT_EVENT	koly akce
QUEST_UI_TEXT_LEVELUP	Loveck koly
QUEST_UI_TEXT_MAIN	Hlavn koly
QUEST_UI_TEXT_SCROLL	koly z Knihy mis
QUEST_UI_TEXT_SUB	Vedlej koly
QUEST_UI_TEXT_SYSTEM	Hern koly
REFINE_COST	Nklady na zlepen: 0 Yang
REFINE_ELEMENT_CHANGE_COST_TITLE	Nklady
REFINE_ELEMENT_CHANGE_DARK	Temnota
REFINE_ELEMENT_CHANGE_EARTH	Zem
REFINE_ELEMENT_CHANGE_ELECT	Blesk
REFINE_ELEMENT_CHANGE_FIRE	Ohe
REFINE_ELEMENT_CHANGE_ICE	Led
REFINE_ELEMENT_CHANGE_TITLE	Zmnit element
REFINE_ELEMENT_CHANGE_WIND	Vtr
REFINE_ELEMENT_DOWNGRADE_TITLE	Snit stupe
REFINE_ELEMENT_UPGRADE_TITLE	Vylepit
REFINE_INFO	Pravdpodobnost spnho zlepen: 100 %
REFINE_MONEY	Poplatek za zulechtn
REFINE_SELECT	Zulechtn
REFINE_TTILE	Zlepen
REPORT_VIOLENT_WHISPER	
RESTART_GIVEUP	Vzdt to
RESTART_HERE	Zde znovu spustit
RESTART_IMMEDIATE	Reinkarnace
RESTART_TOWN	Znovu spustit ve mst
ROULETTE_SPECIAL_TITLE	Odmny (%s)
ROULETTE_SPIN_TEXT1	ZATOIT
ROULETTE_SPIN_TEXT2	50 du
ROULETTE_SPIN_TEXT3	250 000 Yang
ROULETTE_TITLE	Odmny
SAFE_CHANGE_PASSWORD	Zmnit heslo
SAFE_TITLE	Sklad
SELECT_ATTR_CHANGED	Nov
SELECT_ATTR_CURRENT	Aktuln
SELECT_ATTR_SELECT	Zvolit
SELECT_ATTR_TITLE	Zaarovat pedmt+
SELECT_ATT_GRADE	SIL
SELECT_CREATE	Vytvoit
SELECT_DELETE	Smazat
SELECT_DEX_GRADE	POH
SELECT_EMPIRE_NAME	Nzev krlovstv
SELECT_EXIT	Ukonit
SELECT_HP	VIT
SELECT_LEVEL	rove
SELECT_METIN_STONE_TITLE	Zvolit Kmen ducha
SELECT_NAME	Jmno
SELECT_NO_GUILD	Bez cechu
SELECT_PLAYTIME	Trvn hry
SELECT_SELECT	Start
SELECT_SP	INT
SELECT_TITLE	Zvolit titul
SHOP_BUY	Koupit
SHOP_SELL	Prodat
SHOP_TITLE	Obchod
SKILL_SUPPORT_TITLE	Standardn schopnosti
STEP	Stupe irosti
STEP_SELECT	Stupe irosti
STRENGTH	Zeslen
STRENGTH_SELECT	rove
STRUCTURE_VIEW_MODE	Dekorace
STRUCTURE_VIEW_TYPE_STRUCTURE	Skrt
SYSTEMOPTION_TITLE	Nastaven systmu
SYSTEM_CHANGE	Zmnit postavu
SYSTEM_EXIT	Ukonit hru
SYSTEM_HELP	Npovda
SYSTEM_LOGOUT	Odhlsit se
SYSTEM_MALL	Item Shop
SYSTEM_MOVE_CHANNEL	Zmnit kanl
SYSTEM_OPTION	Nastaven systmu
TASKBAR_CHARACTER	Postava [C/V/B/N]
TASKBAR_CHAT	Okno s chatem [Enter]
TASKBAR_DISABLE	Deaktivovno
TASKBAR_DRAGON_SOUL	Alchymie Drach kamen
TASKBAR_EXPAND	Rozit okno
TASKBAR_INVENTORY	Invent [I]
TASKBAR_MESSENGER	Ptel [Alt+M]
TASKBAR_MONEY_EXPAND	Penze
TASKBAR_NEXT_QUICKSLOT	Nejbli pole rychlho pstupu [Shift+slice, Alt]
TASKBAR_PET_INFO	Info o mazlkovi
TASKBAR_PREV_QUICKSLOT	Pedchoz pole rychlho pstupu [Shift+slice]
TASKBAR_SYSTEM	Nastaven [ESC]
TOTAL_RANKING	Celkov hodnocen
WARP_MI_LABEL	K napadenmu Olti
WEEKLY_RANKING	Tdenn hodnocen
WHISPER_BAN	Blokovat
WHISPER_NAME	eptat
WHISPER_REPORT	
WHISPER_SEND	Poslat
YES	Ano
ZONE_MAP	Velk mapa
