ACCEPT	OK
ACCE_ABSORB	Bónusz abszorpció
ACCE_COMBINE	Kombináció
ACCE_MAIN	Pánt 1
ACCE_RESULT	Eredmény
ACCE_SERVE	Pánt 2
ATTACH_METIN_INFO	Használni akarod a Szellemkövet?
ATTACH_METIN_TITLE	Szellemkõ használata
ATTENDANCE_TITLE	Fõszörny-kaszáló esemény
ATTR_67_ADD	Bónusz hozzáadása
ATTR_67_ADD_TITLE	Bónusz hozzáadása
ATTR_67_MATERIAL_SLOT_TITLE	Erõszilánkok
ATTR_67_REGIST_SLOT_TITLE	Céltárgy
ATTR_67_SUPPORT_SLOT_TITLE	Erõsítõ
AURA_MAIN	Aura öltözék
AURA_SUB	Anyag
AUTO_AUTO_ATTACK	Támadás
AUTO_AUTO_POSITION	Bájitalok
AUTO_AUTO_RANGE	Kis hatókör
AUTO_AUTO_SKILL	Készségek
AUTO_CLEAR	Töröl
AUTO_END	Állj
AUTO_OFF	Ki
AUTO_ON	Be
AUTO_POSITION_SETTING	Bájitalok
AUTO_SAVE	Mentés
AUTO_SETTING	Beállítások
AUTO_SKILL_SETTING	Készségek
AUTO_START	Indítás
AUTO_TITLE	Auto-vadászat
BANNER_ATTENDANCE_BUTTON	Fõszörny-kaszáló esemény
BANNER_BLACK_AND_WHITE_BUTTON	Látók párbaja
BANNER_CATCHKING_BUTTON	Kapd el a Királyt
BANNER_EASTER_BUTTON	HÚSVÉT
BANNER_FISH_BUTTON	HAL-KIRAKÓS
BANNER_FLOWER_BUTTON	VIRÁGOK EREJE
BANNER_FOOTBALL_BUTTON	FOCI
BANNER_HALLOWEEN_BUTTON	HALLOWEEN
BANNER_LUCKY_EVENT	SZÖRNY-VADÁSZAT
BANNER_MINIBOSS_BUTTON	Zodiákus Apokalipszis
BANNER_MINI_GAME_FINDM	SZÖRNYHÁRMAS MEMÓ
BANNER_MONSTERBACK_BUTTON	Ütéspontok beváltása
BANNER_MYSTERY_BOX_BUTTON	ZSÁKMÁNY-VADÁSZAT I
BANNER_MYSTERY_BOX_BUTTON_2	ZSÁKMÁNY-VADÁSZAT II
BANNER_NEW_XMAS_BUTTON	KARÁCSONY
BANNER_OKEY_BUTTON	Okey esemény
BANNER_OLYMPIC_BUTTON	HÕS RENDEZVÉNY
BANNER_RAMADAN_BUTTON	RAMADÁN
BANNER_ROULETTE_BUTTON	Vér rituálé
BANNER_SOUL_BUTTON	LÉLEK RENDEZVÉNY
BANNER_SUMMER_BUTTON	NYÁRI RENDEZVÉNY
BANNER_VALENTINE_BUTTON	VALENTIN NAP
BANNER_YUTNORI_BUTTON	Yut Nori
BATTLE_FIELD_INFO	Harci övezet
BATTLE_FIELD_OPERATION_TIME	A Harci övezetbe %s:00 és %s:00 között lehet belépni.
BATTLE_FIELD_OPERATION_TIME_ALL	Jelenleg nyitva a belépéshez.
BATTLE_FIELD_OPERATION_TIME_END	A Harci övezet még nyitva %s órán át.
BATTLE_FIELD_OPERATION_TIME_NA	Pillanatnyilag lezárva a belépés elõl.
BATTLE_FIELD_OPERATION_TIME_OPEN	Megnyílik a belépésre %s óra múlva %s órára.
BATTLE_FILED_RANK	Helyezés
BATTLE_FILED_RANK_EMPIRE	Birodalom
BATTLE_FILED_RANK_NAME	Név
BATTLE_FILED_RANK_POINT	Pontok
BNW_GAME_UI_COM	Ellenfél
BNW_RANK_UI_COUNT	Adományok
BNW_RANK_UI_NAME	Név
BNW_RANK_UI_RANK	Helyezés
CANCEL	Megszakít
CHANGE_ATTR_SELECT	Bónusz megváltoztatása
CHANGE_PASSWORD_CONFIRM	Új jelszó ismét
CHANGE_PASSWORD_NEW	Új jelszó
CHANGE_PASSWORD_OLD	Régi jelszó
CHANGE_PASSWORD_TITLE	Jelszó változtatás
CHARACTER_ACTION	Akció
CHARACTER_EMOTICON	Érzelem
CHARACTER_MAIN	Karakter
CHARACTER_MUTUAL_ACTION	Interaktív akció
CHARACTER_NORMAL_ACTION	Normál akció
CHARACTER_QUEST	Küldetések
CHARACTER_SKILL	Képesség
CHARACTER_SPECTIAL_ACTION	Különleges akciók
CHAT_FILTER	Csetszûrõ
CHAT_FILTER_DICE	Kocka
CLOSE	Bezár
COMB_APPEARANCE	Cél
COMB_ATTRIBUTE	Kiindulás
COMB_MAIN	Cél
COMB_MATERIAL	Kiindulás
COMB_SKILLBOOK_TILE	Könyvekkel üzletelni
COMB_TITLE	
COSTUME_TITLE	Öltözékek
COSTUME_WINDOW_TITLE	Viseletek
CREATE_ATT_GRADE	Erõ
CREATE_CREATE	Létrehoz
CREATE_DEX_GRADE	ÜGY
CREATE_HP	VIT
CREATE_LAST_POINT	Pont
CREATE_MAN	Férfi
CREATE_NAME	Név
CREATE_NEXT	Tovább
CREATE_PREV	Vissza
CREATE_SEX	Neme
CREATE_SHAPE	Kinézet
CREATE_SP	INT
CREATE_STAT_RESET	Vissza
CREATE_WOMAN	Asszony
CUBE_INFO_TITLE	Finomítási kézikönyv
CUBE_RENEWAL_BELT_IMPROVE	Esély növelése
CUBE_RENEWAL_TITLE	Fejlesztés
CUBE_REQUIRE_MATERIAL	Szükséges anyagok
CUBE_REQUIRE_MATERIAL_OR	vagy
CUBE_TITLE	Nemesítési ablak
CURRENT_POINT	Jelenlegi pontok: %s
CZ_REWARD_WINDOW_TITLE	Zodiákus templom
DO_CHANGE_ATTR	Mehet
DO_REFINE	Nemesít
DRAGONSOUL_ACTIVATE	Aktiválás
DRAGONSOUL_CHANGE_ATTR_WINDOW_TITLE	Mitikus sárkánykõ bónuszának megváltoztatása
DRAGONSOUL_PAGE_BUTTON_1	Nyers
DRAGONSOUL_PAGE_BUTTON_2	Metszett
DRAGONSOUL_PAGE_BUTTON_3	Ritka
DRAGONSOUL_PAGE_BUTTON_4	Antik
DRAGONSOUL_PAGE_BUTTON_5	Legendás
DRAGONSOUL_PAGE_BUTTON_6	Mitikus
DRAGONSOUL_REFINE_WINDOW_TITLE	Nemesítési ablak
DRAGONSOUL_TAP_TITLE_1	Sárkánygyémánt
DRAGONSOUL_TAP_TITLE_2	Sárkányrubin
DRAGONSOUL_TAP_TITLE_3	Sárkányjáde
DRAGONSOUL_TAP_TITLE_4	Sárkányzafír
DRAGONSOUL_TAP_TITLE_5	Sárkánygránát
DRAGONSOUL_TAP_TITLE_6	Sárkányónix
DRAGONSOUL_TITLE	Sárkánykõ-alkímia
DUTCHAUCTION_BUTTON	Menj
DUTCHAUCTION_TITLE	Villám aukció
EMPIRE_A	Shinsoo
EMPIRE_ALL	Összes
EMPIRE_B	Chunjo
EMPIRE_C	Jinno
EMPIRE_EXIT	Bezár
EMPIRE_NEXT	Tovább
EMPIRE_PREV	Vissza
EMPIRE_SELECT	Választani
END_TIME	Aktív rendezvény
ENTER_BATTLE_FIELD	Belépni
EVENT_ALARM_TITLE	Rendezvények áttekintése
EVENT_NAME_TITLE	Név
EVENT_REWARD_TITLE	Jutalom
EXCHANGE_ACCEPT	OK
EXCHANGE_TITLE	Kereskedés
EXIT_BATTLE_FIELD	Tényleg el szeretnéd hagyni a Harci övezetet?
EXIT_BATTLE_FIELD_ON_DEAD	El akarod hagyni a Harci övezetet %d ponttal?
EXPIRED_TIME	A rendezvény véget ért.
FISHING_RENEWAL_TITLE	Horgászat
FRAGMENT_COMB_TITLE	Készségkönyvek kombinálása
GAMEOPTION_TITLE	Játék opciók
GAME_EXIT_OBSERVER	Megfigyelõ módot befejezni
GAME_GUILD_WAR_JOIN	Céhháborúba lép
GAME_HELP	Segítség
GAME_QUEST	Feladat
GAME_SKILL_UP	Képesség fejlesztés
GAME_STAT_UP	Státusz emelés
GEMSHOP_LEFTTIME	Hátralévõ idõ:
GEMSHOP_TITLA	GAYA PIAC
GRADE	Osztály
GRADE_SELECT	Osztály
GRAPHICONOFF_DROP_ITEM_APPLY	Alkalmaz
GRAPHICONOFF_DROP_ITEM_LEVEL	Tárgy dobás
GRAPHICONOFF_DROP_ITEM_LEVEL1	1
GRAPHICONOFF_DROP_ITEM_LEVEL1_TOOLTIP	Effekt & Név mutatása
GRAPHICONOFF_DROP_ITEM_LEVEL2	2
GRAPHICONOFF_DROP_ITEM_LEVEL2_TOOLTIP	Effekt elrejtése
GRAPHICONOFF_DROP_ITEM_LEVEL3	3
GRAPHICONOFF_DROP_ITEM_LEVEL3_TOOLTIP	Effekt & Név elrejtése
GRAPHICONOFF_DROP_ITEM_LEVEL4	4
GRAPHICONOFF_DROP_ITEM_LEVEL4_TOOLTIP	Tárgyak elrejtése & kurzorra nevek mutatása
GRAPHICONOFF_DROP_ITEM_LEVEL5	5
GRAPHICONOFF_DROP_ITEM_LEVEL5_TOOLTIP	Tárgyak & nevek elrejtése
GRAPHICONOFF_EFFECT_APPLY	Alkalmaz
GRAPHICONOFF_EFFECT_LEVEL	Effektek
GRAPHICONOFF_EFFECT_LEVEL1	1
GRAPHICONOFF_EFFECT_LEVEL1_TOOLTIP	Mindent mutat
GRAPHICONOFF_EFFECT_LEVEL2	2
GRAPHICONOFF_EFFECT_LEVEL2_TOOLTIP	Csak a saját és a szörnyek effektjei
GRAPHICONOFF_EFFECT_LEVEL3	3
GRAPHICONOFF_EFFECT_LEVEL3_TOOLTIP	Csak a saját és más játékosok effektjei
GRAPHICONOFF_EFFECT_LEVEL4	4
GRAPHICONOFF_EFFECT_LEVEL4_TOOLTIP	Csak saját
GRAPHICONOFF_EFFECT_LEVEL5	5
GRAPHICONOFF_EFFECT_LEVEL5_TOOLTIP	Mindent elrejt
GRAPHICONOFF_NPC_NAME_STATUS	NPC nevek
GRAPHICONOFF_NPC_NAME_STATUS_OFF	Ki
GRAPHICONOFF_NPC_NAME_STATUS_OFF_TOOLTIP	NPC nevek elrejtése
GRAPHICONOFF_NPC_NAME_STATUS_ON	Be
GRAPHICONOFF_NPC_NAME_STATUS_ON_TOOLTIP	NPC nevek mutatása
GRAPHICONOFF_PET_STATUS	Kedvencek
GRAPHICONOFF_PET_STATUS_OFF	Ki
GRAPHICONOFF_PET_STATUS_OFF_TOOLTIP	Kedvencek elrejtése
GRAPHICONOFF_PET_STATUS_ON	Be
GRAPHICONOFF_PET_STATUS_ON_TOOLTIP	Kedvencek mutatása
GRAPHICONOFF_PRIVATE_SHOP_APPLY	Alkalmaz
GRAPHICONOFF_PRIVATE_SHOP_LEVEL	Magán boltok
GRAPHICONOFF_PRIVATE_SHOP_LEVEL1	1
GRAPHICONOFF_PRIVATE_SHOP_LEVEL1_TOOLTIP	Mindent mutat
GRAPHICONOFF_PRIVATE_SHOP_LEVEL2	2
GRAPHICONOFF_PRIVATE_SHOP_LEVEL2_TOOLTIP	Minden megjelenítése nagy távolságban
GRAPHICONOFF_PRIVATE_SHOP_LEVEL3	3
GRAPHICONOFF_PRIVATE_SHOP_LEVEL3_TOOLTIP	Minden megjelenítése közepes távolságban
GRAPHICONOFF_PRIVATE_SHOP_LEVEL4	4
GRAPHICONOFF_PRIVATE_SHOP_LEVEL4_TOOLTIP	Minden megjelenítése kis távolságban
GRAPHICONOFF_PRIVATE_SHOP_LEVEL5	5
GRAPHICONOFF_PRIVATE_SHOP_LEVEL5_TOOLTIP	Minden megjelenítése a közvetlen közelben
GUILDWINDOW_BASE_BUFF	Céh-bónusz
GUILD_ATTENDANCE_LOCA1	Elsõ részvétel: 1x Bátorság medálja
GUILD_ATTENDANCE_LOCA2	10 vagy több: 1x Bátorság medálja
GUILD_ATTENDANCE_LOCA3	20 vagy több: 2x Bátorság medálja
GUILD_ATTENDANCE_LOCA4	30 vagy több: 4x Bátorság medálja
GUILD_ATTENDANCE_LOCA5	40 vagy több: 6x Bátorság medálja
GUILD_ATTENDANCE_LOCA6	50 vagy több: 8x Bátorság medálja
GUILD_ATTENDANCE_LOCA7	60 vagy több: 10x Bátorság medálja
GUILD_ATTENDANCE_LOCA8	70 vagy több: 12x Bátorság medálja
GUILD_ATTENDANCE_LOCA9	Indul: naponta 5:00 órakor
GUILD_ATTENDANCE_TITLE	Részvételi jutalom
GUILD_BANKINFO_CLOSE	Bezár
GUILD_BANKINFO_NAME	Tag
GUILD_BANKINFO_TITLE	Céhraktár log
GUILD_BANKINFO_TYPE	Tárgy/Fizetõeszköz
GUILD_BANKINFO_USETYPE	Akció
GUILD_BANK_CLOSE	Bezár
GUILD_BANK_INFO	Tárolóoldal:
GUILD_BANK_NUMBER	Bank number
GUILD_BASEINFO_BANK	Céhraktár
GUILD_BASEINFO_BANKLASTOUT	Ut. kivett tárgy
GUILD_BASEINFO_BUILDING	Céhépület
GUILD_BASEINFO_DEAL	Céhterület eladása
GUILD_BASEINFO_FACTORY	Céh-kovács
GUILD_BASEINFO_GOLDMANAGE	Tranzakció
GUILD_BASEINFO_GUILDLAND	Céhterület
GUILD_BASEINFO_LANDABANDON	Céhterület feloszlatása
GUILD_BASEINFO_LANDSCAPE	Egyéb
GUILD_BASEINFO_LOCALE	Elhelyezkedés
GUILD_BASEINFO_MONEY	Egyenleg
GUILD_BASEINFO_MONEYBANKINFO	Céhbank információ
GUILD_BASEINFO_MONEYIN	Betét
GUILD_BASEINFO_MONEYLASTOUT	Utolsó kivét
GUILD_BASEINFO_MONEYOUT	Kivét
GUILD_BASEINFO_POWER	Az Erõ oltára
GUILD_BASEINFO_SMEITER	Céh-alkimista
GUILD_BASEINFO_TITLE	Terület-információ
GUILD_BASEINFO_VOTE	Szavazás
GUILD_BASENAME	Bázisnév
GUILD_BOARD_ID	Név
GUILD_BOARD_REFRESH	Frissít
GUILD_BOARD_TEXT	Üzenet
GUILD_BUILDING_CATEGORY_TITLE	Építõ darabok
GUILD_BUILDING_CHANGE	Cserélni
GUILD_BUILDING_CHANGE_DELETE	Töröl
GUILD_BUILDING_CHANGE_FIX	Céh újjáépítése
GUILD_BUILDING_CHANGE_LIST	Céh-ingatlanlista
GUILD_BUILDING_DIRECTION	Irány
GUILD_BUILDING_FIX	Újjáépítés
GUILD_BUILDING_GRADE	Rang
GUILD_BUILDING_INFO	Épület- és költséginformációk
GUILD_BUILDING_LIST_TITLE	Épület lista
GUILD_BUILDING_LOG	Tönk
GUILD_BUILDING_NAME	Épület név
GUILD_BUILDING_OPERATE	Kiszolgál
GUILD_BUILDING_PLY	Furnér
GUILD_BUILDING_POSITION	Fekvés
GUILD_BUILDING_PREVIEW	Elõnézet
GUILD_BUILDING_PRICE	Ár
GUILD_BUILDING_REFRESH	Frissít
GUILD_BUILDING_STONE	Kõ
GUILD_BUILDING_TITLE	Céhház építés
GUILD_CRYSTAL	Kristály
GUILD_DEPOSIT	Fizetni
GUILD_DONATE_BUTTON_OVER_TEXT	Véletlenszerû tárgy
GUILD_DONATE_COUNT	Szabad adományozás: %d/%d
GUILD_DONATE_GET_MEDAL_OF_HONOR	%d
GUILD_DONATE_GUILD_EXP	Céh EXP
GUILD_DONATE_HIGH_MATERIAL	Nagy adomány
GUILD_DONATE_MEDAL_OF_HONOR	Bátorság medálja
GUILD_DONATE_MIDDLE_MATERIAL	Közepes adomány
GUILD_DONATE_MY_MEDAL_OF_HONOR	Bátorság medáljaim
GUILD_DONATE_NORMAL_MATERIAL	120.000 Yang
GUILD_DONATE_TAB_HIGH	Nagy adomány
GUILD_DONATE_TAB_MIDDLE	Közepes adomány
GUILD_DONATE_TAB_NORMAL	Kicsi adomány
GUILD_DONATE_TITLE	EXP adomány
GUILD_DRAGONLAIR_RANKING	Helyezések
GUILD_DRAGONLAIR_RANKING_COUNT	Rang
GUILD_DRAGONLAIR_RANKING_MEMBER	Tag
GUILD_DRAGONLAIR_RANKING_NAME	Céh
GUILD_DRAGONLAIR_RANKING_TIME	Idõ
GUILD_DROP_RESOURCE1	itt
GUILD_DROP_RESOURCE2	Erõforrás eldobás
GUILD_GEM	Drágakõ
GUILD_GRADE_CHANGE_GRADE_NAME	Új rang név
GUILD_GRADE_NUM	Nr.
GUILD_GRADE_PERMISSION_BANK	Használhatja a céhbankot és -raktárat
GUILD_GRADE_PERMISSION_DELETE	Eltávolítás a céhbõl
GUILD_GRADE_PERMISSION_JOIN	Felvehet játékost a céhbe
GUILD_GRADE_PERMISSION_NOTICE	Írhat céhüzenetet
GUILD_GRADE_PERMISSION_SKILL	Céh-készségek
GUILD_GRADE_PERMISSION_WAR	Kiválaszthat tagokat bajtársaknak
GUILD_GRADE_RANK	Rang
GUILD_GRADE_WRITE	Írni
GUILD_INFO	Céh információ
GUILD_INFO_CUR_EXP	Tapasztalat
GUILD_INFO_DECALRE_WAR	Hadat üzen
GUILD_INFO_ENEMY_GUILD	Ellenséges céh
GUILD_INFO_ENEMY_GUILD_EMPTY	Nincs
GUILD_INFO_LEVEL	Céh-szint
GUILD_INFO_MARK	Céh jel
GUILD_INFO_MASTER	Vezetõ
GUILD_INFO_MASTER_VALUE	Vezetõ
GUILD_INFO_MEMBER_AVG_LEVEL	Átlagos Szint
GUILD_INFO_MEMBER_NUM	Tagok száma
GUILD_INFO_NAME	Céh név
GUILD_INFO_NAME_VALUE	Ez egy céh név
GUILD_INFO_OFFER_EXP	Befektet
GUILD_INFO_REST_EXP	Szükséges tapasztalat
GUILD_INFO_UPLOAD_MARK	Jel feltöltés
GUILD_INFO_UPLOAD_SYMBOL	Zászló feltöltés
GUILD_LANDDEAL_VOTE	Céhterület eladása
GUILD_LANDDEAL_VOTE_DEALGOLD	Ár Yangban:
GUILD_LANDDEAL_VOTE_DEALGUILDNAME	Céhnév:
GUILD_MARK	Céh jel
GUILD_MASTER_CHANGE_TITLEBAR	Céhvezetés átadása
GUILD_MEMBER_JOB	Osztály
GUILD_MEMBER_KNIGHT	Bajtárs
GUILD_MEMBER_LEVEL	Szint
GUILD_MEMBER_NAME	Név
GUILD_MEMBER_OUT_TITLEBAR	Tag eltávolítása
GUILD_MEMBER_PACE_ATTENDANCE	Részvétel ({0}/{1})
GUILD_MEMBER_RANK	Rang
GUILD_MEMBER_SPECIFIC_GRAVITY	Befektet.
GUILD_MEMBER_VOTE_CHECK	Szavazatok ellenõrzése
GUILD_METIN_STONE	Szellemkõ
GUILD_MINENAL	Ásvány
GUILD_MONEY	Yang
GUILD_NAME	Céh
GUILD_RESOURCE_INFO	Forrás információk
GUILD_SKILLPAGE_LADDER	Rangpontok
GUILD_SKILLPAGE_RANK	Rang
GUILD_SKILL_ACTIVE	Aktív
GUILD_SKIlL_HEAL_GSP	Feltölteni
GUILD_SKILL_PASSIVE	Passzív
GUILD_SKILL_POWER	Energia
GUILD_SKILL_STATE	Céh képesség
GUILD_SYMBOL	Céh zászló
GUILD_WAR_ACCEPT	Céh hadüzenet elfogadása
GUILD_WAR_ALLSCORE	Minden háború
GUILD_WAR_BATTLE_TYPE	Harci mód
GUILD_WAR_CTF	Zászló
GUILD_WAR_DECLARE	Céh háborút kinyilvánít
GUILD_WAR_ENEMY	Ellenség
GUILD_WAR_GAINSCORE	Pontok
GUILD_WAR_GAINSCORE_FIFTY	50
GUILD_WAR_GAINSCORE_HUNDRED	100
GUILD_WAR_GAINSCORE_THIRTY	30
GUILD_WAR_GAMETIME	Csata ideje
GUILD_WAR_GAMETIME_SIXTY	60 perc
GUILD_WAR_GAMETIME_TEN	10 perc
GUILD_WAR_GAMETIME_THIRTY	30 perc
GUILD_WAR_JOINMEMBER	Tagok
GUILD_WAR_JOINMEMBER_COUNT	Tagok
GUILD_WAR_JOINMEMBER_FIFTEEN	15
GUILD_WAR_JOINMEMBER_FIVE	5
GUILD_WAR_JOINMEMBER_TEN	10
GUILD_WAR_NORMAL	Harcmezõ
GUILD_WAR_REPORT	Csatajelentés
GUILD_WAR_REPORTLIST	Áttekintés (Csaták: Cs, Gyõzelmek: Gy, Vereségek: V, Döntetlenek: D)
GUILD_WAR_SCORE	Csatajelentés
GUILD_WAR_SKILL	Céh-készségek
GUILD_WAR_TYPE_DEFENSE	Pajzs-harc
GUILD_WAR_TYPE_DIE	Aréna-harc
GUILD_WAR_TYPE_FLAG	Kapd el a zászlót
GUILD_WAR_TYPE_NORMAL	Mezei harc
GUILD_WAR_TYPE_TIGER	Megsemmisítés
GUILD_WAR_TYPE_TIME	Támadás idõre
GUILD_WAR_WARP	Aréna
GUILD_WAR_WIN	Menetek
GUILD_WAR_WIN_FIVE	5
GUILD_WAR_WIN_ONE	1
GUILD_WAR_WIN_THREE	3
GUILD_WATER	Víz
GUILD_WATER_STONE	Aqua kõ
GUILD_WITHDRAW	Kivon
HELP_ATTACK	Egérkattintásonként egyszeri támadást aktivál.
HELP_ATTACK_KEY	Támadás: bal egérgomb vagy szóköz billentyû
HELP_AUTO_ATTACK	Egérkattintásonként automatikus támadást aktivál.
HELP_CAMERA	Kameranézet
HELP_CHANGE_PK_MODE	Támadási mód váltás: bal egérgomb beállítása
HELP_CHARACTER_BUTTON1	(Karakter ablak, Leltár ablak,
HELP_CHARACTER_BUTTON2	Barátlista és Beállítások)
HELP_CHAT	Egy bizonyos csoportban való beszélgetéshez kezdd üzeneted a következõk egyikével: !(hívás), #(csoport cset) vagy %(céh cset).
HELP_CLICK_OTHER_PLAYER	Jobb kattintás a másik játékoson kereskedéshez, csoportalakításhoz, vagy hogy kihívd párbajra.
HELP_CONTROL_CAMERA_BY_MIDDLEBUTTON	Alapértelmezett kameraállás: középsõ egérgomb
HELP_CONTROL_CAMERA_BY_RIGHTBUTTON	Alternatív kameraállás: hozzárendelés a jobb vagy bal egérgombhoz
HELP_EMOTINO	Mutasd ki érzelmeid a <CTRL> + <1~9> billentyûkombinációkkal.
HELP_EXP	Tapasztalat
HELP_FURY	Játékbeli tárgy piac
HELP_GUILD_WINDOW	Céh ablak megnyitása: Alt+G
HELP_HELP	Segítség megmutatása: H
HELP_HELP_KEY	Az alapértelmezett beállítások megjelennek a segítség képernyõn.
HELP_HP	Életerõ (TP)
HELP_KEYSETTING	Kicserélheted a rögzített billentyûidet a játék beállításokban.
HELP_MESSENGER_WINDOW	Barátlista megnyitása: Alt+M
HELP_MINIMAP	Megmutatja a minitérképet.
HELP_MINIMAP_QUEST	A küldetések villogó ikonokként jelennek meg a minitérképen és a nagy térképen.
HELP_MOUSE_LEFT	Bal egérgomb funkció
HELP_MOUSE_RIGHT	Jobb egérgomb funkció
HELP_MOVE_KEY	Vezérlés: W, A, S, D, vagy nyíl billentyûk
HELP_OFF_QUESTSCROLL	Jelenítsd meg/rejtsd el a küldetéstekercseket a <CTRL> + Q-val.
HELP_OPEN_CHARACTER	Karakter ablak megnyitása: C
HELP_OPEN_CHAT	Cset ablak megnyitása: Enter
HELP_OPEN_INVENTORY	Leltár ablak megnyitása: I
HELP_OPEN_LOG	Cset-log megnyitása: L
HELP_OPEN_MINIMAP	Mini térkép megnyitása: Shift + M
HELP_OPEN_QUEST	Feladat ablak megnyitása: N
HELP_OPEN_SKILL	Képesség ablak megnyitása: V
HELP_OPEN_WHISPER	Suttogás ablak megnyitása: Shift + Enter
HELP_OPEN_ZONEMAP	Nagy térkép megnyitása: M
HELP_PICK_ITEM	Tárgyak összegyûjtése: 0 vagy Y billentyû, vagy bal egérgomb
HELP_QUICKSLOT	Gyors elérési mezõk
HELP_SCREEN_CAPTURE	Képernyõkép mentése: Nyomtatás (a "Metin2\screenshot" könyvtárban lesz elmentve egy fájlba)
HELP_SERVER	Kijelzi a szervert és a csatornát.
HELP_SHOW_ALL_NAME	Nevek megmutatása: Alt
HELP_SKILL	Itt használhatsz egy készséget a jobb egérgombbal.
HELP_SP	Mana pontok (MP)
HELP_SYSTEM_BUTTON	Rendszer billentyûk
INVENTORY_PAGE_BUTTON_TOOLTIP_1	1. leltár
INVENTORY_PAGE_BUTTON_TOOLTIP_2	2. leltár
INVENTORY_PAGE_BUTTON_TOOLTIP_3	3. leltár
INVENTORY_PAGE_BUTTON_TOOLTIP_4	4. leltár
INVENTORY_TITLE	Leltár
ITEM_MALL	Tárgy piac
KEYCHANGE_ACTION_WINDOW	Akciók
KEYCHANGE_ATTACK	Támadás
KEYCHANGE_AUTORUN	Auto. futás
KEYCHANGE_AUTO_WINDOW	Auto-vadászat
KEYCHANGE_BASEACTION	Standard gombok
KEYCHANGE_CAM_DOWN1	Kamera (le)
KEYCHANGE_CAM_DOWN2	Kamera (le)
KEYCHANGE_CAM_LEFT1	Kamera (bal)
KEYCHANGE_CAM_LEFT2	Kamera (bal)
KEYCHANGE_CAM_RIGHT1	Kamera (jobb)
KEYCHANGE_CAM_RIGHT2	Kamera (jobb)
KEYCHANGE_CAM_UP1	Kamera (fel)
KEYCHANGE_CAM_UP2	Kamera (fel)
KEYCHANGE_CAM_ZOOM_IN1	Kamera (közelít)
KEYCHANGE_CAM_ZOOM_IN2	Kamera (közelít)
KEYCHANGE_CAM_ZOOM_OUT1	Kamera (távolít)
KEYCHANGE_CAM_ZOOM_OUT2	Kamera (távolít)
KEYCHANGE_CANCLE	Mégsem
KEYCHANGE_CHAT_WINDOW	Csetlog
KEYCHANGE_CLEAR	Standard
KEYCHANGE_DDS_WINDOW	DSS
KEYCHANGE_DOWN1	Hátra
KEYCHANGE_DOWN2	Hátra
KEYCHANGE_DSS1	DS [Ég]
KEYCHANGE_DSS2	DS [Föld]
KEYCHANGE_EMOTION1	Érzelem (szomorú)
KEYCHANGE_EMOTION2	Érzelem (Yang)
KEYCHANGE_EMOTION3	Érzelem (zene)
KEYCHANGE_EMOTION4	Érzelem (szív)
KEYCHANGE_EMOTION5	Érzelem (szívek)
KEYCHANGE_EMOTION6	Érzelem (bomba)
KEYCHANGE_EMOTION7	Érzelem (ötlet)
KEYCHANGE_EMOTION8	Érzelem (vihar)
KEYCHANGE_EMOTION9	Érzelem (sajnálat)
KEYCHANGE_GUILD_WINDOW	Céh
KEYCHANGE_HELP_WINDOW	Segítség
KEYCHANGE_IMPOSSIBLE_CHANGE	[CTRL], [ALT], [SHIFT] itt nincs engedélyezve!
KEYCHANGE_INGAMEEVENT	RENDEZVÉNY
KEYCHANGE_INTERFACE	Ablak
KEYCHANGE_INVENTORY_WINDOW	Leltár
KEYCHANGE_KEY_SETTING	Billentyûzet beállítások
KEYCHANGE_LEFT1	Bal
KEYCHANGE_LEFT2	Bal
KEYCHANGE_MESSENGER_WINDOW	Barátok
KEYCHANGE_MINIMAP_MINER	Minitérkép (-)
KEYCHANGE_MINIMAP_PLUS	Minitérkép (+)
KEYCHANGE_MINIMAP_WINDOW	Nagy térkép
KEYCHANGE_MONSTER_CARD_WINDOW	Szörnykártya
KEYCHANGE_NEXT_TARGET	Következõ célpont
KEYCHANGE_PARTY_MATCH_WINDOW	Csoport keresés
KEYCHANGE_PET_WINDOW	Házikedvenc
KEYCHANGE_QUEST_SCROLL_ONOFF	Küldetéstekercsek
KEYCHANGE_QUEST_WINDOW	Küldetések
KEYCHANGE_QUICKSLOT1	1-es szint
KEYCHANGE_QUICKSLOT2	2-es szint
KEYCHANGE_QUICKSLOT3	3-as szint
KEYCHANGE_QUICKSLOT4	4-es szint
KEYCHANGE_RIDE	Hátas
KEYCHANGE_RIDE_BYE	Ló elküldése
KEYCHANGE_RIDE_HORSE	Hátas
KEYCHANGE_RIDE_PEED	Ló etetése
KEYCHANGE_RIGHT1	Jobb
KEYCHANGE_RIGHT2	Jobb
KEYCHANGE_ROOT1	Felvesz
KEYCHANGE_ROOT2	Felvesz
KEYCHANGE_SAVE	Mentés
KEYCHANGE_SCREENSHOT	Képernyõkép
KEYCHANGE_SHOW_NAME	Nevek mutatása
KEYCHANGE_SKILL_WINDOW	Készségek
KEYCHANGE_SLOT1	1-es hely
KEYCHANGE_SLOT2	2-es hely
KEYCHANGE_SLOT3	3-as hely
KEYCHANGE_SLOT4	4-es hely
KEYCHANGE_SLOT5	5-ös hely
KEYCHANGE_SLOT6	6-os hely
KEYCHANGE_SLOT7	7-es hely
KEYCHANGE_SLOT8	8-as hely
KEYCHANGE_SLOT_KET	Gyorsgombok
KEYCHANGE_STATUS_WINDOW	Karakter
KEYCHANGE_UP1	Elõre
KEYCHANGE_UP2	Elõre
LANGUAGE_AE	Arab
LANGUAGE_CZ	Cseh
LANGUAGE_DE	Német
LANGUAGE_DK	Dán
LANGUAGE_EN	Angol
LANGUAGE_ES	Spanyol
LANGUAGE_FR	Francia
LANGUAGE_GR	Görög
LANGUAGE_HU	Magyar
LANGUAGE_IT	Olasz
LANGUAGE_NL	Holland
LANGUAGE_PL	Lengyel
LANGUAGE_PT	Portugál
LANGUAGE_RO	Román
LANGUAGE_RU	Orosz
LANGUAGE_TR	Török
LOAD_ERROR	Az adatfájl megsérült. Installáld újra a klienst. Nyomd meg az ESC gombot.
LOGIN_CONNECT	Csatlakozik
LOGIN_CONNECTING	A szerverhez leszel kapcsolva.
LOGIN_DEFAULT_SERVERADDR	Szervernév, 1. csatorna
LOGIN_EXIT	Bezár
LOGIN_ID	Felhasználónév
LOGIN_PASSWORD	Jelszó
LOGIN_REGION_TITLE	Számlakibocsátás helyszíne
LOGIN_SELECT_BUTTON	Választ
LOGIN_SELECT_EXIT	Bezár
LOGIN_SELECT_OK	OK
LOGIN_SELECT_TITLE	Szervert választ
LUCKY_BOX_NOTICE_YANG	Új tárgy választásának Yang költsége
LUCKY_BOX_RECV_BUTTON	Tárgy elfogadása
LUCKY_BOX_RECV_NAME	Tartalma:
LUCKY_BOX_RETRY_BUTTON	Próba-szerencse: új tárgy
LUCKY_BOX_TITLE_NAME	Szerencse-láda
MAILBOX_POST_ALL_DELETE_BUTTON	Összes törlése
MAILBOX_POST_ALL_RECEIVE	Összes begyûjtése
MAILBOX_POST_READ_BLOCK	Blokkol
MAILBOX_POST_READ_DELETE	Töröl
MAILBOX_POST_READ_FROM	Feladó
MAILBOX_POST_READ_MAIN_TITLE	Üzenet
MAILBOX_POST_READ_RECV	Begyûjt
MAILBOX_POST_READ_TITLE	Tárgy
MAILBOX_POST_SEND_TITLE	Üzenet
MAILBOX_POST_WRITE_BUTTON_TEXT	Küldés
MAILBOX_POST_WRITE_CLOSE_TEXT	Bezár
MAILBOX_POST_WRITE_CONFIRM_TEXT	Címzett ellenõrzése
MAILBOX_POST_WRITE_SEND_TEXT	Küldés
MAILBOX_POST_WRITE_TITLE	Tárgy
MAILBOX_POST_WRITE_TO	Címzett
MAILBOX_TITLE	Bejövõ üzenetek
MALL_PASSWORD_TITLE	Jelszó
MALL_TITLE	Tárgypiac raktár
MARKET_TITLE	Betölt
MARKLIST_REFRESH	Aktualizál
MARKLIST_TITLE	Céh jelet regisztrál
MC_EXCHANGE_BUTTON	Csere
MC_MISSION_INIT_BUTTON	Megbízásszint-visszaállítás
MC_MOTION_BUTTON	Mozgás
MC_POLY_BUTTON	Átváltozás
MC_PROMOTION_BUTTON	Elõléptetés
MC_REQUEST_MISSION_BUTTON	Megbízás elfogadása
MC_REWARD_CARD_BUTTON	Gyûjts Szörnykártyát
MC_SHUFFLE_BUTTON	Megbízáskártyák megkeverése
MC_SUMMON_BUTTON	Idézés
MC_TAB_BUTTON_CARD_MISSION	Kártya megbízás
MC_TAB_BUTTON_PARTY	Kazamata-gyûjtemény
MC_TAB_BUTTON_SOLO	Nyílt terep-gyûjtemény
MC_WARP_BUTTON	Teleport
MESSAGE	Ez egy üzenet
MESSENGER_ADD_FRIEND	Barát hozzáadása
MESSENGER_BLOCK_FRIEND	Blokkol
MESSENGER_DELETE_FRIEND	Töröl
MESSENGER_MOBILE	SMS köldés
MESSENGER_OPEN_GUILD	Céh ablak nyitás
MESSENGER_TITLE	Barát
MESSENGER_USE_GUILD_MOVE_SKILL	Használd a céh mozgatókészséget
MESSENGER_WHISPER	Súgás
MINIGAME_FISH_EVENT_USE_COUNT	Darab
MINIMIZE	Minimalizál
MINI_BOSS_DUNGEON_DESC_BTN	Rendezvény-szabályok
MINI_BOSS_DUNGEON_TITLE_NAME	Név
MINI_BOSS_DUNGEON_TITLE_NUM	Helyezés
MINI_BOSS_DUNGEON_TITLE_POINT	Apokalipszis-pontok
MINI_BOSS_DUNGEON_TOOTIP_01	Kazamata áttekintés
MINI_BOSS_DUNGEON_TOOTIP_02	Apokalipszis 40-80. szint közöttieknek
MINI_BOSS_DUNGEON_TOOTIP_03	Apokalipszis 81. szint felettieknek
MINI_BOSS_DUNGEON_TOOTIP_04	Belépés
MINI_BOSS_DUNGEON_TOOTIP_05	Maradék idõ
MINI_BOSS_DUNGEON_TOOTIP_06	Apokalipszis pontjaim
MINI_BOSS_DUNGEON_TOOTIP_07	Hátralévõ Apokalipszisek
MINI_BOSS_DUNGEON_TOOTIP_08	Jutalmam
MINI_BOSS_TITLE	Zodiákus Apokalipszis
MINI_GAME_BLACK_AND_WHITE_DONATE	Adományozás
MINI_GAME_BLACK_AND_WHITE_GAME_TITLE	Látók párbaja
MINI_GAME_BLACK_AND_WHITE_RANK_BUTTON	Helyezések
MINI_GAME_BLACK_AND_WHITE_REWARD_TRADE	Díjak
MINI_GAME_BLACK_AND_WHITE_START_BUTTON	Indítás
MINI_GAME_BLACK_AND_WHITE_WAITTING_TITLE	Látók párbaja
MINI_GAME_CATCHKING_CHALLENGE	Tét
MINI_GAME_CATCHKING_HELP_TEXT	Szabályok
MINI_GAME_CATCHKING_HIGH_SCORE	Rekord
MINI_GAME_CATCHKING_MYNUMBER	Kártyám
MINI_GAME_CATCHKING_POPUP_CONFIRM	Pop-up be/ki
MINI_GAME_CATCHKING_RETRY	Játssz újra
MINI_GAME_CATCHKING_REWARD	Jutalmad
MINI_GAME_CATCHKING_SCORE	Pontszám
MINI_GAME_CATCHKING_SELECTION_NUMBER	Felfedett kártya
MINI_GAME_CATCHKING_START_TEXT	Indítás
MINI_GAME_CATCHKING_TITLE	Kapd el a Királyt
MINI_GAME_FINDM_HINT_BTN	Segítség
MINI_GAME_FINDM_START_BTN	Játék indítása
MINI_GAME_FINDM_TITLE	Szörnyhármas memó
MINI_GAME_FINDM_TRY_COUNT_TEXT	Próbálkozások
MINI_GAME_FINDM_UPGRADE_BAR1	Tárgy
MINI_GAME_FINDM_UPGRADE_BAR2	Díj (Yang)
MINI_GAME_FINDM_UPGRADE_RECV	Tárgy begyûjtése
MINI_GAME_FINDM_UPGRADE_RETRY	Fejlesztés megpróbálása
MINI_GAME_FINDM_UPGRADE_TITLE	Jutalom fejlesztése
MINI_GAME_FISH_HELP_TEXT	Súgó
MINI_GAME_FISH_START_TEXT	Indítás
MINI_GAME_FISH_TITLE	Hal-kirakós
MINI_GAME_RUMI_DISCARD_TEXT	Biztonságos mód
MINI_GAME_RUMI_EXIT	Vége
MINI_GAME_RUMI_LBUTTON_DESC	Bal kattintás kártya hozzáadásához
MINI_GAME_RUMI_RBUTTON_DESC	Jobb kattintás kártya elvetéséhez
MINI_GAME_RUMI_SCORE	Pontszám
MINI_GAME_RUMI_START_TEXT	Kezdés
MINI_GAME_RUMI_TITLE	Metin2 Okey kártyajáték
MINI_GAME_YUTNORI_COM_TEXT	Számítógép
MINI_GAME_YUTNORI_PLAYER_TEXT	Játékos
MINI_GAME_YUTNORI_PROBABILITY	Valószínûség
MINI_GAME_YUTNORI_PROB_DESC	Válassz egy Yut értéket, aminek emelkedjen az esélye dobáskor.
MINI_GAME_YUTNORI_REMAIN_COUNT	Körök
MINI_GAME_YUTNORI_REWARD_TEXT	Jutalom
MINI_GAME_YUTNORI_SCORE	Pontszám
MINI_GAME_YUTNORI_START_TEXT	Indítás
MINI_GAME_YUTNORI_THROW	Dobás
MINI_GAME_YUTNORI_TITLE	Yut Nori
MINI_GAME_YUTNORI_YUTSEM1	Do
MINI_GAME_YUTNORI_YUTSEM2	Gae
MINI_GAME_YUTNORI_YUTSEM3	Geol
MINI_GAME_YUTNORI_YUTSEM4	Yut
MINI_GAME_YUTNORI_YUTSEM5	Mo
MINI_GAME_YUTNORI_YUTSEM6	Back Do
MISTS_ISLAND_EMPIRE_NAME	Birodalom neve
MISTS_ISLAND_EMPIRE_SCORE	Birodalom pontszáma
MISTS_ISLAND_END_TIME	Befejezés ideje
MISTS_ISLAND_EXIT	Kilépés
MISTS_ISLAND_INFO_TEXT	Rang/státusz információ
MISTS_ISLAND_RANK	Helyezés
MISTS_ISLAND_SCORE	Pontszám
MISTS_ISLAND_TITLE_RANK	Rang/státusz információ
MISTS_ISLAND_TITLE_SCORE	Áttekintés
MOUSEBUTTON_ATTACK	Támad
MOUSEBUTTON_AUTO_ATTACK	Automatikus támadás
MOUSEBUTTON_CAMERA	Kamera
MOUSEBUTTON_SKILL	Készség
MUSICLIST_TITLE	Zene választás
MYSHOP_DECO_CANCEL	Bezár
MYSHOP_DECO_DEFAULT	Alapértelmezett
MYSHOP_DECO_NEXT	Következõ
MYSHOP_DECO_OK	Megerõsít
MYSHOP_DECO_PREV	Vissza
MYSHOP_DECO_SELECT_MODEL	Válaszd ki boltod megjelenését!
MYSHOP_DECO_SELECT_TITLE	Válaszd ki neved megjelenését!
NO	Nem
OK	OK
OPPOSITES	Visszautasít
OPTION_ALWAYS_SHOW_NAME	Név
OPTION_ALWAYS_SHOW_NAME_OFF	Korlátozott
OPTION_ALWAYS_SHOW_NAME_ON	Mindig
OPTION_BLOCK	Letilt
OPTION_BLOCK_EXCHANGE	Kereskedés
OPTION_BLOCK_FRIEND	Barátok
OPTION_BLOCK_GUILD	Céh
OPTION_BLOCK_PARTY	Csoport
OPTION_BLOCK_PARTY_REQUEST	Kérés
OPTION_BLOCK_WHISPER	Súgás
OPTION_CAMERA_DISTANCE	Kamera
OPTION_CAMERA_DISTANCE_LONG	Távoli
OPTION_CAMERA_DISTANCE_SHORT	Közeli
OPTION_DELETE_MOBILE_BUTTON	Telefonszám törlés
OPTION_EFFECT	Találati info.
OPTION_ENV_EFFECT	Környezet
OPTION_ENV_EFFECT_OFF	Ki
OPTION_ENV_EFFECT_ON	Be
OPTION_FOG	Köd
OPTION_FOG_DENSE	Sok
OPTION_FOG_LIGHT	Kevés
OPTION_FOG_MIDDLE	Közepes
OPTION_FOG_OFF	Ki
OPTION_FOG_ON	Be
OPTION_INPUT_MOBILE_BUTTON	Mobiltelefonszám megadása
OPTION_KEY_SETTING	Billentyûzet
OPTION_LANGUAGE_CHANGE	OK
OPTION_LANGUAGE_SELECT	Nyelv
OPTION_MOBILE	Mobiltelefon
OPTION_MOB_INFO	Szörny-infó
OPTION_MOB_INFO_AGGR	Agresszív
OPTION_MOB_INFO_LEVEL	Szint
OPTION_MUSIC	Zene
OPTION_MUSIC_CHANGE	Váltani
OPTION_MUSIC_DEFAULT_THEMA	Metin2 alap zene
OPTION_NAME_COLOR	Szín név
OPTION_NAME_COLOR_EMPIRE	Birod. Szín
OPTION_NAME_COLOR_NORMAL	Normális
OPTION_NIGHT_MODE	Éjjel
OPTION_NIGHT_MODE_OFF	Ki
OPTION_NIGHT_MODE_ON	Be
OPTION_PVPMODE	PvP Mód
OPTION_PVPMODE_FREE	Szabad
OPTION_PVPMODE_FREE_TOOLTIP	Minden játékost megtámadhatsz.
OPTION_PVPMODE_GUILD	Céh
OPTION_PVPMODE_GUILD_TOOLTIP	Céhtagokat kivéve minden játékost megtámadhatsz.
OPTION_PVPMODE_PEACE	Béke
OPTION_PVPMODE_PEACE_TOOLTIP	Nem támadhatod meg a saját birodalmad játékosait.
OPTION_PVPMODE_REVENGE	Ellenség
OPTION_PVPMODE_REVENGE_TOOLTIP	Csak eltérõ világképû játékost támadhatsz meg.
OPTION_SALESTEXT	Bolt név
OPTION_SALESTEXT_VIEW_OFF	Elrejt
OPTION_SALESTEXT_VIEW_ON	Mutat
OPTION_SETTING	Megnyit
OPTION_SNOW_MODE	Hóesés
OPTION_SNOW_MODE_OFF	Ki
OPTION_SNOW_MODE_ON	Be
OPTION_SNOW_TEXTURE_MODE	Hó
OPTION_SNOW_TEXTURE_MODE_OFF	Ki
OPTION_SNOW_TEXTURE_MODE_ON	Be
OPTION_SOUND	Hatás
OPTION_TARGET_BOARD	Cél menü
OPTION_TARGET_BOARD_NO_VIEW	Bezár
OPTION_TARGET_BOARD_VIEW	Megmutat
OPTION_TITLE	Opciók
OPTION_VIEW_CHAT	Cset sor
OPTION_VIEW_CHAT_OFF	Elrejt
OPTION_VIEW_CHAT_ON	Mutat
PARTY_MATCH_TEXT_DUNGEON_NAME	Kazamata
PARTY_MATCH_TEXT_DUNGEON_SELECT	Válassz kazamatát
PARTY_MATCH_TEXT_ENTREE_LEVEL	Szint: %d
PARTY_MATCH_TEXT_LEVEL_LIMIT	Szint követelmény
PARTY_MATCH_TEXT_REQUEST_MATCH	Keresés
PARTY_MATCH_TEXT_REQUEST_MATCH_CANCEL	Mégse
PARTY_MATCH_TEXT_REQUIRED_ITEMS	Szükséges tárgy
PARTY_MEMBER_INFO_NAME	Csoporttárs neve
PASSWORD_DESC_1	Írd be a jelszavad
PASSWORD_DESC_2	a raktár megnyitásához.
PASSWORD_DESC_3	Megváltoztattad már a jelszavad?
PASSWORD_DESC_4	Ha még nem, a jelszavad "000000" lesz.
PASSWORD_DESC_5	Változtasd meg a jelszavad a raktárban.
PASSWORD_TITLE	Jelszó mentés
PET_AGE_TEXT	Kedvenc kora
PET_ATTR_CHANGE_ITEM_TEXT	Kedvenc megbûvölõ
PET_ATTR_CHANGE_TITLE	Házikedvenc típus megváltoztatása
PET_ATTR_CONFIRMATION	Változtat
PET_ATTR_DETERMINE_TITLE	Új kedvenc típus
PET_ATTR_OK	Bezár
PET_CHANGE_TEXT	Házikedvenc
PET_FEED_TITLE	Etetés
PET_FFED_BUTTON_TEXT	Etetés
PET_HATCHING_BUTTON	Kikelés
PET_HATCHING_NIK	Kedvenc neve
PET_HATCHING_WINDOW_TITLE	Inkubátor
PET_INFORMATION_ABILITIES	Bónuszok
PET_INFORMATION_AGE	Kor
PET_INFORMATION_COSTUME_BONUS	Öltözék bónusz
PET_INFORMATION_DEFENCE	Védekezés
PET_INFORMATION_EVOL_BUTTON	Nevelés
PET_INFORMATION_EXP	Tapasztalat
PET_INFORMATION_EXP_BUTTON	Tárgy EXP
PET_INFORMATION_HP	TP
PET_INFORMATION_LEVEL	Szint
PET_INFORMATION_LIFE	Idõtartam
PET_INFORMATION_LIFETIME_BUTTON	Etetés
PET_INFORMATION_LIFE_TIME	Óra
PET_INFORMATION_SKILL	Készség
PET_INFORMATION_SP	MP
PET_INFORMATION_TITLE	Házikedvenc
PET_NAME_CHANGE_BUTTON	Csere
PET_NAME_CHANGE_WINDOW_TITLE	Névváltoztatás
PET_REVIVE_BUTTON	Felélesztés
PET_REVIVE_CANCEL_BUTTON	Mégse
PET_REVIVE_MATERIAL_TITLE	Anyag
PET_REVIVE_REUSLT_TEXT	Eredmény
PET_REVIVE_TARGET	Felélesztendõ kedvenc
PET_REVIVE_TITLE	Házikedvenc felélesztése
PICK_MONEY_TITLE	Feloszt
PRIVATESHOPSEARCH_BUY	Vásárol
PRIVATESHOPSEARCH_COUNT	Mennyiség
PRIVATESHOPSEARCH_ITEMNAME	Név
PRIVATESHOPSEARCH_ITEMTYPE	Tárgyak
PRIVATESHOPSEARCH_JOB	Osztály
PRIVATESHOPSEARCH_LEVEL	Szint
PRIVATESHOPSEARCH_PRICE	Ár
PRIVATESHOPSEARCH_REFINE	Tárgyszint
PRIVATESHOPSEARCH_SEARCH	Keresés
PRIVATESHOPSEARCH_SEARCH_BAR	Keresés
PRIVATESHOPSEARCH_SELECT	Választás
PRIVATESHOPSEARCH_SELLER	Eladó
PRIVATE_SHOP_CLOSE_BUTTON	Bolt zárás
PRIVATE_SHOP_NAME	Bolt neve
PRIVATE_SHOP_TITLE	Magán bolt nyitás
QUEST_UI_TEXT_COLLECTION	Biológus küldetések
QUEST_UI_TEXT_DAILY	Napi küldetés
QUEST_UI_TEXT_EVENT	Esemény küldetések
QUEST_UI_TEXT_LEVELUP	Vadászküldetések
QUEST_UI_TEXT_MAIN	Fõküldetések
QUEST_UI_TEXT_SCROLL	Missziókönyv küldetések
QUEST_UI_TEXT_SUB	Mellékküldetések
QUEST_UI_TEXT_SYSTEM	Játék küldetések
REFINE_COST	Javítási költségek: 0 Yang
REFINE_ELEMENT_CHANGE_COST_TITLE	Ára
REFINE_ELEMENT_CHANGE_DARK	Sötétség
REFINE_ELEMENT_CHANGE_EARTH	Föld
REFINE_ELEMENT_CHANGE_ELECT	Villám
REFINE_ELEMENT_CHANGE_FIRE	Tûz
REFINE_ELEMENT_CHANGE_ICE	Jég
REFINE_ELEMENT_CHANGE_TITLE	Elem megváltoztatása
REFINE_ELEMENT_CHANGE_WIND	Szél
REFINE_ELEMENT_DOWNGRADE_TITLE	Visszafejlesztés
REFINE_ELEMENT_UPGRADE_TITLE	Fejlesztés
REFINE_INFO	Esély a sikeres javításra: 100%
REFINE_MONEY	Nemesítési díj
REFINE_SELECT	Nemesítés
REFINE_TTILE	Javítások
REPORT_VIOLENT_WHISPER	
RESTART_GIVEUP	Feladás
RESTART_HERE	Újraindít itt
RESTART_IMMEDIATE	Újraélesztõ
RESTART_TOWN	Újraindít a városban
ROULETTE_SPECIAL_TITLE	Jutalmak (%s)
ROULETTE_SPIN_TEXT1	FORGAT
ROULETTE_SPIN_TEXT2	50 lélek
ROULETTE_SPIN_TEXT3	250.000 Yang
ROULETTE_TITLE	Jutalmak
SAFE_CHANGE_PASSWORD	Jelszó változtatás
SAFE_TITLE	Tárolóhely
SELECT_ATTR_CHANGED	Új
SELECT_ATTR_CURRENT	Jelenlegi
SELECT_ATTR_SELECT	Választás
SELECT_ATTR_TITLE	Megbûvölõ tárgy+
SELECT_ATT_GRADE	ERÕ
SELECT_CREATE	Létrehoz
SELECT_DELETE	Töröl
SELECT_DEX_GRADE	ÜGY
SELECT_EMPIRE_NAME	Birodalom neve
SELECT_EXIT	Bezár
SELECT_HP	VIT
SELECT_LEVEL	Szint
SELECT_METIN_STONE_TITLE	Szellemkõ választás
SELECT_NAME	Név
SELECT_NO_GUILD	Nincs céh
SELECT_PLAYTIME	Játékidõ
SELECT_SELECT	Start
SELECT_SP	INT
SELECT_TITLE	Cím választás
SHOP_BUY	Vásárol
SHOP_SELL	Elad
SHOP_TITLE	Bolt
SKILL_SUPPORT_TITLE	Standard készségek
STEP	Tisztasági minõség
STEP_SELECT	Tisztasági minõség
STRENGTH	Erõsítés
STRENGTH_SELECT	Szint
STRUCTURE_VIEW_MODE	Dekoráció
STRUCTURE_VIEW_TYPE_STRUCTURE	Elrejt
SYSTEMOPTION_TITLE	Rendszer opciók
SYSTEM_CHANGE	Karakter csere
SYSTEM_EXIT	Játék befejezés
SYSTEM_HELP	Segítség
SYSTEM_LOGOUT	Kilépés
SYSTEM_MALL	Tárgy piac
SYSTEM_MOVE_CHANNEL	Csatorna váltás
SYSTEM_OPTION	Rendszer opciók
TASKBAR_CHARACTER	Karakter [C/V/B/N]
TASKBAR_CHAT	Cset ablak [Enter]
TASKBAR_DISABLE	Kikapcsolva
TASKBAR_DRAGON_SOUL	Sárkánykõ-alkímia
TASKBAR_EXPAND	Meghosszabbítás
TASKBAR_INVENTORY	Leltár [I]
TASKBAR_MESSENGER	Barátok [Alt+M]
TASKBAR_MONEY_EXPAND	Vagyon
TASKBAR_NEXT_QUICKSLOT	Következõ gyors elérésû mezõ [Shift+Szám, Alt]
TASKBAR_PET_INFO	Házikedvenc infó
TASKBAR_PREV_QUICKSLOT	Elõzõ gyors elérésû mezõ [Shift+Szám]
TASKBAR_SYSTEM	Opciók [ESC]
TOTAL_RANKING	Összesített rangsor
WARP_MI_LABEL	A megtámadott szentélyhez
WEEKLY_RANKING	Heti rangsor
WHISPER_BAN	Letiltás
WHISPER_NAME	Suttogás
WHISPER_REPORT	
WHISPER_SEND	Küld
YES	Igen
ZONE_MAP	Nagy térkép
