ACCE_ABSORB_COST	Costo dell'assorbimento: %d
ACCE_ALREADY_REGISTER	Questo oggetto è stato già usato.
ACCE_DEL_ABSORDITEM	Assorbire e distruggere l'oggetto?
ACCE_DEL_SERVEITEM	Se la fusione fallisce, la stola 2 verrà distrutta.
ACCE_DEL_SERVEITEM2	Se la fusione fallisce, la stola 2 verrà distrutta.
ACCE_INITEM	Trascina gli oggetti nella finestra.
ACCE_MAXGRADE	Questa stola è già su misura.
ACCE_MAX_DRAINRATE	Tasso di assorbimento massimo
ACCE_NOTABSORBITEM	Non puoi utilizzare un'arma/armatura già assorbita.
ACCE_NOT_SEALITEM	Non si possono utilizzare oggetti legati all'anima.
ACCE_NOT_USINGITEM	Non si possono fondere oggetti che fan parte dell'equipaggiamento.
ACCE_NOT_WINDOWOPEN	Non è possibile utilizzare l'oggetto mentre la finestra della fusione è aperta.
ACCE_POSSIBLE_ACCE	Puoi utilizzare solo stole.
ACCE_POSSIBLE_ACCEITEM	Puoi estrarre bonus solo da armi e armature.
AFF_LOVE_POINT	Punto amore: %d%%
ALIGNMENT_NAME	Punti Karma:
ATTACK_ERROR_UNKNOWN	Errore d'attacco sconosciuto: %s
ATTENDANCE_REWARD_QUESTION	Vuoi ricevere la tua ricompensa?
ATTR_6TH_7TH_ADD_QUESTION1	Non si può usare l'oggetto mentre si aggiunge un bonus.
ATTR_6TH_7TH_ADD_QUESTION2	Aggiungere il bonus?
ATTR_6TH_7TH_CHANGE_FAIL	Non si può modificare il bonus.
ATTR_6TH_7TH_DESC1	a. Per aggiungere il 6° e 7° bonus devi inserire i materiali richiesti per l'oggetto.
ATTR_6TH_7TH_DESC2	b. Ogni frammento aumenta del 2% la probabilità di successo.
ATTR_6TH_7TH_DESC3	c. Aumenta la probabilità di successo con un'Integrazione.
ATTR_6TH_7TH_DESC4	d. L'aggiunta del bonus richiede 24 ore. L'NPC trattiene l'oggetto al quale viene aggiunto il bonus. L'oggetto ti verrà restituito al termine del processo.
ATTR_6TH_7TH_POSSIBILITY	Puoi aggiungere un bonus extra.
ATTR_6TH_7TH_TOTAL_SUCCESS_PERCENT	Probabilità di successo: %.1f%%
AURA_DRAIN_PER	Tasso di assorbimento: %.1f%%
AURA_EVOLUTION_GOLD	[Aura] Non hai abbastanza Yang per effettuare un'evoluzione.
AURA_IMPOSSIBLE_ABSORBITEM	[Aura] Non è possibile trasferire altri bonus.
AURA_IMPOSSIBLE_EQUIPITEM	[Aura] Gli item in uso non possono essere trasferiti.
AURA_IMPOSSIBLE_EVOLUTION_ITEM	[Aura] Non si può far evolvere.
AURA_IMPOSSIBLE_EVOLUTION_ITEMCOUNT	[Aura] La quantità di item in uso non è sufficiente per effettuare l'evoluzione.
AURA_IMPOSSIBLE_GROWTHITEM	[Aura] Non si può migliorare.
AURA_IMPOSSIBLE_REFINEITEM	[Aura] Si può fare solo con Vesti Aura, scudi, orecchini, bracciali.
AURA_IMPOSSIBLE_SEALITEM	[Aura] Gli oggetti legati all'anima non si possono trasferire.
AURA_ITEM_NEED_REGISTER	[Aura] È necessario aggiungere degli item.
AURA_LEVEL_STEP	Livello %d (livello %d)
AURA_MAX_LEVEL	[Aura] La Veste Aura ha raggiunto il livello massimo.
AURA_NOTICE_DEL_ABSORDITEM	[Aura] L'item trasferito è stato distrutto.
AURA_OPEN_OTHER_WINDOW	Non puoi eseguire questa azione quando la finestra per il miglioramento/l'evoluzione/il trasferimento dei valori è aperta.
AURA_POSSIBLE_AURAITEM	[Aura] Si può fare solo con la Veste Aura.
AURA_POSSIBLE_REGISTER_AURAITEM	[Aura] È necessario aggiungere prima la Veste Aura.
AURA_TITLE_ABSORB	I valori sono stati trasferiti sulla Veste Aura.
AURA_TITLE_EVOLUTION	Fai evolvere la Veste Aura
AURA_TITLE_GROWTH	Migliora la Veste Aura
AURA_TOOLTIP_EXP	EXP (%d%%/100%%)
AURA_TOOLTIP_LEVEL	Livello %d (livello %d) (tasso di assorbimento %.1f%%)
AURA_TOOLTIP_NEED_YANG	%s Yang
AURA_TOOLTIP_NEXT	Nuovi
AURA_TOOLTIP_NOW	Recenti
AURA_TOOLTIP_RESOURCE	Bene di consumo
AURA_TOOLTIP_RESOURCE_ITEM	%s * %d
AUTO_TOOLTIP_LINE1	Abilità: scegli delle abilità per la battaglia e trascinale negli spazi. (Premium)
AUTO_TOOLTIP_LINE2	Suggerimento: sotto ogni abilità puoi modificare l'intervallo di attivazione (espresso in secondi).
AUTO_TOOLTIP_LINE3	Abilità: scegli delle pozioni per la battaglia e trascinale negli spazi. (Premium)
AUTO_TOOLTIP_LINE4	Suggerimento: le pozioni HP e MP si attivano quando si supera il valore in % espresso sotto la pozione.
AUTO_TOOLTIP_LINE5	Suggerimento: la durata delle altre pozioni è espressa in secondi.
AUTO_TOOLTIP_TITLE	Aiuto Autocaccia
BATTLE_POINT	Punti battaglia
BEAD	Sfera Anima
BEAD_TIME_REMAINING_TO_GET	La Sfera Anima verrà ricaricata tra %d min.
BNW_COIN	Monete Veggenza
BUY_LIMIT_LEVEL	Limite d'acquisto: %s
CANNOT_ATTACK_DEST_IN_SAFE	L'avversario è troppo lontano.
CANNOT_ATTACK_SELF_IN_SAFE	Da qui non posso attaccare l'avversario.
CANNOT_EQUIP_IN_EXCHANGE	Mentre stai commerciando non puoi cambiare nessuna armatura.
CANNOT_EQUIP_IN_SHOP	Mentre stai commerciando non puoi cambiare nessuna armatura.
CANNOT_OPEN_PRIVATE_SHOP_IN_SAFE_AREA	Non puoi aprire il tuo negozio privato in un luogo pubblico.
CANNOT_SHOOT_DEST_IN_SAFE	L'avversario è troppo lontano.
CANNOT_SHOOT_EMPTY_ARROW	Mi serve una freccia.
CANNOT_SHOOT_SELF_IN_SAFE	Da qui non posso attaccare l'avversario.
CANNOT_SKILL_APPROACH	Sono sicuro di non riuscire ad arrivarci da più vicino.
CANNOT_SKILL_ATTACK	Non lo posso attaccare.
CANNOT_SKILL_BLUE	Se l'Anima del lupo purpureo è attiva, non puoi usare l'Anima del lupo indaco.
CANNOT_SKILL_DEST_IN_SAFE	L'avversario è troppo lontano.
CANNOT_SKILL_EQUIP_FISHING_ROD	Non è possibile pescare senza che si stia utilizzando una canna da pesca.
CANNOT_SKILL_HAVE_TO_RIDE	Per utilizzarlo mi serve un cavallo.
CANNOT_SKILL_NEED_EMPTY_BOTTLE	Non ho una bottiglia vuota.
CANNOT_SKILL_NEED_POISON_BOTTLE	Non ho una bottiglia di veleno.
CANNOT_SKILL_NEED_TARGET	Chi è il bersaglio?
CANNOT_SKILL_NOT_ENOUGH_HP	Non ho abbastanza HP!
CANNOT_SKILL_NOT_ENOUGH_SP	Non ho abbastanza MP!
CANNOT_SKILL_NOT_HORSE_SKILL	Non lo posso utilizzare mentre cavalco.
CANNOT_SKILL_NOT_MATCHABLE_WEAPON	Non posso utilizzare questa abilità con quest`arma.
CANNOT_SKILL_NOT_YET_LEARN	Non ho imparato quest`abilità.
CANNOT_SKILL_ONLY_FOR_ALLIANCE	Ha effetto solo sui membri del gruppo.
CANNOT_SKILL_ONLY_FOR_CORPSE	Ha effetto solo sui morti.
CANNOT_SKILL_RED	Se l'Anima del lupo indaco è attiva, non puoi usare l'Anima del lupo purpureo.
CANNOT_SKILL_REMOVE_FISHING_ROD	Non posso utilizzare questa abilità con la mia canna da pesca.
CANNOT_SKILL_SELF_IN_SAFE	Da qui non posso attaccare.
CANNOT_SKILL_USE_SELF	Non posso usarlo su me stesso.
CANNOT_SKILL_WAIT_COOLTIME	Non sono ancora in grado di utilizzare questa abilità.
CANNOT_USE	Non la puoi utilizzare.
CANNOT_WHISPER_DEST_REFUSE	%s ha bloccato la chat privata.	SA
CANNOT_WHISPER_NOT_LOGON	%s non è online.	SA
CANNOT_WHISPER_SELF_REFUSE	Non puoi chattare privatamente con gli altri se hai bloccato la Chat privata.	SNA
CATEGORY_ARMOR_ARMOR_BODY	Armature
CATEGORY_ARMOR_ARMOR_HEAD	Elmi
CATEGORY_ARMOR_ARMOR_SHIELD	Scudi
CATEGORY_COSTUMES	Costumi
CATEGORY_COSTUMES_COSTUME_BODY	Costumi
CATEGORY_COSTUMES_COSTUME_HAIR	Pettinature
CATEGORY_COSTUMES_COSTUME_WEAPON	Skin per arma
CATEGORY_COSTUMES_ETC	Varie
CATEGORY_COSTUMES_SASH	Stole
CATEGORY_DRAGON_STONE	Alchimia delle Pietre del drago
CATEGORY_DRAGON_STONE_DRAGON_DIAMOND	Diamante
CATEGORY_DRAGON_STONE_DRAGON_GARNET	Granato
CATEGORY_DRAGON_STONE_DRAGON_JADE	Giada
CATEGORY_DRAGON_STONE_DRAGON_ONYX	Onice
CATEGORY_DRAGON_STONE_DRAGON_RUBY	Rubino
CATEGORY_DRAGON_STONE_DRAGON_SAPPHIRE	Zaffiro
CATEGORY_DRAGON_STONE_ETC	Varie
CATEGORY_EQUIPMENT_ARMOR	Armature
CATEGORY_EQUIPMENT_JEWELRY	Gioielli
CATEGORY_EQUIPMENT_WEAPON	Armi
CATEGORY_ETC	Varie
CATEGORY_ETC_ETC	Varie
CATEGORY_ETC_EVENT	Item eventi
CATEGORY_ETC_GIFTBOX	Bauli | Pacchi
CATEGORY_ETC_MATRIMORY	Matrimonio
CATEGORY_ETC_PARTI	Libri dell'Arte della guerra
CATEGORY_ETC_POLYMORPH	Sfere trasformazione
CATEGORY_ETC_RECIPE	Produzione pozioni
CATEGORY_ETC_SEAL	Legame dell'anima
CATEGORY_FISHING_PICK	Pesca | Scienza mineraria
CATEGORY_FISHING_PICK_EQUIPMENT_PICK	Picconi appuntiti
CATEGORY_FISHING_PICK_ETC	Varie
CATEGORY_FISHING_PICK_FISHING_POLE	Canne da pesca
CATEGORY_FISHING_PICK_FOOD	Pesci
CATEGORY_FISHING_PICK_PICK_BOOK	Libri di scienza mineraria
CATEGORY_FISHING_PICK_STONE	Minerali
CATEGORY_JEWELRY_ARMOR_EAR	Orecchini
CATEGORY_JEWELRY_ARMOR_FOOTS	Scarpe
CATEGORY_JEWELRY_ARMOR_NECK	Collane
CATEGORY_JEWELRY_ARMOR_PENDANT	Talismano
CATEGORY_JEWELRY_ARMOR_WRIST	Bracciali
CATEGORY_JEWELRY_ITEM_BELT	Cinture
CATEGORY_MOUNT_PET	Cavalcature | Pet
CATEGORY_MOUNT_PET_CHARGED_PET	Pet
CATEGORY_MOUNT_PET_EGG	Uova del pet
CATEGORY_MOUNT_PET_FREE_PET	Pet evolvibili
CATEGORY_MOUNT_PET_MOUNT	Cavalcature
CATEGORY_POTION	Pozioni
CATEGORY_POTION_ABILITY	Beni di consumo
CATEGORY_POTION_ETC	Varie
CATEGORY_POTION_HAIRDYE	Colori di capelli
CATEGORY_SKILL	Abilità
CATEGORY_SKILL_BOOK_OF_OBLIVION	Libri dell'Amnesia
CATEGORY_SKILL_ETC	Varie
CATEGORY_SKILL_PAHAE	Contrattacco | Boost
CATEGORY_SKILL_SKILL_BOOK	Libri delle abilità
CATEGORY_TUNING	Miglioramenti
CATEGORY_TUNING_ETC	Varie
CATEGORY_TUNING_RESOURCE	Materiali
CATEGORY_TUNING_STONE	Pietre spirituali
CATEGORY_UNIQUE	Item speciali
CATEGORY_UNIQUE_ABILITY	Beni di consumo
CATEGORY_UNIQUE_ETC	Varie
CATEGORY_WEAPON_WEAPON_ARROW	Frecce
CATEGORY_WEAPON_WEAPON_BELL	Campane
CATEGORY_WEAPON_WEAPON_BOW	Archi
CATEGORY_WEAPON_WEAPON_CLAW	Artigli
CATEGORY_WEAPON_WEAPON_DAGGER	Pugnali
CATEGORY_WEAPON_WEAPON_FAN	Ventagli
CATEGORY_WEAPON_WEAPON_MOUNT_SPEAR	Lance
CATEGORY_WEAPON_WEAPON_QUIVER	Faretre
CATEGORY_WEAPON_WEAPON_SWORD	Arma a una mano
CATEGORY_WEAPON_WEAPON_TWO_HANDED	Armi a due mani
CHANGE_ALREADY_REGISTER	[Proiezione] Questo oggetto è già stato registrato.
CHANGE_LOOK_CHANGE_ITEM	Vuoi proiettarlo?
CHANGE_LOOK_CHECK_OUT_REGISTER_ITEM	[Proiezione] Prima rimuovi l'oggetto sul quale desideri applicare la proiezione.
CHANGE_LOOK_COST	Prezzo della proiezione: %s Yang
CHANGE_LOOK_DEL_ITEM	L'oggetto assorbito andrà perso.
CHANGE_LOOK_DO_NOT_CHANGE_LOOK_ITEM	[Proiezione] Questo oggetto non può essere proiettato.
CHANGE_LOOK_DO_NOT_EQUIP_ITEM	[Proiezione] Non puoi proiettare l'oggetto mentre fa parte del tuo equipaggiamento.
CHANGE_LOOK_DO_NOT_REGISTER_ITEM	[Proiezione] Questo oggetto non può essere registrato.
CHANGE_LOOK_DO_NOT_SEAL_ITEM	[Proiezione] Questo oggetto è legato all'anima.
CHANGE_LOOK_INSERT_CHANGE_LOOK_ITEM	[Proiezione] Registra l'oggetto che desideri proiettare.
CHANGE_LOOK_INSERT_ITEM	[Proiezione] Prima devi registrare l'oggetto.
CHANGE_LOOK_NEED_MONEY	I tuoi Yang non sono sufficienti oppure non possiedi abbastanza oggetti.
CHANGE_LOOK_OPEN_OTHER_WINDOW	[Proiezione] Non è possibile compiere quest'azione mentre la finestra "Proiezione" è aperta.
CHANGE_LOOK_TITLE	Proiezione
CHANGE_LOOK_TITLE2	Trasformazione cavalcatura
CHANGE_PET_PLEASE_APPEND_FIRST	Bisogna prima selezionare il pet.
CHANGE_TOOLTIP2_LINE1	A sinistra inserisci l'oggetto di destinazione e a destra il materiale.
CHANGE_TOOLTIP2_LINE2	Clicca sulla spunta per utilizzare degli Yang o un Buono trasformazione per modificare l'aspetto della tua cavalcatura.
CHANGE_TOOLTIP2_LINE3	Il Buono trasformazione modifica l'aspetto della cavalcatura senza che si debbano utilizzare degli Yang. Una volta utilizzato, il buono verrà eliminato.
CHANGE_TOOLTIP2_LINE4	Se si modifica l'aspetto di una cavalcatura, la durata dell'aspetto originario della cavalcatura modificata resterà invariata. Inoltre, la durata del materiale non sarà mai maggiore rispetto a quella della cavalcatura di destinazione.
CHANGE_TOOLTIP2_LINE5	Nel caso in cui la cavalcatura di destinazione sia permanente e il materiale abbia invece una durata specifica, la cavalcatura manterrà l'aspetto modificato per la durata specifica del materiale.
CHANGE_TOOLTIP_LINE1	Poggia a sinistra l'oggetto sul quale si dovrà effettuare la proiezione.
CHANGE_TOOLTIP_LINE2	Poggia l'altro oggetto a destra.
CHANGE_TOOLTIP_LINE3	L'apparenza dell'oggetto si modifica
CHANGE_TOOLTIP_LINE4	quando confermi la proiezione (tasto V) e ti viene sottratto dello Yang.
CHANGE_TOOLTIP_LINE5	Quando usi questo oggetto,
CHANGE_TOOLTIP_LINE6	puoi proiettare il tuo item senza usare Yang.
CHANGE_TOOLTIP_TITLE	Proiezione
CHANNEL	Canale
CHANNELING_CANNOT_LOGOUT	Non puoi tornare alla pagina d'iscrizione.
CHANNEL_EMPTY_SERVER	Nessun server
CHANNEL_NORMAL	Canale %d
CHANNEL_NOTIFY_FULL	Questo canale è pieno! Sei pregato di sceglierne un altro.
CHANNEL_NOT_FIND_INFO	Non ricevi nessuna informazione sul canale.
CHANNEL_PVP	Duello libero
CHANNEL_SELECT_CHANNEL	Scegli il canale
CHANNEL_SELECT_REGION	Scegli il luogo per il conto
CHANNEL_SELECT_SERVER	Scegli il server
CHANNEL_STATUS_BUSY	Molto frequentato
CHANNEL_STATUS_FULL	Pieno
CHANNEL_STATUS_OFFLINE	Sconosciuto
CHANNEL_STATUS_RECOMMENDED	Consigliato
CHANNEL_STATUS_VACANT	Poco frequentato
CHANNEL_TEST_SERVER	Testa il server
CHANNEL_TEST_SERVER_ADDR	Test %s:%d
CHARACTER_CREATE_MODE	Crea personaggio
CHARACTER_NAME	Nome
CHARACTER_SELECT_MODE	Seleziona personaggio
CHARGE_BEAD_QUESTION	Sfere Anima necessarie: %d Vuoi continuare?
CHAT_ALL	Tutti
CHAT_BLOCK	Blocca
CHAT_DICE_INFO	Tira
CHAT_GUILD	Gilda
CHAT_INFORMATION	Info
CHAT_INSULT_STRING	La frase contiene parole proibite
CHAT_LOG	Mostra i messaggi vecchi [L]
CHAT_LOG_TITLE	Protocollo della chat
CHAT_NORMAL	Normale
CHAT_NOTICE	Server
CHAT_PARTY	Gruppo
CHAT_SEND_CHAT	Invia Chat
CHAT_SEND_MEMO	Invia Chat privata [Shift+Invio]
CHAT_SHOUT	Chiama
CHAT_SHOUT_LIMIT	Puoi chiamare ogni 15 secondi.
CHAT_WHISPER	Chat privata
CHEQUE_SYSTEM_DO_NOT_DROP_MONEY	Non puoi fare cadere i soldi.
CHEQUE_SYSTEM_PICK_WON	Hai ottenuto %d Won.
CHEQUE_SYSTEM_SELL_PRICE	[Prezzo di vendita]
CHEQUE_SYSTEM_UNIT_WON	Won
CHEQUE_SYSTEM_UNIT_YANG	Yang
CHEQUE_SYSTEM_WON	%s Won
CHEQUE_SYSTEM_YANG	%s Yang
CLEAR_FLOOR	Livello
CLEAR_TIME	Tempo
ClosePetChangeWndButton	Chiudi
COMB_ACCE_IS_CONTINUE_PROCESS	Vuoi continuare?
COMB_ACCE_WARNING_MESSAGE	In caso di successo totale o parziale, l'originale verrà distrutto. Il trasferimento potrebbe non andare a buon fine. In caso di fallimento o successo parziale, il tasso di assorbimento della stola di destinazione diminuirà.
COMB_ACCE_WARNING_MESSAGE1	In caso di successo totale o parziale, la stola di partenza verrà distrutta.
COMB_ACCE_WARNING_MESSAGE2	Il trasferimento potrebbe non andare a buon fine.
COMB_ACCE_WARNING_MESSAGE3	In caso di fallimento o successo parziale, il tasso di assorbimento della stola di destinazione diminuirà.
COMB_ACCE_WILL_REMOVE_MATERIAL	In caso di successo totale o parziale, la stola di partenza verrà distrutta.
COMB_ALREADY_APPEND	Questo oggetto è già stato selezionato.
COMB_CANT_APPEND_ITEM	Questo oggetto non può essere utilizzato.
COMB_CANT_APPEND_SEALED_ITEM	Non si possono utilizzare oggetti legati all'anima.
COMB_CANT_BASE_ITEM	Non è possibile scegliere come stola di destinazione una stola che possiede già dei bonus.
COMB_CANT_MATCH_DRAINRATE	Il trasferimento del bonus presuppone che entrambi gli item abbiano lo stesso tasso di assorbimento.
COMB_CANT_MATCH_GRADE	Il trasferimento del bonus presuppone che entrambi gli item abbiamo lo stesso grado.
COMB_CANT_MATERIAL_ITEM	L'item originale deve possedere un bonus.
COMB_COST	Prezzo: %s
COMB_IS_CONTINUE_PROCESS	Desideri continuare?
COMB_NOTICE	Non puoi aprire un negozio privato mentre stai scambiando dei libri.
COMB_NOTICE_NOT_OPEN	Non puoi scambiar libri mentre hai un negozio privato aperto.
COMB_NOT_ALL_SLOT_APPEND_ITEM	Per poter trasferire i bonus ti servono un item originale, un item di destinazione e l'item per il trasferimento.
COMB_NOT_FULL_BOOK	No, non ci siamo. Come ti ho già spiegato, sono disposto a fare lo scambio solo se mi porti 10 libri.
COMB_NOT_ITEM_IN_INVENTORY	Non puoi utilizzare oggetti già in uso.
COMB_NOT_MEDIUM_ITEM	Questo oggetto non può essere utilizzato.
COMB_WILL_REMOVE_MATERIAL	In caso di successo, l'originale verrà distrutto.
CREATE_ERROR_GM_NAME	Nel nome del personaggio non puoi usare ,GM‘.
CREATE_ERROR_INSULT_NAME	Questo nome non è consentito.
CREATE_ERROR_LIMIT_LEVEL	Il tuo personaggio deve aver raggiunto almeno il livello 80.
CREATE_ERROR_TIME_LIMIT	Puoi solo creare un personaggio ogni 30 secondi.
CREATE_ERROR_WRONG_STRING	Non puoi utilizzare questo nome.
CREATE_EXIST_SAME_NAME	Questo nome è usato da un altro personaggio.
CREATE_FAILURE	Non puoi creare il personaggio.
CREATE_FULL	Non puoi più creare alcun personaggio.
CREATE_GM_NAME	GM
CREATE_INPUT_NAME	Inserisci il nome.
CREATE_PLUS_STAT	Ci sono ancora punti status disponibili.
CUBE_CATEGORY_ACCESSORY	Gioielli
CUBE_CATEGORY_ARMOR	Armatura
CUBE_CATEGORY_BELT	Cintura
CUBE_CATEGORY_ETC	Etc.
CUBE_CATEGORY_EVENT	Evento
CUBE_CATEGORY_WEAPON	Arma
CUBE_MAKE_CONFIRM_QUESTION_1	Almeno uno degli item utilizzati è particolarmente prezioso (possiede più di %d bonus).
CUBE_MAKE_CONFIRM_QUESTION_2	Vuoi davvero continuare?
CUBE_NOT_ENOUGH_GOLD	Non hai abbastanza Yang per la produzione.
CUBE_NOT_ENOUGH_MATERIAL	Non hai materiale a sufficienza per la produzione.
CUBE_PLEASE_SELECT	Non è stato selezionato alcun oggetto.
CZ_REWARD_QUESTION_COMPLETE	Vorresti avere questa cavalcatura?
CZ_REWARD_TOOLTIP_10GAN	Insegne Zodiaco
CZ_REWARD_TOOLTIP_10GAN_COUNT	Quantità presente nell'inventario
CZ_REWARD_TOOLTIP_10GAN_NEED_COUNT	Quantità necessaria
CZ_REWARD_TOOLTIP_12ZI	Insegne del guardiano
CZ_REWARD_TOOLTIP_12ZI_COUNT	Quantità presente nell'inventario
CZ_REWARD_TOOLTIP_12ZI_NEED_COUNT	Quantità necessaria
CZ_REWARD_TOOLTIP_ALL_BOX	Tesoro stellare
CZ_REWARD_TOOLTIP_CAN_GET_ALL_BOX	Clicca qui per ritirare la tua ricompensa, il Tesoro stellare.
CZ_REWARD_TOOLTIP_CAN_GET_GREEN_BOX	Clicca qui per ritirare la tua ricompensa, il Tesoro Aventurina.
CZ_REWARD_TOOLTIP_CAN_GET_YELLOW_BOX	Clicca qui per ritirare la tua ricompensa, il Tesoro Aureolina.
CZ_REWARD_TOOLTIP_COMPLETABLE	Riscuoti
CZ_REWARD_TOOLTIP_GREEN_BOX	Tesoro Aventurina
CZ_REWARD_TOOLTIP_GREEN_BOX_COMP_CNT	Tesori Aventurina ritirati: %d
CZ_REWARD_TOOLTIP_WEEKLY	Giorno
CZ_REWARD_TOOLTIP_WEEKLY_FRI	Venerdì
CZ_REWARD_TOOLTIP_WEEKLY_MON	Lunedì
CZ_REWARD_TOOLTIP_WEEKLY_SAT	Sabato
CZ_REWARD_TOOLTIP_WEEKLY_SAT_SUN	Sabato/Domenica
CZ_REWARD_TOOLTIP_WEEKLY_THU	Giovedì
CZ_REWARD_TOOLTIP_WEEKLY_TUE	Martedì
CZ_REWARD_TOOLTIP_WEEKLY_WED	Mercoledì
CZ_REWARD_TOOLTIP_YELLOW_BOX	Tesoro Aureolina
CZ_REWARD_TOOLTIP_YELLOW_BOX_COMP_CNT	Tesori Aureolina ritirati: %d
DAY	g
DETAILS_1	Forte vs Mezziuomini
DETAILS_10	Forte vs mostri des.
DETAILS_11	Forte vs insetti
DETAILS_12	Valore d'attacco
DETAILS_13	Valore di difesa
DETAILS_14	Danno medio
DETAILS_15	Res. danno medio
DETAILS_16	Danni abilità
DETAILS_17	Resistenza danni abilità
DETAILS_18	Att. magico/C. a C.
DETAILS_19	Attacco magico
DETAILS_2	Res. Mezzouomo
DETAILS_20	Prob. colpo critico
DETAILS_21	Colpo trafiggente
DETAILS_22	Res. colpo critico
DETAILS_23	Res. colpo trafigg.
DETAILS_24	Resistenza lampo
DETAILS_25	Resistenza ghiaccio
DETAILS_26	Res. oscurità
DETAILS_27	Resistenza fuoco
DETAILS_28	Resistenza vento
DETAILS_29	Resistenza terra
DETAILS_3	Forte vs orchi
DETAILS_30	Forza del fulmine
DETAILS_31	Forza del ghiaccio
DETAILS_32	Forza dell'oscurità
DETAILS_33	Forza del fuoco
DETAILS_34	Forza del vento
DETAILS_35	Forza della terra
DETAILS_36	Forte vs guerrieri
DETAILS_37	Forte vs ninja
DETAILS_38	Forte vs sura
DETAILS_39	Forte vs shamani
DETAILS_4	Forte vs zombie
DETAILS_40	Forte vs lican
DETAILS_41	Difesa dai guerrieri
DETAILS_42	Difesa dai ninja
DETAILS_43	Difesa dai sura
DETAILS_44	Dif. dagli shamani
DETAILS_45	Difesa dai lican
DETAILS_46	Difesa spada
DETAILS_47	Difesa spadone
DETAILS_48	Difesa pugnale
DETAILS_49	Difesa artigli
DETAILS_5	Forte vs mostri
DETAILS_50	Difesa campana
DETAILS_51	Difesa ventaglio
DETAILS_52	Difesa freccia
DETAILS_53	Prob. svenimento
DETAILS_54	Prob. rallentamento
DETAILS_55	Prob. avvelenamento
DETAILS_56	Res. avvelenamento
DETAILS_57	Attacco sanguinante
DETAILS_58	Res. attacco sang.
DETAILS_59	Furto HP
DETAILS_6	Forte vs mostri Zod.
DETAILS_60	Furto MP
DETAILS_61	Ripristino HP
DETAILS_62	Ripristino MP
DETAILS_63	Blocca attacco
DETAILS_64	Schiva frecce
DETAILS_65	Rifless. att. corp.
DETAILS_66	Ripr. HP (uccisione)
DETAILS_67	Ripr. MP (uccisione)
DETAILS_68	EXP doppia
DETAILS_69	Yang doppi
DETAILS_7	Forte vs animali
DETAILS_70	Prob. di drop
DETAILS_71	Valore d'attacco
DETAILS_72	Difesa
DETAILS_73	EXP
DETAILS_74	Prob. di drop
DETAILS_75	Yang doppi
DETAILS_76	Resistenza magia
DETAILS_77	Anti-magia
DETAILS_8	Forte vs esoterici
DETAILS_9	Forte vs diavolo
DETAILS_ATTBONUS_BELL	Rottura della campana
DETAILS_ATTBONUS_BOW	Rottura della freccia
DETAILS_ATTBONUS_CLAW	Rottura dell'artiglio
DETAILS_ATTBONUS_DAGGER	Rottura del pugnale
DETAILS_ATTBONUS_FAN	Rottura del ventaglio
DETAILS_ATTBONUS_SWORD	Rottura della spada
DETAILS_ATTBONUS_TWOHAND	Rottura dello spadone
DETAILS_CATE_1	Danno/Difesa
DETAILS_CATE_2	Bonus elementali
DETAILS_CATE_3	Bonus classe
DETAILS_CATE_4	Bonus armi
DETAILS_CATE_5	Altri bonus
DETAILS_CATE_6	Bonus speciali
DETAILS_RESIST_MOUNT_FALL	Resistenza alla caduta
DETAILS_TITLE	Dettagli
DETAILS_TOOLTIP_1	Forte contro i Mezziuomini: infligge ingenti danni ai Mezziuomini
DETAILS_TOOLTIP_10	Forte contro i mostri del deserto: infligge una maggiore quantità di danni ai mostri del deserto.
DETAILS_TOOLTIP_11	Forte contro insetti: infligge una maggiore quantità di danni agli insetti.
DETAILS_TOOLTIP_12	Incrementa il tuo valore d'attacco.
DETAILS_TOOLTIP_13	Incrementa il tuo valore di difesa
DETAILS_TOOLTIP_14	Aumenta il danno medio che infliggi agli avversari quando li attacchi.
DETAILS_TOOLTIP_15	Resistenza al danno medio: riduce i danni che subisci in un attacco.
DETAILS_TOOLTIP_16	Aumenta i danni provocati da un'abilità.
DETAILS_TOOLTIP_17	Resistenza ai danni abilità: riduce il danno da abilità che subisci.
DETAILS_TOOLTIP_18	Aumenta il valore d'attacco corporale e magico.
DETAILS_TOOLTIP_19	Aumenta il danno che infliggi agli avversari tramite attacco magico.
DETAILS_TOOLTIP_2	Resistenza ai Mezziuomini: riduce il danno che viene inflitto dai Mezziuomini.
DETAILS_TOOLTIP_20	Aumenta la probabilità di mettere a segno un colpo critico.
DETAILS_TOOLTIP_21	Probabilità di colpo trafiggente: aumenta la probabilità di mettere a segno un colpo trafiggente.
DETAILS_TOOLTIP_22	Resistenza ai colpi critici: riduce il danno che viene inflitto dai colpi critici.
DETAILS_TOOLTIP_23	Resistenza ai colpi trafiggenti: riduce il danno che viene inflitto dai colpi trafiggenti.
DETAILS_TOOLTIP_24	Riduce il danno che viene inflitto da determinati mostri.
DETAILS_TOOLTIP_25	Riduce il danno che viene inflitto da determinati mostri.
DETAILS_TOOLTIP_26	Resistenza all'oscurità: riduce il danno che viene inflitto da determinati mostri.
DETAILS_TOOLTIP_27	Riduce il danno che viene inflitto da determinati mostri.
DETAILS_TOOLTIP_28	Riduce il danno che viene inflitto da determinati mostri.
DETAILS_TOOLTIP_29	Riduce il danno che viene inflitto da determinati mostri.
DETAILS_TOOLTIP_3	Forza contro Orchi: infligge una maggiore quantità di danni agli Orchi.
DETAILS_TOOLTIP_30	Incrementa il danno che provochi tramite la forza del fulmine.
DETAILS_TOOLTIP_31	Incrementa il danno che provochi tramite la forza del ghiaccio.
DETAILS_TOOLTIP_32	Incrementa il danno che provochi tramite la forza dell'oscurità.
DETAILS_TOOLTIP_33	Incrementa il danno che provochi tramite la forza del fuoco.
DETAILS_TOOLTIP_34	Incrementa il danno che provochi tramite la forza del vento.
DETAILS_TOOLTIP_35	Incrementa il danno che provochi tramite la forza della terra.
DETAILS_TOOLTIP_36	Forte contro i guerrieri: infligge una maggiore quantità di danni ai guerrieri.
DETAILS_TOOLTIP_37	Forte contro i ninja: infligge una maggiore quantità di danni ai ninja.
DETAILS_TOOLTIP_38	Forte contro i sura: infligge una maggiore quantità di danni ai sura.
DETAILS_TOOLTIP_39	Forte contro gli shamani: infligge una maggiore quantità di danni agli shamani.
DETAILS_TOOLTIP_4	Forte contro gli Zombie: infligge una maggiore quantità di danni agli Zombie.
DETAILS_TOOLTIP_40	Forte contro i lican: infligge una maggiore quantità di danni ai lican.
DETAILS_TOOLTIP_41	Probabilità di difesa dagli attacchi dei guerrieri: riduce il danno che viene inflitto dai guerrieri.
DETAILS_TOOLTIP_42	Probabilità di difesa dagli attacchi dei ninja: riduce il danno che viene inflitto dai ninja.
DETAILS_TOOLTIP_43	Probabilità di difesa dagli attacchi dei sura: riduce il danno che viene inflitto dai sura.
DETAILS_TOOLTIP_44	Probabilità di difesa dagli attacchi degli shamani: riduce il danno che viene inflitto dagli shamani.
DETAILS_TOOLTIP_45	Probabilità di difesa dagli attacchi dei lican: riduce il danno che viene inflitto dai lican.
DETAILS_TOOLTIP_46	Riduce il danno che viene inflitto da una spada.
DETAILS_TOOLTIP_47	Riduce il danno che viene inflitto da un'arma a due mani.
DETAILS_TOOLTIP_48	Riduce il danno che viene inflitto da un pugnale.
DETAILS_TOOLTIP_49	Riduce il danno che viene inflitto da un artiglio.
DETAILS_TOOLTIP_5	Forte contro i mostri: infligge una maggiore quantità di danni ai mostri.
DETAILS_TOOLTIP_50	Riduce il danno che viene inflitto da una campana.
DETAILS_TOOLTIP_51	Riduce il danno che viene inflitto da un ventaglio.
DETAILS_TOOLTIP_52	Riduce il danno che viene inflitto da una freccia e da un arco.
DETAILS_TOOLTIP_53	Aumenta la probabilità di far svenire un avversario.
DETAILS_TOOLTIP_54	Aumenta la probabilità di rallentare un avversario.
DETAILS_TOOLTIP_55	Aumenta la probabilità di avvelenare un avversario.
DETAILS_TOOLTIP_56	Riduce il danno che viene inflitto da un veleno.
DETAILS_TOOLTIP_57	Aumenta la probabilità di mettere a segno un attacco sanguinante.
DETAILS_TOOLTIP_58	Resistenza all'attacco sanguinante: riduce il danno che viene inflitto da un attacco sanguinante.
DETAILS_TOOLTIP_59	Quando colpisci il tuo avversario, gli sottrae HP.
DETAILS_TOOLTIP_6	Forte contro i mostri dello zodiaco: infligge una maggiore quantità di danni ai mostri Zodiaco.
DETAILS_TOOLTIP_60	Quando colpisci il tuo avversario, gli sottrae MP.
DETAILS_TOOLTIP_61	Accelera la rigenerazione dei tuoi punti vita.
DETAILS_TOOLTIP_62	Accelera la rigenerazione dei tuoi punti mana.
DETAILS_TOOLTIP_63	Probabilità di bloccare attacchi nella lotta corpo a corpo: aumenta la probabilità di schivare un attacco corpo a corpo.
DETAILS_TOOLTIP_64	Probabilità di schivare frecce: aumenta la probabilità di schivare l'attacco, a distanza o con frecce, di un mostro.
DETAILS_TOOLTIP_65	Probabilità di riflettere un colpo nella lotta corpo a corpo: una parte del danno della lotta corpo a corpo viene restituito all'avversario.
DETAILS_TOOLTIP_66	Ripristino HP quando si uccide: quando uccidi un avversario, i tuoi punti vita aumentano.
DETAILS_TOOLTIP_67	Ripristino MP quando si uccide: quando uccidi un avversario, i tuoi punti mana aumentano.
DETAILS_TOOLTIP_68	Probabilità di ricevere esperienza doppia: aumenta la probabilità di ricevere un bonus EXP quando hai sconfitto un avversario.
DETAILS_TOOLTIP_69	Probabilità di droppare il doppio degli Yang: aumenta la tua probabilità di ricevere il doppio degli Yang.
DETAILS_TOOLTIP_7	Forte contro gli animali: infligge una maggiore quantità di danni agli animali selvatici.
DETAILS_TOOLTIP_70	Probabilità di droppare oggetti: aumenta la probabilità di ottenere il doppio degli oggetti.
DETAILS_TOOLTIP_71	Incrementa il tuo valore d'attacco.
DETAILS_TOOLTIP_72	Incrementa il tuo valore di difesa
DETAILS_TOOLTIP_73	Aumenta la raccolta di esperienza.
DETAILS_TOOLTIP_74	Probabilità di droppare oggetti: raddoppia la tua probabilità di ottenere oggetti.
DETAILS_TOOLTIP_75	Probabilità di droppare Yang: incrementa la tua probabilità di ottenere più Yang.
DETAILS_TOOLTIP_76	Riduce il danno che subisci tramite attacco magico.
DETAILS_TOOLTIP_77	Riduce la resistenza magia del tuo avversario.
DETAILS_TOOLTIP_8	Forte contro gli esoterici: infligge una maggiore quantità di danni agli esoterici.
DETAILS_TOOLTIP_9	Forte contro i diavoli: infligge una maggiore quantità di danni ai diavoli.
DETAILS_TOOLTIP_ATTBONUS_BELL	Interruzione della difesa campana: riduce la difesa campana dell'avversario.
DETAILS_TOOLTIP_ATTBONUS_BOW	Interruzione della difesa freccia: riduce la difesa freccia dell'avversario.
DETAILS_TOOLTIP_ATTBONUS_CLAW	Interruzione della difesa artigli: riduce la difesa artigli dell'avversario.
DETAILS_TOOLTIP_ATTBONUS_DAGGER	Interruzione della difesa pugnale: riduce la difesa pugnale dell'avversario.
DETAILS_TOOLTIP_ATTBONUS_FAN	Interruzione della difesa ventaglio: riduce la difesa ventaglio dell'avversario.
DETAILS_TOOLTIP_ATTBONUS_SWORD	Interruzione della difesa spada: riduce la difesa spada dell'avversario.
DETAILS_TOOLTIP_ATTBONUS_TWOHAND	Interruzione della difesa spadone: riduce la difesa spadone dell'avversario.
DETAILS_TOOLTIP_RESIST_MOUNT_FALL	Resistenza alla caduta: riduce la probabilità di cadere dalla cavalcatura.
DONT_USE_ITEM_WHEN_SHOW_CONFIRM	Non è possibile spostare gli oggetti mentre è in corso una richiesta.
DO_NOT_INSERT_UPBRINGING_PET	Non è possibile selezionare il pet attivo.
DO_YOU_BUY_ITEM1	Vuoi acquistare %s per %s Yang?
DO_YOU_BUY_ITEM2	Vuoi acquistare %s (%s unità) per %s Yang?
DO_YOU_BUY_ITEM3	Desideri comprare %s per %s Won e %s Yang?
DO_YOU_BUY_ITEM4	Desideri comprare %s (%s unità) per %s Won e %s Yang?
DO_YOU_DROP_MONEY	Desideri lasciar cadere %d Yang?
DO_YOU_SELL_ITEM1	Vuoi vendere %s per %s Yang?
DO_YOU_SELL_ITEM2	Vuoi vendere %s (%s unità) per %s Yang?
DRAGON_SOUL_CANNOT_REFINE	Non puoi raffinare questa Pietra del Drago.
DRAGON_SOUL_CANNOT_REFINE_MORE	Questa Pietra del Drago ha già raggiunto il livello più alto.
DRAGON_SOUL_EQUIP_WARNING1	È difficile eliminare nuovamente una Pietra del Drago.
DRAGON_SOUL_EQUIP_WARNING2	Vorresti continuare?
DRAGON_SOUL_EXPIRED	Pietra del Drago scaduta
DRAGON_SOUL_INVALID_DRAGON_SOUL	È la Pietra del Drago sbagliata.
DRAGON_SOUL_IS_NOT_DRAGON_SOUL	Questa non è una Pietra del Drago.
DRAGON_SOUL_NOT_DRAGON_SOUL_REFINE_STONE	Non è la giusta Pietra del Drago.
DRAGON_SOUL_NOT_ENOUGH_MATERIAL	Non hai materiale a sufficienza per il raffinamento.
DRAGON_SOUL_NOT_ENOUGH_MATERIAL2	Per la %s\n serve questo item: %s (%d)
DRAGON_SOUL_NOT_ENOUGH_MONEY	Non hai abbastanza Yang per modificare il bonus.
DRAGON_SOUL_NOT_MATCHED_SLOT	La Pietra del Drago non va bene per questo slot.
DRAGON_SOUL_STEP_LEVEL1	Purezza: opaco,
DRAGON_SOUL_STEP_LEVEL2	Purezza: chiaro,
DRAGON_SOUL_STEP_LEVEL3	Purezza: limpido,
DRAGON_SOUL_STEP_LEVEL4	Purezza: brillante,
DRAGON_SOUL_STEP_LEVEL5	Purezza: eccellente,
DRAGON_SOUL_STRENGTH	Livello: +%d 	SA
DRAGON_SOUL_UNEQUIP_WARNING1	La Pietra del Drago potrebbe distruggersi in questo processo.
DRAGON_SOUL_UNEQUIP_WARNING2	Vorresti continuare?
DRAGON_SOUL_UNMATCHED_SLOT	Questo è lo slot sbagliato.
DRAGON_SOUL_UNQUALIFIED	Non puoi ancora utilizzare l'alchimia delle Pietre del drago.
DROP_ITEM_FAILURE_EQUIP_ITEM	Non puoi lasciar cadere un oggetto che è in uso.
DROP_ITEM_FAILURE_PRIVATE_SHOP	Non puoi lasciar cadere un oggetto se hai un negozio privato aperto.
DROP_MONEY_FAILURE_1000_OVER	Puoi lasciar cadere massimo 999 Yang.
DS_SYSTEM_MSG_1	Ecco cosa ti serve: %s (%dx).
DUTCH_AUCTION_CLOSE_OTHER_WINDOW	Prima di aprire l'Asta lampo è necessario chiudere tutte le finestre.
EMOTION_ALCOHOL	Salute!
EMOTION_ANGRY	Arrabbiato
EMOTION_ATTRACTIVE	Seduzione
EMOTION_BANTER	Scherzoso
EMOTION_BUSY	Stress
EMOTION_CALL	Chiamata
EMOTION_CELEBRATION	Party
EMOTION_CHARGING	Carica
EMOTION_CHEERS_1	Esulto 1
EMOTION_CHEERS_2	Esulto 2
EMOTION_CHEERUP	Gioire
EMOTION_CHOOSE_ONE	Scegli bersaglio.
EMOTION_CLAP	Applauso
EMOTION_CLAP_KISS	Bacio
EMOTION_CONGRATULATION	Approvazione
EMOTION_DANCE_1	Ballare 1
EMOTION_DANCE_2	Ballare 2
EMOTION_DANCE_3	Ballare 3
EMOTION_DANCE_4	Ballare 4
EMOTION_DANCE_5	Ballare 5
EMOTION_DANCE_6	Gumsan Style
EMOTION_DANCE_7	Samba
EMOTION_DOZE	Pisolino
EMOTION_EXERCISE	Riscaldamento
EMOTION_FORGIVE	Perdono
EMOTION_FRENCH_KISS	Bacio con la lingua
EMOTION_HUNGRY	Fame
EMOTION_JOY	Felicita'
EMOTION_LETTER	Lettera d'amore
EMOTION_NOSAY	Senza parole
EMOTION_PUSH_UP	Flessione
EMOTION_SAD	Triste
EMOTION_SELFIE	Selfie
EMOTION_SHY	Rifiuto
EMOTION_SIREN	Sirena
EMOTION_SLAP	Colpo
EMOTION_WEATHER_1	Sole
EMOTION_WEATHER_2	Arcobaleno
EMOTION_WEATHER_3	Luna
EMOTION_WHIRL	Confusione
EMPIRE_A	Regno Shinsoo
EMPIRE_B	Regno Chunjo
EMPIRE_C	Regno Jinno
EMPIRE_SELECT_MODE	Seleziona regno
EXCHANGE_CANNOT_GIVE	Quest'oggetto non è commerciabile.
EXCHANGE_CANT_EDIT_MONEY	Non puoi modificare il prezzo ora.
EXCHANGE_FAILURE_EQUIP_ITEM	Non puoi scambiare gli oggetti in uso.
EXCHANGE_MONEY	Prezzo
EXCHANGE_TITLE	Commercia con %s (%d)
EXINVEN_USE_ITEM_FAIL_FALL_SHORT	Ampliamenti dell'inventario mancanti: %d.
EXINVEN_USE_ITEM_FAIL_FOURTH_PAGE_STAGE_MAX	Il tuo inventario ha già raggiunto il numero massimo di Ampliamenti.
EXINVEN_USE_ITEM_QUESTION	Desideri ampliare il tuo inventario con %d Ampliamenti dell'inventario?
FINDM_BUTTON_01	Ritira
FINDM_BUTTON_02	Migliora
FINDM_POPUP_01	Non hai tutti gli oggetti che servono per avviare il minigioco.
FINDM_POPUP_02	Non hai abbastanza %s.
FINDM_POPUP_03	Non si può più utilizzare.
FINDM_POPUP_04	Questa è già la ricompensa migliore.
FINDM_POPUP_05	Non hai abbastanza Yang per il minigioco.
FINDM_POPUP_06	Se non le giri entro %d secondi, le tre carte vengono girate automaticamente.
FINDM_QUESTION_01	Consumerai %d Yang e %s.\nContinuare?
FINDM_QUESTION_02	Riprovare e utilizzare %s %d?
FINDM_QUESTION_03	Ricompensa: %s
FINDM_QUESTION_04	Nuovo tentativo? In caso di insuccesso, l'attuale ricompensa rimane comunque tua.
FINDM_QUESTION_05	Terminare la partita e ottenere la ricompensa?
FINDM_TOOLTIP_01	Se nell'arco di tempo indicato non effettui alcuna scelta, verranno girate automaticamente tre carte.
FISHING_FAILURE	Hai perso l'esca.
FISHING_NOTIFY1	Sembrerebbe che %s abbia abboccato.
FISHING_NOTIFY2	Sembrerebbe che %s sia stato catturato.
FISHING_RENEWAL_CANNOT_EMOTION	Mentre si sta pescando non è possibile utilizzare le emozioni.
FISHING_RENEWAL_CANNOT_OPEN_1	Non si può aprire mentre si sta pescando.
FISHING_RENEWAL_CANNOT_OPEN_2	Non è possibile eseguire questa azione mentre si sta pescando.
FISHING_RENEWAL_QUESTION	Un pesce ha abboccato. Vuoi catturarlo?
FISHING_RENEWAL_TIMEOUT	Hai tentennato troppo. Il pesce è scappato.
FISHING_SUCCESS1	Ne hai catturati %s!
FISHING_SUCCESS2	Hai pescato %s!
FISHING_UNKNOWN	Qualcosa ha abboccato ma non sai cosa sia.
FISHING_WRONG_PLACE	Qui non posso pescare.
FLOWER_EVENT_USE_ITEM_TEXT1	Vuoi sostituire l'effetto attivato?
FLOWER_EVENT_USE_ITEM_TEXT2	Il tentativo potrebbe non andare a buon fine; il fiore appassisce.
FOR_FEMALE	Per Donne
FOR_MALE	Per Uomini
FRAGMENT_COMB_COST	Costo combinazione: %s
GAME_CANNOT_MINING	Non puoi estrarre minerali mentre sei a cavallo.
GAME_CANNOT_PICK_ITEM	Non puoi raccogliere l'oggetto perchè non lo hai razziato tu.
GAME_GUILDWAR_NOW_JOIN	Vuoi partecipare alla guerra tra gilde?
GAME_INIT_ERROR_CURSOR	Non si è potuto creare la freccia del mouse.
GAME_INIT_ERROR_DIRECTX	DirectX 8.1 deve essere installata per poter eseguire il gioco.\nInstalla DirectX 8.1 o maggiore.
GAME_INIT_ERROR_GRAPHICS_BAD_PERFORMANCE	Non è stata trovata nessuna scheda grafica compatibile con il gioco.\nControlla che la tua scheda VGA sia installata correttamente.
GAME_INIT_ERROR_GRAPHICS_NOT_EXIST	Non è stato possibile eseguire la grafica.\nControlla se possiedi una scheda VGA.\nIn alternativa puoi attivare l'accelerazione Hardware \n(Metti l'accelerazione Hardware al massimo \nPannello di controllo->Schermo->Impostazioni->Avanzate->Risoluzione problemi)
GAME_INIT_ERROR_GRAPHICS_NOT_SUPPORT_32BIT	La scheda grafica del PC non supporta la modalità finestra in 32bit.\nModifica in modalità 16bit o usa la modalità a tutto schermo.
GAME_INIT_ERROR_ITEM_PROTO	I dati degli oggetti non sono disponibili.\nInstalla nuovamente il gioco.
GAME_INIT_ERROR_MAIN_WINDOW	Non è stato possibile creare la finestra principale.
GAME_INIT_ERROR_MOB_PROTO	I dati dei mostri non sono disponibili.\nInstalla nuovamente il gioco.
GAME_INIT_ERROR_NETWORK	Non è stato possibile creare la connessione.\nControlla la tua connessione ad internet.
GAME_PICK_MONEY	Hai ricevuto %d Yang.
GEM_SYSTEM_ADD_SLOT	Oggetto richiesto: %s.\nVuoi usarne %d per aprire un ulteriore spazio?
GEM_SYSTEM_BUY_ITEM	Vuoi comprare questo oggetto?
GEM_SYSTEM_NAME	Gaya
GEM_SYSTEM_NOT_ENOUGHT_REFRESHITEM	[Gaya] Non hai abbastanza "Resetta Negozio di Gaya".
GEM_SYSTEM_NOT_ENOUGH_HP_GEM	[Gaya] Non hai abbastanza Gaya.
GEM_SYSTEM_NO_MORE_ADDSLOT	[Gaya] Non è possibile aggiungere altri spazi.
GEM_SYSTEM_OPEN_GEMSHOP	[Gaya] Apri innanzitutto il Negozio di Gaya.
GEM_SYSTEM_PICK_GEM	[Gaya] Quantità di Gaya: %d
GEM_SYSTEM_REFRESH_SHOP_ITEMS	Vuoi resettare?
GIVEUP_QUESTION	Vuoi davvero arrenderti?
GUILDBANK_CLEARBANK	Attenzione: si deve svuotare il Magazzino della Gilda
GUILDBANK_DONT_MONEY_OUT	Nella banca della gilda non ci sono Yang.
GUILDBANK_GOLD_IN	Versamento
GUILDBANK_GOLD_OUT	Prelievo
GUILDBANK_ITEM_IN	Deposita
GUILDBANK_ITEM_OUT	Metti in vendita
GUILDBANK_MONEYIN	Versa Yang
GUILDBANK_MONEYOUT	Preleva Yang
GUILDBANK_NOTUSE	Non possiedi i diritti per eseguire questa azione.
GUILDBANK_NOT_ENOUGH_MONEY	Non ha molti Yang da versare.
GUILDBANK_OVER_INCOME	È stato raggiunto il limite del conto.
GUILDBANK_OVER_MONEY	Il conto della gilda è pieno.
GUILDLAND_ABANDON	Cedi terreno della gilda
GUILDLAND_ABANDON_VOTE	Cedi il terreno della tua gilda [%s].
GUILDLAND_ABANDON_VOTE_RESULT1	Si è ceduto il terreno della gilda [%s].
GUILDLAND_ABANDON_VOTE_RESULT2	Il terreno della gilda è stato ceduto.
GUILDLAND_ABANDON_VOTE_RESULT3	Risultato del sondaggio:
GUILDLAND_ABANDON_VOTE_RESULT4	Il sondaggio non è valido.
GUILDLAND_ABANDON_VOTE_TEXT	Vuoi davvero iniziare il sondaggio?
GUILDLAND_ABANDON_VOTE_TEXT1	Voti a favore della cessione del terreno della gilda?
GUILDLAND_ACCEPT	Sì
GUILDLAND_DEAL	Vendi terreno della gilda
GUILDLAND_DEAL_TEXT1	La gilda [%s] vuole vendere
GUILDLAND_DEAL_TEXT2	il proprio terreno della gilda per %s Yang.
GUILDLAND_DEAL_TEXT3	Accetti l'offerta?
GUILDLAND_DELA_VOTE	La gilda [%s] vuole acquistare il nostro terreno.
GUILDLAND_DELA_VOTE_RESULT1	Vendita del terreno alla gilda [%s].
GUILDLAND_DELA_VOTE_RESULT2	Il sondaggio è terminato.
GUILDLAND_DELA_VOTE_RESULT3	Risultato del sondaggio per la vendita del terreno:
GUILDLAND_DELA_VOTE_RESULT4	Il sondaggio non è valido.
GUILDLAND_DELA_VOTE_TEXT	A quale gilda vuoi vendere il terreno della gilda?
GUILDLAND_DELA_VOTE_TEXT1	Voti a favore della vendita del terreno della gilda?
GUILDLAND_DONTHAVE_LAND	Non possiedi alcun terreno della gilda.
GUILDLAND_NOT	No
GUILDLAND_VOTE_TEXT	Vuoi cedere il terreno a [%s]?
GUILDLIST_APPLICANT	Vuoi candidarti?
GUILDMARK_UPLOADER_ERROR_128_HEIGHT	L'altezza non è di 128 Pixel
GUILDMARK_UPLOADER_ERROR_12_HEIGHT	L'altezza non è di 12 Pixel
GUILDMARK_UPLOADER_ERROR_16_WIDTH	La larghezza non è di 16 Pixel
GUILDMARK_UPLOADER_ERROR_64_WIDTH	La larghezza non è di 64 Pixel
GUILDMARK_UPLOADER_ERROR_FILE_FORMAT	Il gioco non supporta questa immagine.
GUILDMARK_UPLOADER_ERROR_PATH	Sposta il file nella cartella metin2/upload.
GUILDMARK_UPLOADER_ERROR_SELECT	Non hai scelto nessuna immagine.
GUILDVOTE_CHANGEMASTER	Cambia Capo della gilda
GUILDVOTE_CHANGEMASTER_RESULT1	La gilda è stata ceduta con successo.
GUILDVOTE_CHANGEMASTER_RESULT2	Ti è stata ceduta la gilda [%s].
GUILDVOTE_CHANGEMASTER_RESULT3	Cedi la gilda al membro [%s].
GUILDVOTE_CHANGEMASTER_RESULT4	Il sondaggio non è valido.
GUILDVOTE_CHANGEMASTER_RESULT5	Nuovo Capo della gilda: %s
GUILDVOTE_CHANGEMASTER_TEXT1	Vuoi cedere la gilda a [%s]?
GUILDVOTE_CHANGEMASTER_TEXT2	
GUILDVOTE_CHANGEMASTER_TEXT3	Vuoi davvero rinunciare alla dirigenza della gilda?
GUILDVOTE_CHANGEMASTER_TEXT4	
GUILDVOTE_CHANGEMASTER_VOTETEXT1	Cedi la gilda al membro [%s].
GUILDVOTE_CHANGEMASTER_VOTETEXT2	Voti a favore della cessione della gilda?
GUILDVOTE_MEMBEROUT	Espelli membro
GUILDVOTE_MEMBEROUT_AUTH	Non possiedi i diritti per eseguire questa azione.
GUILDVOTE_MEMBEROUT_NOMAL	Vuoi davvero allontanare questo membro?
GUILDVOTE_MEMBEROUT_RESULT1	Membro allontanato: [%s]
GUILDVOTE_MEMBEROUT_RESULT2	Risultato del sondaggio
GUILDVOTE_MEMBEROUT_RESULT3	Ti hanno espulso dalla gilda [%s].
GUILDVOTE_MEMBEROUT_RESULT4	Risultato del sondaggio
GUILDVOTE_MEMBEROUT_RESULT5	Il sondaggio non è valido.
GUILDVOTE_MEMBEROUT_TEXT1	Vuoi iniziare il sondaggio contro [%s]?
GUILDVOTE_MEMBEROUT_TEXT2	Sondaggio: espellere questo membro dalla gilda?
GUILDVOTE_MEMBEROUT_VOTETEXT1	Sondaggio: si deve espellere [%s] dalla gilda?
GUILDVOTE_MEMBEROUT_VOTETEXT2	
GUILDVOTE_NO	Contro
GUILDVOTE_OK	A favore
GUILDVOTE_RESULT_AGGRE_MEMBER	Favorevoli: %d
GUILDVOTE_RESULT_ALL_MEMBER	Partecipanti: %d
GUILDVOTE_RESULT_OPPESE_MEMBER	Contrari: %d
GUILDVOTE_RESULT_TIME	%d giorni %d ore %d minuti %d secondi
GUILDVOTE_SELECT_ONE	Scegli un personaggio.
GUILDWAR_ALL	Combattimenti (C)
GUILDWAR_CTF_TITLE	Battaglia per la bandiera
GUILDWAR_DRAW	Parità (P)
GUILDWAR_GAINSCORE_FIFTY	50 punti
GUILDWAR_GAINSCORE_HUNDRED	100 punti
GUILDWAR_GAINSCORE_THIRTY	30 punti
GUILDWAR_GAMETIME_SIXTY	60 minuti
GUILDWAR_GAMETIME_TEN	10 minuti
GUILDWAR_GAMETIME_THIRTY	30 minuti
GUILDWAR_INPUT_OTHERGUILD	Registra gilda avversaria.
GUILDWAR_LADDER	Punti karma
GUILDWAR_LIMIT_MEMBER_FIVE	Numero minimo di partecipanti: 5.
GUILDWAR_LOSE	Sconfitta (S)
GUILDWAR_NORMAL_TITLE	Battaglia campale
GUILDWAR_OVER_MEMBERCOUNT	Hai raggiunto il limite di membri.
GUILDWAR_QUESTION_LINE_1	La Gilda %s ha dichiarato guerra alla tua Gilda.
GUILDWAR_QUESTION_LINE_2	Accetti? (%s)
GUILDWAR_RANKING	Rango
GUILDWAR_RECODE_ALL	%d C; %d V; %d S; %d P
GUILDWAR_SELECT_MEMBER_COUNT	Scegli il numero dei partecipanti.
GUILDWAR_TYPE_DEFENSE	Battaglia difensiva
GUILDWAR_TYPE_TIGER	Battaglia di annientamento
GUILDWAR_TYPE_TIME	Attacco a tempo
GUILDWAR_UNKNOWN_TITLE	...
GUILDWAR_WARP_TITLE	Campo di battaglia
GUILDWAR_WIN	Vittorie (V)
GUILDWAR_WIN_FIVE	Cinque round
GUILDWAR_WIN_ONE	Un round
GUILDWAR_WIN_THREE	Tre round
GUILDWINDOW_BUTTON_BANKGOLDINFO	Log Magazzino della Gilda
GUILDWINDOW_BUTTON_BASEABANDON	Cedi terreno della gilda
GUILDWINDOW_BUTTON_BASEDEAL	Vendi terreno della gilda
GUILDWINDOW_BUTTON_BASEDEALVOTE	Sondaggio
GUILDWINDOW_BUTTON_BOARD	Appunti della gilda
GUILDWINDOW_BUTTON_CHANGEMASTER	Cambia Capo della gilda
GUILDWINDOW_BUTTON_DECLARE	Dichiarazione di guerra
GUILDWINDOW_BUTTON_DONATE	Donazione
GUILDWINDOW_BUTTON_GOLDIN	Versamento
GUILDWINDOW_BUTTON_GOLDOUT	Prelievo
GUILDWINDOW_BUTTON_GRADE	Amministra diritti
GUILDWINDOW_BUTTON_GUILDLIST	Lista delle gilde
GUILDWINDOW_BUTTON_HEALGSP	Ripristina Forza del drago
GUILDWINDOW_BUTTON_INFO	Informazioni della gilda
GUILDWINDOW_BUTTON_LANDINFO	Informazioni terreno
GUILDWINDOW_BUTTON_MARK	Carica Stemma della gilda
GUILDWINDOW_BUTTON_MEMBER	Membri
GUILDWINDOW_BUTTON_OFFER	Dona EXP
GUILDWINDOW_BUTTON_OUTMEMBER	Espelli membro
GUILDWINDOW_BUTTON_SKILL	Abilità della gilda
GUILDWINDOW_BUTTON_SYMBOL	Carica Stemma della gilda
GUILDWINDOW_BUTTON_VOTECHECK	Controlla sondaggio
GUILDWINDOW_BUY_GUILD_LAND	Acquisto di terreno
GUILDWINDOW_CHANGE_BLACKSMITH	Cambia professione
GUILDWINDOW_CHANGE_OBJECT	Modifica
GUILDWINDOW_CHANGE_SMELTER	Modifica della fornace
GUILDWINDOW_CREATE_OBJECT	Costruzione di edifici
GUILDWINDOW_DEAL_GUILD_LAND	Vendita di terreno
GUILDWINDOW_GRADE_BANK	Si possono usare la banca della gilda e il Magazzino della gilda
GUILDWINDOW_GRADE_DRIVEOUTAUTHORITY	Si può espellere il membro dalla gilda
GUILDWINDOW_GRADE_GRADENAME	Nome di rango
GUILDWINDOW_GRADE_GRADENUMBER	Numero di rango
GUILDWINDOW_GRADE_GUILDWAR	Si possono scegliere i membri che partecipano in veste di guerrieri
GUILDWINDOW_GRADE_INVITEAUTHORITY	Si possono ammettere dei giocatori nella gilda
GUILDWINDOW_GRADE_NOTICEAUTHORITY	Appendi appunti della gilda
GUILDWINDOW_GRADE_SKILLAUTHORITY	Si possono utilizzare le abilità della gilda
GUILDWINDOW_INFO_LEVEL10	Incrementa num. max. membri
GUILDWINDOW_INFO_LEVEL15	Sconto: Forza del drago
GUILDWINDOW_INFO_LEVEL20	Banca: detassazione
GUILDWINDOW_INFO_LEVEL5	+5% EXP donazioni gilda
GUILDWINDOW_LIST_ALL	Tutti i regni
GUILDWINDOW_LIST_ALREADY_REGISTER	[Gilda] Hai già presentato la candidatura.
GUILDWINDOW_LIST_APPLICANT_LIST	Lista candidati
GUILDWINDOW_LIST_CHRACTER_JOB	Classe
GUILDWINDOW_LIST_CHRACTER_LV	Livello
GUILDWINDOW_LIST_CHRACTER_NAME	Nome del personaggio
GUILDWINDOW_LIST_CHRACTER_SUB_JOB	Dottrina
GUILDWINDOW_LIST_EMPIRE_A	Shinsoo
GUILDWINDOW_LIST_EMPIRE_B	Chunjo
GUILDWINDOW_LIST_EMPIRE_C	Jinno
GUILDWINDOW_LIST_GUILDMEMBER	Membri
GUILDWINDOW_LIST_GUILD_LIST	Lista delle gilde
GUILDWINDOW_LIST_GUILD_LV	Livello
GUILDWINDOW_LIST_GUILD_NAME	Gilda
GUILDWINDOW_LIST_INPUT_GUILDNAME	[Gilda] Inserisci un nome per la gilda.
GUILDWINDOW_LIST_LADDER	Punti karma
GUILDWINDOW_LIST_NOTPROMOTEGUILD	[Gilda] Questa gilda non ha bando.
GUILDWINDOW_LIST_PROMOTE_GUILD	Candidatura
GUILDWINDOW_LIST_PROMOTE_GUILD_LIST	Lista delle gilde
GUILDWINDOW_LIST_RANKING	Posizione
GUILDWINDOW_LIST_RANKING_COUNT	Posizione
GUILDWINDOW_LIST_REGISTER	Candidature
GUILDWINDOW_LIST_REGISTER_GUILD	Candidati in una gilda
GUILDWINDOW_LIST_SEARCH	Cerca
GUILDWINDOW_LIST_SELECT_GUILD	[Gilda] Scegli una gilda in cui ti vuoi candidare.
GUILDWINDOW_PROMOTE_REFRESH	Pubblicità
GUILDWINDOW_PROMOTE_REGISTER	Pubblicità
GUILDWINDOW_SP_RECOVER	Forza del Drago
GUILDWINDOW_UPGRADE_ALTEROFPOWER	Ampliamento dell'altare
GUILDWINDOW_UPGRADE_GUILDBANK	Ampliamento della banca
GUILD_ATTENDANCE_FAIL_ALREADY	Oggi hai già partecipato.
GUILD_ATTENDANCE_FAIL_JOIN_TIME	Ora non puoi partecipare. Sarà possibile partecipare di nuovo a partire dalle ore 05:00.
GUILD_BANKINFO_CLOSE	Chiudi
GUILD_BANKINFO_NAME	Membro
GUILD_BANKINFO_TYPE	Oggetto/Valuta
GUILD_BANKINFO_USETYPE	Offerta
GUILD_BANK_CLOSE	Chiudi
GUILD_BANK_INFO	Log Magazzino della Gilda
GUILD_BOARD_ID	Membro
GUILD_BOARD_TEXT	Messaggio
GUILD_BUILDING_FIX_CHANGE	Vuoi davvero cambiare posizione?
GUILD_BUILDING_FIX_CHANGE_GOLD	Costo: 1.000.000 Yang
GUILD_BUILDING_FIX_DELETE	Vuoi davvero eliminare l'oggetto?
GUILD_BUILDING_FIX_NEED_BUILDING	Non ci sono edifici disponibili.
GUILD_BUILDING_GRADE	Posizione
GUILD_BUILDING_NAME	Nome della costruzione
GUILD_CANNOT_HEAL_GSP_ANYMORE	L'energia dello spirito del drago è completamente rigenerata.
GUILD_COMMENT	Scrivi
GUILD_CREATE_ERROR_INSULT_NAME	Nome della Gilda non consentito.
GUILD_DEFAULT_GRADE	Membro della Gilda
GUILD_DELETE	Cancella
GUILD_DEPOSIT	Deposita
GUILD_DONATE_FAIL_NOT_ENOUGH_HIGH_ITEM	Non hai abbastanza Buoni Donazione generosa.
GUILD_DONATE_FAIL_NOT_ENOUGH_INVENTORY	Il tuo inventario è pieno. Non puoi fare donazioni.
GUILD_DONATE_FAIL_NOT_ENOUGH_LEVEL	Il tuo personaggio deve aver raggiunto almeno il livello 30.
GUILD_DONATE_FAIL_NOT_ENOUGH_MIDDLE_ITEM	Non hai abbastanza Buoni Donazione media.
GUILD_DONATE_FAIL_NOT_ENOUGH_YANG	Non hai abbastanza Yang.
GUILD_DONATE_FAIL_TIME	Ci vediamo tra 24 ore!
GUILD_DONATE_QUESTION_HIGH	Vuoi fare una Donazione generosa?
GUILD_DONATE_QUESTION_MIDDLE	Vuoi fare una Donazione media?
GUILD_DONATE_QUESTION_NORMAL	Vuoi fare una Donazione minima?
GUILD_DO_YOU_HEAL_GSP	Desideri spendere %d Yang per rigenerare %d unità di spirito del drago?
GUILD_DO_YOU_JOIN	  ti ha invitato. Desideri entrare nella Gilda?
GUILD_DRAGONLAIR_MIN	Min.
GUILD_DRAGONLAIR_PARTY_ALL	Classifica generale
GUILD_DRAGONLAIR_PARTY_LINE_FOUR	dall'11º posto: 100 Gaya
GUILD_DRAGONLAIR_PARTY_LINE_HELP	Aiuto
GUILD_DRAGONLAIR_PARTY_LINE_ONE	1º posto: 400 Gaya
GUILD_DRAGONLAIR_PARTY_LINE_THREE	4° - 10º posto: 200 Gaya
GUILD_DRAGONLAIR_PARTY_LINE_TWO	2° - 3º posto: 300 Gaya
GUILD_DRAGONLAIR_PARTY_MEMBER	Membri
GUILD_DRAGONLAIR_PARTY_NOW	Classifica settimanale
GUILD_DRAGONLAIR_PARTY_PAST	Classifica precedente
GUILD_DRAGONLAIR_PARTY_TIME	Tempo
GUILD_DRAGONLAIR_PARTY_TOOLTIP_TITLE	Ricompensa
GUILD_DRAGONLAIR_RANKING_FAIL	TENTATIVO FALLITO
GUILD_DRAGONLAIR_RANKING_NONE	NOVITÀ
GUILD_DRAGONLAIR_RANKING_SUCCESS	CE L'HAI FATTA!
GUILD_DRAGONLAIR_SECOND	Sec.
GUILD_EMPTY_AREA	Terra di nessuno
GUILD_ENEMY_GUILD_NAME	Nome della Gilda avversaria
GUILD_FACILITY	Edificio secondario
GUILD_GEM	Pietra preziosa
GUILD_HEADQUARTER	Edificio principale
GUILD_HEAL_GSP	Rigenera lo spirito del drago
GUILD_INFO_ENEMY_GUILD_EMPTY	Nessuno
GUILD_MARK_NOT_ENOUGH_LEVEL	È richiesto minimo livello 3
GUILD_MARK_UPLOAD_NOTICE	Attendi per poter registrare i loghi della gilda.
GUILD_MEMBER_JOB	Classe
GUILD_MEMBER_KNIGHT	Guerriero
GUILD_MEMBER_LEVEL	Livello
GUILD_MEMBER_NAME	Membro
GUILD_MEMBER_RANK	Rango
GUILD_MEMBER_SPECIFIC_GRAVITY	EXP donati
GUILD_NAME	Nome della Gilda
GUILD_NOT_ENOUGH_MATERIAL	Non possiedi abbastanza materiale per questo edificio.
GUILD_NOT_ENOUGH_MONEY	Non possiedi abbastanza Yang per questo edificio.
GUILD_NO_NOTICE_PERMISSION	Non sei autorizzato a fare un annuncio.
GUILD_OBJECT	Oggetti
GUILD_OFFER_EXP	Esperienza da investire
GUILD_SHORT_EXP	Non hai abbastanza punti esperienza.
GUILD_TILE_BASEINFO	Informazioni terreno
GUILD_TILE_BOARD	Appunti della gilda
GUILD_TILE_GRADE	Amministra diritti
GUILD_TILE_INFO	Informazioni della Gilda
GUILD_TILE_MEMBER	Membri
GUILD_TILE_SKILL	Abilità della Gilda
GUILD_USE_MASTER_ONLY	Solo il Capo della gilda è in possesso di tale diritto.
GUILD_VILLAGE_01	Miryang
GUILD_VILLAGE_02	Songpa
GUILD_VILLAGE_03	Daeyami
GUILD_WAR1	Area della Guerra tra Gilde
GUILD_WAR2	Area della Guerra tra Gilde
GUILD_WAR3	Area della Guerra tra Gilde
GUILD_WAR4	Area della Guerra tra Gilde
GUILD_WAR_GAINSCORE_FIFTY	50 punti
GUILD_WAR_GAINSCORE_HUNDRED	100 punti
GUILD_WAR_GAINSCORE_THIRTY	30 punti
GUILD_WAR_GAMETIME_SIXTY	60 minuti
GUILD_WAR_GAMETIME_TEN	10 minuti
GUILD_WAR_GAMETIME_THIRTY	30 minuti
GUILD_WAR_LIMIT_30MIN	Tempo: 30 minuti
GUILD_WAR_REWARD_POTION	Ricompensa: Il vincitore riceve pozioni.
GUILD_WAR_SELECT_WAR	Seleziona tipo di battaglia
GUILD_WAR_TYPE_DEFENSE	Battaglia difensiva
GUILD_WAR_TYPE_DIE	Battaglia arena
GUILD_WAR_TYPE_FLAG	Battaglia per la bandiera
GUILD_WAR_TYPE_NORMAL	Battaglia campale
GUILD_WAR_TYPE_TIGER	Battaglia di annientamento
GUILD_WAR_TYPE_TIME	Attacco a tempo
GUILD_WAR_USE_BATTLE_MAP	Usa il campo di battaglia della Gilda
GUILD_WAR_USE_NORMAL_MAP	Luogo: mappa normale
GUILD_WAR_WIN_CHECK_SCORE	Chi ha il risultato maggiore vince la guerra.
GUILD_WAR_WIN_FIVE	Cinque round
GUILD_WAR_WIN_ONE	Un round
GUILD_WAR_WIN_TAKE_AWAY_FLAG1	Conquista la bandiera dell'avversario
GUILD_WAR_WIN_TAKE_AWAY_FLAG2	e portala alla tua base
GUILD_WAR_WIN_THREE	Tre round
GUILD_WAR_WIN_WIPE_OUT_GUILD	Per vincere distruggi tutti i tuoi avversari.
GUILD_WITHDRAW	Ritirata
GUILD_YOU_DO_NOT_JOIN	Non appartieni a nessuna Gilda
HORSE_HEALTH0	Morto
HORSE_HEALTH1	Denutrito
HORSE_HEALTH2	Affamato
HORSE_HEALTH3	Sazio
HORSE_LEVEL1	Cavallo normale
HORSE_LEVEL2	Cavallo da Battaglia
HORSE_LEVEL3	Cavallo militare
HOUR	h
HOW_MANY_ITEM_DO_YOU_DROP1	Desideri lasciar cadere %s ?
HOW_MANY_ITEM_DO_YOU_DROP2	Desideri lasciar cadere %s %d ?
INPUT_MATRIX_CARD_NUMBER	Inserire numer omatrix della carta
INPUT_MATRIX_CARD_TITLE	Matrix della carta
INPUT_PRIVATE_CODE_DIALOG_DESCRIPTION	Inserisci qui il codice che hai inserito nell'iscrizione
INPUT_PRIVATE_CODE_DIALOG_TITLE	Cancella personaggio
INVENTORY_DO_NOT_PACK_WARP_SCROLL	Il papiro del ritorno non può essere unito.
INVENTORY_REALLY_USE_ITEM	Vuoi usare l'item su questo oggetto?
INVENTORY_REALLY_USE_ITEM2	Vuoi veramente utilizzare questo oggetto?
INVENTORY_REALLY_USE_PET_BAG_ITEM	Vuoi veramente mettere il tuo pet nel Trasportino?
INVENTORY_REALLY_USE_PET_BAG_TAKE_OUT	Vuoi aprire il Trasportino?
INVENTORY_REALLY_USE_PET_FEEDSTUFF_ITEM	Vuoi dare %s a %s perché lo mangi?
IS_NOT_PET_CHANGE_ITEM	Questo non è l'item Incanta pet.
IS_NOT_PET_ITEM	Questo non è un pet.
JOB_ASSASSIN	Ninja
JOB_ASSASSIN0	Nessuno
JOB_ASSASSIN1	Vicininja
JOB_ASSASSIN2	Lontaninja
JOB_SHAMAN	Shamano
JOB_SHAMAN0	Nessuno
JOB_SHAMAN1	Shamano del drago
JOB_SHAMAN2	Shamano della guarigione
JOB_SURA	Sura
JOB_SURA0	Nessuno
JOB_SURA1	Sura delle armi
JOB_SURA2	Sura della magia
JOB_WARRIOR	Guerriero
JOB_WARRIOR0	Nessuno
JOB_WARRIOR1	Guerriero corporale
JOB_WARRIOR2	Guerriero mentale
JOB_WOLFMAN	Lican
JOB_WOLFMAN0	Lican principiante
JOB_WOLFMAN1	Istinto
JOB_WOLFMAN2	N.A.
KEYCHANGE_DONT_SAVE_EXIT	Chiudere o salvare?
KEYCHANGE_IMPOSSIBLE_CHANGE	Qui [Ctrl], [Alt] e [Shift] non sono ammessi!
KEYCHANGE_SAVE_EXIT	Chiudere o salvare?
KEY_0	0
KEY_0_LALT	ALT + 0
KEY_0_LCONTROL	CTRL + 0
KEY_0_LSHIFT	MAIUSC + 0
KEY_1	1
KEY_1_LALT	ALT + 1
KEY_1_LCONTROL	CTRL + 1
KEY_1_LSHIFT	MAIUSC + 1
KEY_2	2
KEY_2_LALT	ALT + 2
KEY_2_LCONTROL	CTRL + 2
KEY_2_LSHIFT	MAIUSC + 2
KEY_3	3
KEY_3_LALT	ALT + 3
KEY_3_LCONTROL	CTRL + 3
KEY_3_LSHIFT	MAIUSC + 3
KEY_4	4
KEY_4_LALT	ALT + 4
KEY_4_LCONTROL	CTRL + 4
KEY_4_LSHIFT	MAIUSC + 4
KEY_5	5
KEY_5_LALT	ALT + 5
KEY_5_LCONTROL	CTRL + 5
KEY_5_LSHIFT	MAIUSC + 5
KEY_6	6
KEY_6_LALT	ALT + 6
KEY_6_LCONTROL	CTRL + 6
KEY_6_LSHIFT	MAIUSC + 6
KEY_7	7
KEY_7_LALT	ALT + 7
KEY_7_LCONTROL	CTRL + 7
KEY_7_LSHIFT	MAIUSC + 7
KEY_8	8
KEY_8_LALT	ALT + 8
KEY_8_LCONTROL	CTRL + 8
KEY_8_LSHIFT	MAIUSC + 8
KEY_9	9
KEY_9_LALT	ALT + 9
KEY_9_LCONTROL	CTRL + 9
KEY_9_LSHIFT	MAIUSC + 9
KEY_A	A
KEY_ADD	+
KEY_A_LALT	ALT + A
KEY_A_LCONTROL	CTRL + A
KEY_A_LSHIFT	MAIUSC + A
KEY_B	B
KEY_B_LALT	ALT + B
KEY_B_LCONTROL	CTRL + B
KEY_B_LSHIFT	MAIUSC + B
KEY_C	C
KEY_COMMA	,
KEY_COMMA_LALT	ALT + ,
KEY_COMMA_LCONTROL	CTRL + ,
KEY_COMMA_LSHIFT	MAIUSC + ,
KEY_C_LALT	ALT + C
KEY_C_LCONTROL	CTRL + C
KEY_C_LSHIFT	MAIUSC + C
KEY_D	D
KEY_DOWN	GIÙ
KEY_D_LALT	ALT + D
KEY_D_LCONTROL	CTRL + D
KEY_D_LSHIFT	MAIUSC + D
KEY_E	E
KEY_E_LALT	ALT + E
KEY_E_LCONTROL	CTRL + E
KEY_E_LSHIFT	MAIUSC + E
KEY_F	F
KEY_F1	F1
KEY_F10	F10
KEY_F10_LALT	ALT + F10
KEY_F10_LCONTROL	CTRL + F10
KEY_F10_LSHIFT	MAIUSC + F10
KEY_F1_LALT	ALT + F1
KEY_F1_LCONTROL	CTRL + F1
KEY_F1_LSHIFT	MAIUSC + F1
KEY_F2	F2
KEY_F2_LALT	ALT + F2
KEY_F2_LCONTROL	CTRL + F2
KEY_F2_LSHIFT	MAIUSC + F2
KEY_F3	F3
KEY_F3_LALT	ALT + F3
KEY_F3_LCONTROL	CTRL + F3
KEY_F3_LSHIFT	MAIUSC + F3
KEY_F4	F4
KEY_F4_LALT	ALT + F4
KEY_F4_LCONTROL	CTRL + F4
KEY_F4_LSHIFT	MAIUSC + F4
KEY_F5	F5
KEY_F5_LALT	ALT + F5
KEY_F5_LCONTROL	CTRL + F5
KEY_F5_LSHIFT	MAIUSC + F5
KEY_F6	F6
KEY_F6_LALT	ALT + F6
KEY_F6_LCONTROL	CTRL + F6
KEY_F6_LSHIFT	MAIUSC + F6
KEY_F7	F7
KEY_F7_LALT	ALT + F7
KEY_F7_LCONTROL	CTRL + F7
KEY_F7_LSHIFT	MAIUSC + F7
KEY_F8	F8
KEY_F8_LALT	ALT + F8
KEY_F8_LCONTROL	CTRL + F8
KEY_F8_LSHIFT	MAIUSC + F8
KEY_F9	F9
KEY_F9_LALT	ALT + F9
KEY_F9_LCONTROL	CTRL + F9
KEY_F9_LSHIFT	MAIUSC + F9
KEY_F_LALT	ALT + F
KEY_F_LCONTROL	CTRL + F
KEY_F_LSHIFT	MAIUSC + F
KEY_G	G
KEY_GRAVE	\
KEY_GRAVE_LALT	ALT + \
KEY_GRAVE_LCONTROL	CTRL + \
KEY_GRAVE_LSHIFT	MAIUSC + \
KEY_G_LALT	ALT + G
KEY_G_LCONTROL	CTRL + G
KEY_G_LSHIFT	MAIUSC + G
KEY_H	H
KEY_H_LALT	ALT + H
KEY_H_LCONTROL	CTRL + H
KEY_H_LSHIFT	MAIUSC + H
KEY_I	I
KEY_I_LALT	ALT + I
KEY_I_LCONTROL	CTRL + I
KEY_I_LSHIFT	MAIUSC + I
KEY_J	J
KEY_J_LALT	ALT + J
KEY_J_LCONTROL	CTRL + J
KEY_J_LSHIFT	MAIUSC + J
KEY_K	K
KEY_K_LALT	ALT + K
KEY_K_LCONTROL	CTRL + K
KEY_K_LSHIFT	MAIUSC + K
KEY_L	L
KEY_LALT	ALT
KEY_LCONTROL	CTRL
KEY_LEFT	SINISTRA
KEY_LSHIFT	MAIUSC
KEY_L_LALT	ALT + L
KEY_L_LCONTROL	CTRL + L
KEY_L_LSHIFT	MAIUSC + L
KEY_M	M
KEY_M_LALT	ALT + M
KEY_M_LCONTROL	CTRL + M
KEY_M_LSHIFT	MAIUSC + M
KEY_N	N
KEY_NUMLOCK	BLOC NUM
KEY_NUMPAD0	TastNum 0
KEY_NUMPAD1	TastNum 1
KEY_NUMPAD2	TastNum 2
KEY_NUMPAD3	TastNum 3
KEY_NUMPAD4	TastNum 4
KEY_NUMPAD5	TastNum 5
KEY_NUMPAD6	TastNum 6
KEY_NUMPAD7	TastNum 7
KEY_NUMPAD8	TastNum 8
KEY_NUMPAD9	TastNum 9
KEY_N_LALT	ALT + N
KEY_N_LCONTROL	CTRL + N
KEY_N_LSHIFT	MAIUSC + N
KEY_O	O
KEY_O_LALT	ALT + O
KEY_O_LCONTROL	CTRL + O
KEY_O_LSHIFT	MAIUSC + O
KEY_P	P
KEY_PERIOD	.
KEY_PERIOD_LALT	ALT + .
KEY_PERIOD_LCONTROL	CTRL + .
KEY_PERIOD_LSHIFT	MAIUSC + .
KEY_PGDN	PGGIÙ
KEY_PGUP	PGSU
KEY_P_LALT	ALT + P
KEY_P_LCONTROL	CTRL + P
KEY_P_LSHIFT	MAIUSC + P
KEY_Q	Q
KEY_Q_LALT	ALT + Q
KEY_Q_LCONTROL	CTRL + Q
KEY_Q_LSHIFT	MAIUSC + Q
KEY_R	R
KEY_RIGHT	DESTRA
KEY_R_LALT	ALT + R
KEY_R_LCONTROL	CTRL + R
KEY_R_LSHIFT	MAIUSC + R
KEY_S	S
KEY_SPACE	SPAZIO
KEY_SUBTRACT	-
KEY_SYSRQ	STAMP
KEY_S_LALT	ALT + S
KEY_S_LCONTROL	CTRL + S
KEY_S_LSHIFT	MAIUSC + S
KEY_T	T
KEY_TAB	TAB
KEY_T_LALT	ALT + T
KEY_T_LCONTROL	CTRL + T
KEY_T_LSHIFT	MAIUSC + T
KEY_U	U
KEY_UP	SU
KEY_U_LALT	ALT + U
KEY_U_LCONTROL	CTRL + U
KEY_U_LSHIFT	MAIUSC + U
KEY_V	V
KEY_V_LALT	ALT + V
KEY_V_LCONTROL	CTRL + V
KEY_V_LSHIFT	MAIUSC + V
KEY_W	W
KEY_W_LALT	ALT + W
KEY_W_LCONTROL	CTRL + W
KEY_W_LSHIFT	MAIUSC + W
KEY_X	X
KEY_X_LALT	ALT + X
KEY_X_LCONTROL	CTRL + X
KEY_X_LSHIFT	MAIUSC + X
KEY_Y	Y
KEY_Y_LALT	ALT + Y
KEY_Y_LCONTROL	CTRL + Y
KEY_Y_LSHIFT	MAIUSC + Y
KEY_Z	Z
KEY_Z_LALT	ALT + Z
KEY_Z_LCONTROL	CTRL + Z
KEY_Z_LSHIFT	MAIUSC + Z
LEADER_NAME	Nome del capo
LEFT_TIME	Tempo rimanente
LIMIT_LEVEL_GUILD	Livello gilda: %d
LOGIN_CONNECT_FAILURE	Errore di collegamento con il server.
LOGIN_CONNECT_SUCCESS	Sei stato collegato al server.
LOGIN_CONNETING	Attendi, connessione al server in corso.
LOGIN_FAILURE_ALREAY	Il tuo account è già collegato!
LOGIN_FAILURE_BACKEND_ERR	Si è verificato un errore. Ti preghiamo di contattare il supporto.
LOGIN_FAILURE_BE_SAME_KEY	Problema d'iscrizione
LOGIN_FAILURE_BLOCK_ID	Questo account è bloccato.
LOGIN_FAILURE_BLOCK_LOGIN	Sei pregato di scegliere un altro server!
LOGIN_FAILURE_COUNTRY_ERR	Il codice del Paese non è corretto.\nTi preghiamo di contattare il supporto.
LOGIN_FAILURE_INTEGRTING	Questo account è in fase di fusione. Riprova più tardi.
LOGIN_FAILURE_IOVATION_ERR	Si è verificato un errore. Rivolgiti al nostro supporto.
LOGIN_FAILURE_NOBILL	Il tuo account non presenta alcun tempo di gioco.
LOGIN_FAILURE_NOT_AVAIL	L'account non è disponibile.
LOGIN_FAILURE_NOT_EXIST_ID	Nome account o password errati.
LOGIN_FAILURE_NOT_MAIL_CONFIRM	È necessario verificare il tuo account via e-mail.
LOGIN_FAILURE_REPAIR_ID	È in corso il ripristino di alcuni oggetti per questo account.
LOGIN_FAILURE_SAMELOGIN	Qualcuno si è collegato al tuo account.
LOGIN_FAILURE_SHUTDOWN	Il server non è ancora aperto.
LOGIN_FAILURE_STEAM_SESSION	La sessione è scaduta. Riavvia il client.
LOGIN_FAILURE_TNT_SESSION	Impossibile aprire il client. Riavvia il launcher ed effettua il login.
LOGIN_FAILURE_TOO_MANY_USER	Non sei riuscito a connetterti perchè ci sono troppi giocatori
LOGIN_FAILURE_UNKNOWN	Non sei riuscito a connetterti per ragioni sconosciute.
LOGIN_FAILURE_WEB_BLOCK	È stato bloccato sulla pagina web. Per favore controlli la sua e-mail
LOGIN_FAILURE_WRONG_MATRIX_CARD_NUMBER	Hai inserito un numero sbagliato.
LOGIN_FAILURE_WRONG_MATRIX_CARD_NUMBER_TRIPLE	Hai inserito per tre volte un numero sbagliato. La connessione è stata conclusa.
LOGIN_FAILURE_WRONG_PASSWORD	Nome account o password errati.
LOGIN_INPUT_ID	Inserisci l'ID.
LOGIN_INPUT_PASSWORD	Inserisci la password.
LOGIN_PROCESSING	È in corso il login.
LUCKY_BOX_DIALOG_RECV_TEXT	Vuoi accettare l'item?
LUCKY_BOX_DIALOG_RETRY_TEXT	Vuoi tentare di nuovo?
MAILBOX_FAIL_USE_TIME_LIMIT	Aggiornamento della casella di posta in corso. Riprova più tardi.
MAILBOX_POST_ALL_DELETE_FAIL_EMPTY	Nessun messaggio
MAILBOX_POST_ALL_DELETE_QUESTION1	Eliminare tutti i messaggi?
MAILBOX_POST_ALL_DELETE_QUESTION2	I messaggi con allegato non verranno eliminati.
MAILBOX_POST_ALL_GET_ITEMS_FAIL_EMPTY	La tua casella di posta non contiene alcun messaggio con allegato.
MAILBOX_POST_ALL_GET_ITEMS_QUESTION	Accettare allegato? (Imposte per Yang: 5%)
MAILBOX_POST_DELETE_FAIL_EXIST_ITEMS	Non è stato possibile eliminare il messaggio. Devi prima accettare l'allegato.
MAILBOX_POST_DELETE_QUESTION	Vuoi davvero eliminare questo messaggio?
MAILBOX_POST_GET_ITEMS_NOT_ENOUGHT_INVENTORY	Non è stato possibile accettare gli item. Il tuo inventario è pieno.
MAILBOX_POST_GET_ITEMS_QUESTION	Accettare allegato? (Imposte per Yang: 5%)
MAILBOX_POST_GET_ITEMS_WON_OVERFLOW	Non puoi più accettare alcuno Won.
MAILBOX_POST_GET_ITEMS_YANG_OVERFLOW	Non puoi più accettare alcuno Yang.
MAILBOX_POST_GM_ARRIVE	Messaggio del GM
MAILBOX_POST_NOT_CONFIRM_INFO_1	Messaggi non letti: %d
MAILBOX_POST_NOT_CONFIRM_INFO_2	Senza allegato: %d / Con allegato: %d
MAILBOX_POST_READ_BLOCK	Vuoi davvero bloccare %s?
MAILBOX_POST_WRITE_ALREADY_ITEM	Ogni messaggio può contenere un solo item.
MAILBOX_POST_WRITE_CAN_NOT_SPLIT_ITEM	Distribuisci gli item nel tuo inventario prima di allegarli singolarmente a un messaggio.
MAILBOX_POST_WRITE_CONFIRM_FAIL	Destinatario sconosciuto. Non è stato possibile inviare il messaggio.
MAILBOX_POST_WRITE_CONFIRM_FULL_MAILBOX	La casella di posta del destinatario è piena. Non è stato possibile inviare il messaggio.
MAILBOX_POST_WRITE_LEVEL_LIMIT	Puoi inviare messaggi a partire dal livello 20.
MAILBOX_POST_WRITE_MONEY_NOT_ENOUGHT	Non hai abbastanza Yang per poter inviare questo messaggio.
MAILBOX_POST_WRITE_NAME_CHECK	Conferma il nome del destinatario cliccando su "Verifica destinatario".
MAILBOX_POST_WRITE_NAME_EMPTY	Digita un destinatario.
MAILBOX_POST_WRITE_QUESTION1	Vuoi inviare un messaggio a %s adesso?
MAILBOX_POST_WRITE_QUESTION2	Costo della consegna: %d Yang
MAILBOX_POST_WRITE_SEND_FAIL_EMPTY_NAME	Digita un destinatario.
MAILBOX_POST_WRITE_SEND_FAIL_EMPTY_TITLE	Digita un oggetto.
MAILBOX_POST_WRITE_SEND_MONEY_TITLE	Somma di denaro
MAILBOX_POST_WRITE_WRONG_ITEM	Non si possono inviare item legati all'anima.
MAILBOX_POST_WRITE_WRONG_MESSAGE	Il messaggio contiene parole vietate.
MAILBOX_POST_WRITE_WRONG_TITLE	L'oggetto contiene parole vietate.
MALL_CANNOT_INSERT	Non puoi collocare l'oggetto.
MALL_PASSWORD_TITLE	Password
MAP_A1	Zona Yongan
MAP_A2	Valle di Seungryong
MAP_A2_1	
MAP_A3	Zona Yayang
MAP_AG	Jungrang
MAP_B1	Zona Joan
MAP_B2	Valle di Imji
MAP_B3	Zona Bokjung
MAP_BATTLE_FIELD	Zona di combattimento
MAP_BAY	Baia Nefrite
MAP_BAYBLACKSAND	Baia Nefrite
MAP_BG	Waryong
MAP_BOSS_AWAKEN_DAWNMIST	RSV: Foresta Incantata
MAP_BOSS_AWAKEN_FLAME	RSV: Fortezza Drago Rosso
MAP_BOSS_AWAKEN_SKIPIA	RSV: Grotta dell'Esilio
MAP_BOSS_AWAKEN_SNOW	RSV: Torre Vedetta Nemere
MAP_BOSS_CRACK_DAWNMIST	FT: Foresta Incantata
MAP_BOSS_CRACK_FLAME	FT: Fortezza Drago Rosso
MAP_BOSS_CRACK_SKIPIA	FT: Grotta dell'Esilio
MAP_BOSS_CRACK_SNOW	FT: Torre Vedetta Nemere
MAP_BOSS_LABYRINTH	Altopiano delle Illusioni
MAP_C1	Zona Pyungmoo
MAP_C2	Valle di Bangsan
MAP_C3	Zona Bakra
MAP_CAPE	Capo Fuoco del Drago
MAP_CAPEDRAGONHEAD	Capo Fuoco del Drago
MAP_CG	Imha
MAP_CZ_DUNGEON	Tempio dello Zodiaco
MAP_DAWN	Falesia di Gautama
MAP_DAWNMISTWOOD	Falesia di Gautama
MAP_DAWNMIST_DUNGEON_01	Foresta Incantata
MAP_DEFENSE_WAVE	Difesa nave
MAP_DEFENSE_WAVE_PORT	Porto
MAP_DESERT	Deserto Yongbi
MAP_DEVILCATACOMB	Catacomba del Diavolo
MAP_DEVILTOWER1	Torre dei Demoni
MAP_DUEL	Arena Esercitazioni Belliche
MAP_E	Colonia
MAP_EMPIREWAR01	Battaglia per il Castello
MAP_EMPIREWAR02	Battaglia per il Castello
MAP_EMPIREWAR03	Battaglia per il Castello
MAP_FLAME	Doyyumhwan
MAP_GUILD_01	Jungrang
MAP_GUILD_02	Waryong
MAP_GUILD_03	Imha
MAP_GUILD_PVE	Palazzo del Re Drago
MAP_HOLYPLACE_DESERT	Terra dei Deserti - Guerra dei Regni
MAP_HOLYPLACE_FLAME	Terra di Fuoco - Guerra dei Regni
MAP_HOLYPLACE_ICE	Terra dei Ghiacci - Guerra dei Regni
MAP_MILGYO	Tempio Hwang
MAP_MILGYO_A	
MAP_MINIBOSS_01	Dungeon blu – liv. 40-80
MAP_MINIBOSS_02	Dungeon rosso – dal liv. 81
MAP_MISTS_OF_ISLAND	Isole Nebulose
MAP_MONKEY_DUNGEON	Hasun Dong
MAP_MONKEY_DUNGEON2	Jungsun Dong
MAP_MONKEY_DUNGEON3	Sangsun Dong
MAP_MONKEY_DUNGEON_11	Hasun Dong
MAP_MONKEY_DUNGEON_12	Hasun Dong
MAP_MONKEY_DUNGEON_13	Hasun Dong
MAP_MT_THUNDER	Monti Tonanti
MAP_MT_TH_DUNGEON_01	Tempio degli Ochao
MAP_NUSLUCK	Terra Giganti
MAP_NUSLUCK01	Terra dei Giganti
MAP_N_DESERT_01	Deserto Yongbi
MAP_N_DESERT_02	
MAP_N_FLAME_01	Terra di Fuoco
MAP_N_FLAME_02	
MAP_N_FLAME_DRAGON	Rifugio di Meley
MAP_N_FLAME_DUNGEON_01	Fortezza del Drago Rosso
MAP_N_SNOWM_01	Monte Sohan
MAP_N_SNOWM_02	
MAP_N_SNOW_DUNGEON_01	Torre di Vedetta di Nemere
MAP_N_THREEWAY	Valle di Seungryong
MAP_OXEVENT	Gara OX
MAP_PATHWAY_DESERT_01	Terra dei Deserti - Guerra dei Regni
MAP_PATHWAY_DESERT_02	Terra dei Deserti - Guerra dei Regni
MAP_PATHWAY_DESERT_03	Terra dei Deserti - Guerra dei Regni
MAP_PATHWAY_FLAME_01	Terra di Fuoco - Guerra dei Regni
MAP_PATHWAY_FLAME_02	Terra di Fuoco - Guerra dei Regni
MAP_PATHWAY_FLAME_03	Terra di Fuoco - Guerra dei Regni
MAP_PATHWAY_ICE_01	Terra dei Ghiacci - Guerra dei Regni
MAP_PATHWAY_ICE_02	Spassolandia
MAP_PATHWAY_ICE_03	Terra dei Ghiacci - Guerra dei Regni
MAP_SKELTOWER	Torre di Gumsan
MAP_SKIPIA_DUNGEON_01	Grotta dell'Esilio
MAP_SKIPIA_DUNGEON_011	
MAP_SKIPIA_DUNGEON_012	
MAP_SKIPIA_DUNGEON_013	
MAP_SKIPIA_DUNGEON_02	Grotta dell'Esilio 2
MAP_SKIPIA_DUNGEON_021	
MAP_SKIPIA_DUNGEON_022	
MAP_SKIPIA_DUNGEON_023	
MAP_SKIPIA_DUNGEON_BOSS	Stanza del Drago
MAP_SKIPIA_DUNGEON_BOSS_1	Sotterraneo dei Ragni 1
MAP_SKIPIA_DUNGEON_BOSS_2	Sotterraneo dei Ragni 2
MAP_SKIPIA_DUNGEON_BOSS_3	Sotterraneo dei Ragni 3
MAP_SNOW	Monte Sohan
MAP_SPIDER	Kuahlo Dong
MAP_SPIDERDUNGEON	Sotterraneo dei Ragni 1
MAP_SPIDERDUNGEON_02	Sotterraneo dei Ragni 2
MAP_SPIDERDUNGEON_02_1	Sotterraneo dei Ragni 2
MAP_SPIDERDUNGEON_03	Sotterraneo dei Ragni 3
MAP_SUNGZI	Guerra dei Regni
MAP_SUNGZI_DESERT_01	Terra dei Deserti - Guerra dei Regni
MAP_SUNGZI_DESERT_HILL_01	Terra dei Deserti - Guerra dei Regni
MAP_SUNGZI_DESERT_HILL_02	Terra dei Deserti - Guerra dei Regni
MAP_SUNGZI_DESERT_HILL_03	Terra dei Deserti - Guerra dei Regni
MAP_SUNGZI_FLAME_HILL_01	Terra di Fuoco - Guerra dei Regni
MAP_SUNGZI_FLAME_HILL_02	Terra di Fuoco - Guerra dei Regni
MAP_SUNGZI_FLAME_HILL_03	Terra di Fuoco - Guerra dei Regni
MAP_SUNGZI_SNOW	Terra dei Ghiacci - Guerra dei Regni
MAP_SUNGZI_SNOW_PASS01	Terra dei Ghiacci - Guerra dei Regni
MAP_SUNGZI_SNOW_PASS02	Terra dei Ghiacci - Guerra dei Regni
MAP_SUNGZI_SNOW_PASS03	Terra dei Ghiacci - Guerra dei Regni
MAP_T1	Area della Guerra tra Gilde
MAP_T2	Area della Guerra tra Gilde
MAP_T3	Area della Guerra tra Gilde
MAP_T4	Area della Guerra tra Gilde
MAP_TEMPLE	Tempio Hwang
MAP_THUNDER	Monti Tonanti
MAP_TREE	Lungsam
MAP_TRENT	Bosco Fantasma
MAP_TRENT02	Bosco Rosso
MAP_TRENT02_A	Bosco Rosso
MAP_TRENT_A	
MAP_WEDDING_01	Mappa dei Matrimoni
MAP_WL	Campo Serpi
MAP_WL_01	Campo Serpi
MC_ACCUMULATION_COUNT	Carte mostro raccolte: %d
MC_ALTER_TEXT	Livello missione %d
MC_CARD_FALL_SHORT	Le carte registrate non sono sufficienti.
MC_CARD_SHUFFLE	Vuoi riordinare le carte?
MC_INIT_ITEM_FALL_SHORT	Hai bisogno di %d carta/e del nuovo inizio.
MC_MISSION_FAIL_MSG	Nessuna missione attiva o limite superato.
MC_MISSION_INIT	Vuoi reimpostare la missione al livello 1?
MC_MISSION_NO_CLEAR	Prima devi completare la missione.
MC_MOTION_BUTTON_OVER_MSG	Questa opzione è disponibile solo a partire dalla 2° stella.
MC_POLY_BUTTON_OVER_MSG	Questa opzione è disponibile solo a partire dalla 3° stella.
MC_POLY_FAIL	Ora non puoi trasformarti.
MC_POLY_QUESTION	Vuoi trasformarti in questo mostro?
MC_PROMOTION_MAX	Non è più possibile effettuare un miglioramento.
MC_PROMOTION_QUESTION	Vuoi salire di livello?
MC_QUESTION_BUTTON_DESC1	È possibile reimpostare un massimo di 6 volte ogni 24 ore.
MC_QUESTION_BUTTON_DESC2	Carta del nuovo inizio
MC_QUESTION_BUTTON_DESC3	Clicca qui per visualizzare il tempo di ricarica restante.
MC_REWARD_FAIL	Non hai abbastanza spazio nell'inventario.
MC_REWARD_MISSION	Vuoi ottenere ora la tua carta mostro?
MC_SHUFFLE_NO_ITEM	Non hai alcuna carta del nuovo ordine.
MC_TIME	Tempo di ricarica: %s.
MC_TRADE_QUESTION	Ti verranno prelevate %d carte. Vuoi continuare?
MC_USE_ITEM_FAIL	Impossibile aggiungere questa carta.
MC_USE_ITEM_QUESTION	Vuoi aggiungere questa carta mostro?
MC_WARP_BUTTON_OVER_MSG	Questa opzione è disponibile solo a partire dalla 4° stella.
MC_WARP_FAIL	Non puoi più teletrasportarti.
MC_WARP_LIMIT_LEVEL	Il tuo il livello attuale non è sufficiente per teletrasportarti.
MC_WARP_QUESTION	Vuoi teletrasportarti nella zona di questo mostro?
MD_POPUP_MSG_1	Puoi accedere solamente dal Tempio dello Zodiaco.
MD_POPUP_MSG_2	I guardiani dello zodiaco devono rigenerare la loro forza.\nDagli un po' di tempo.
MD_SYSTEM_MSG_1	Non sei uno zombie. Non puoi combattere mentre sei morto.
MEDAL_OF_HONOR	Medaglia del coraggio
MEDAL_OF_HONOR_SYSTEM_PICK	Item ottenuto: Medaglia del coraggio x %d
MESSENGER_ADD_BLOCK_FRIEND	Aggiungi
MESSENGER_ADD_FRIEND	Aggiungi amico
MESSENGER_BLOCK	Bloccato
MESSENGER_DO_YOU_ACCEPT_ADD_FRIEND_1	%s vuole essere tuo amico.
MESSENGER_DO_YOU_ACCEPT_ADD_FRIEND_2	Accetti?
MESSENGER_DO_YOU_DELETE	Cancelli?
MESSENGER_DO_YOU_DELETE_PHONE_NUMBER	Desideri cancellare il numero di cellulare?
MESSENGER_DO_YOU_MOVE	Desideri andare avanti?
MESSENGER_EMPTY_LIST	Vuoto
MESSENGER_FAMILY	Famiglia
MESSENGER_FRIEND	Amici
MESSENGER_GUILD	Gilda
MESSENGER_INPUT_MOBILE_AUTHORITY_DESCRIPTION	Inserisci il codice di conferma che è stato inviato al tuo cellulare.
MESSENGER_INPUT_MOBILE_AUTHORITY_TITLE	Inserisci il codice di conferma
MESSENGER_INPUT_MOBILE_PHONE_NUMBER_1	Inserisci il numero di cellulare per l'invio di SMS.
MESSENGER_INPUT_MOBILE_PHONE_NUMBER_2	Desideri inserire il numero ora?
MESSENGER_INPUT_MOBILE_PHONE_NUMBER_TITLE	Inserisci numero di cellulare
MESSENGER_SEND_MOBILE_MESSAGE_TITLE	Invia messaggio.
METIN_TEST	
MINIGAMEUI_CALENDAR	Calendario degli eventi
MINIGAME_FISH_EVENT_ADD_ACCEPT	Vuoi aggiungerlo?
MINIGAME_FISH_EVENT_DROP_ACCEPT	Vuoi veramente lasciar cadere questo oggetto?
MINIGAME_FISH_EVENT_REWARD_MSG	Hai ricevuto %s.
MINIGAME_FISH_EVENT_USE_ACCEPT	Vuoi usarlo?
MINIMAP	Mini-mappa
MINIMAP_CANNOT_SEE	La mappa miniaturizzata non può essere visualizzata.
MINIMAP_CAN_NOT_SHOW_AREAMAP	La mappa non può essere visualizzata.
MINIMAP_DEC_SCALE	Zoom out
MINIMAP_INC_SCALE	Zoom in
MINIMAP_OBSERVER_COUNT	%d Spettatori
MINIMAP_OPEN_INGAMEEVENT	Eventi
MINIMAP_SHOW_AREAMAP	Apri mappa grande
MINI_GAME_BNW_DONATE_QUESTION1	Vuoi effettuare una donazione?
MINI_GAME_BNW_DONATE_QUESTION2	Una donazione costa 15 Monete Veggenza.
MINI_GAME_BNW_FONT	Arial:15
MINI_GAME_BNW_GAME_GIVEUP_MSG1	Vuoi davvero interrompere la partita?
MINI_GAME_BNW_GAME_GIVEUP_MSG2	Solo se vinci, riceverai delle ricompense. Ricordatelo.
MINI_GAME_BNW_GAME_RESULT_DRAW	Parità! Hai ricevuto %d Monete Veggenza.
MINI_GAME_BNW_GAME_RESULT_LOSE	Sconfitta! Hai ricevuto %d Monete Veggenza.
MINI_GAME_BNW_GAME_RESULT_SCORE	Punteggio: %d
MINI_GAME_BNW_GAME_RESULT_WIN	Vittoria! Hai ricevuto %d Monete Veggenza.
MINI_GAME_BNW_NOT_ENOUGH_INVEN	Non hai abbastanza spazio nell'inventario.
MINI_GAME_BNW_NOT_ENOUGH_ITEM	Per giocare hai bisogno di un Set Tarot.
MINI_GAME_BNW_NOT_ENOUGH_YANG	Non hai abbastanza Yang per poter giocare.
MINI_GAME_BNW_RESULT_DRAW1	La cifra riportata sulla tua carta è la stessa della carta del tuo avversario.
MINI_GAME_BNW_RESULT_DRAW2	Parità!
MINI_GAME_BNW_RESULT_LOSE1	La cifra riportata sua tua carta è minore rispetto a quella della carta del tuo avversario.
MINI_GAME_BNW_RESULT_LOSE2	Sconfitta!
MINI_GAME_BNW_RESULT_WIN1	La cifra riportata sua tua carta è maggiore rispetto a quella della carta del tuo avversario.
MINI_GAME_BNW_RESULT_WIN2	Vittoria!
MINI_GAME_BNW_START_QUESTION	Per giocare hai bisogno di 30.000 Yang e di un Set Tarot. Vuoi partecipare alla gara?
MINI_GAME_CATCHKING_CHALLENGE_TOOLTIP1	In caso tu usi più unità del %s, riceverai la stessa quantità di bauli come vincita.
MINI_GAME_CATCHKING_CHALLENGE_TOOLTIP2	È possibile usare %d Mazzi del re al massimo.
MINI_GAME_CATCHKING_HELP_MSG1	Peccato! Il valore della tua carta è inferiore.\nNon ottieni punti. Scegli una nuova carta dal mazzo.
MINI_GAME_CATCHKING_HELP_MSG2	Ottimo lavoro! Queste carte hanno lo stesso valore.\nIl tuo turno di gioco è terminato. Scegli una nuova carta dal mazzo.
MINI_GAME_CATCHKING_HELP_MSG3	Continua così! Il valore della tua carta è superiore.\nScopri un'altra carta.
MINI_GAME_CATCHKING_HELP_MSG4	Vicino alla tua carta c'era un [5].\nNon ottieni punti. Ora scegli il re [K].
MINI_GAME_CATCHKING_POPUP_CATCH_FAIL	Il re ti è sfuggito! La partita è finita. \nQualora tu abbia totalizzato un minimo di 10 punti, puoi ritirare la tua vincita.
MINI_GAME_CATCHKING_POPUP_REWARD_FAIL	Non puoi ritirare alcuna vincita.
MINI_GAME_CATCHKING_SEARCH_NUMBER5	C'è un [5] nelle vicinanze.
MINI_GAME_CATCHKING_START_QUESTION	In questo turno, ti verranno detratti Yang (%d) e %s (%d unità).\nVuoi giocare adesso?
MINI_GAME_CATCHKING_TOOLTIP_CARD1	Può acchiappare la seguente carta: [1]
MINI_GAME_CATCHKING_TOOLTIP_CARD2	Può acchiappare le seguenti carte: [1], [2]
MINI_GAME_CATCHKING_TOOLTIP_CARD3	Può acchiappare le seguenti carte: [1], [2], [3]
MINI_GAME_CATCHKING_TOOLTIP_CARD4	Può acchiappare le seguenti carte: [1], [2], [3], [4]
MINI_GAME_CATCHKING_TOOLTIP_CARD5	Può acchiappare le, seguenti carte: [1], [2], [3], [4], [5]\nSe un altro [5] dovesse trovarsi accanto alla tua carta scoperta,\nil turno si concluderà e non riceverai punti.
MINI_GAME_CATCHKING_TOOLTIP_CARD6	Può acchiappare la seguente carta: [K]
MINI_GAME_CATCHKING_TOOLTIP_SCORE1	%s: minimo 550
MINI_GAME_CATCHKING_TOOLTIP_SCORE2	%s: 400 ~ 549
MINI_GAME_CATCHKING_TOOLTIP_SCORE3	%s: 10 ~ 399
MINI_GAME_CATCHKING_TOOLTIP_SCORE4	Ricevi 10 punti extra se riesci a scoprire tutte le carte di una fila.
MINI_GAME_GIVEUP_QUESTION	Vuoi davvero interrompere la partita? In questo caso, dovrai rinunciare alla tua ricompensa.
MINI_GAME_NOTICE_1	Clicca su "Lancia" per decidere chi sarà a iniziare.
MINI_GAME_NOTICE_10	Ah! Hai cacciato via il computer dalla sua casella.
MINI_GAME_NOTICE_11	Che sfortuna! Il computer ti ha cacciato via dalla tua casella.
MINI_GAME_NOTICE_12	Avevi Yut oppure Mo e quindi puoi lanciare di nuovo.
MINI_GAME_NOTICE_13	La partita è finita. Ritira la tua ricompensa.
MINI_GAME_NOTICE_2	Lancia i bastoncini Yut.
MINI_GAME_NOTICE_3	Il computer lancia i bastoncini Yut per determinare chi inizia.
MINI_GAME_NOTICE_4	Il computer ha effettuato un lancio di punteggio identico o inferiore e pertanto può iniziare.
MINI_GAME_NOTICE_5	Hai fatto il lancio più basso: sarai tu a iniziare.
MINI_GAME_NOTICE_6	Il tuo lancio: %s. Muoviti in avanti di %d casella/e.
MINI_GAME_NOTICE_7	Il tuo lancio: %s. Devi tornare indietro di 1 casella.
MINI_GAME_NOTICE_8	Lancio: %s
MINI_GAME_NOTICE_9	Ora tocca al computer.
MINI_GAME_RUMI_DISCARD_QUESTION	Vuoi veramente gettar via questa carta?
MINI_GAME_RUMI_EXIT_QUESTION	Vuoi terminare la manche e acquisire la tua vincita?\nI tuoi punti e le carte rimanenti verranno resettati.
MINI_GAME_RUMI_START_QUESTION	Per poter giocare, devi pagare %d Yang. Inoltre, avrai bisogno di %d set di carte.\nVuoi iniziare a giocare?
MINI_GAME_YUTNORI_COM_WIN	A volte si perde e a volte vincono gli avversari.
MINI_GAME_YUTNORI_PC_WIN	Ecco come sono i vincitori, schalalalala!
MINI_GAME_YUTNORI_PC_WIN_SCORE	Punteggio: %d
MINI_GAME_YUTNORI_RETHROW_BUTTON	Lancia
MINI_GAME_YUTNORI_RETHROW_POPUP	La fortuna ti sorride! Tocca di nuovo a te.
MINI_GAME_YUTNORI_SCORE_FONT	Tahoma:24b
MINI_GAME_YUTNORI_START_QUESTION	Per iniziare a giocare a Yutnori, ti servono %d Yang e %d un tavoliere da Yutnori. \n Vuoi giocare adesso?
MINUTE	m
MISTS_ISLAND_BUFF_MSG_01	Energia +2
MISTS_ISLAND_BUFF_MSG_02	Tasso di drop item +10%
MISTS_ISLAND_BUFF_MSG_03	Forza, intelligenza, vitalità, destrezza +3
MISTS_ISLAND_BUFF_MSG_04	Drop di Yang +10%
MISTS_ISLAND_BUFF_MSG_05	Incrementa del 3% i bonus costume
MISTS_ISLAND_INFO_01	Il tuo livello è troppo basso.
MISTS_ISLAND_INFO_02	Non hai abbastanza Yang.
MISTS_ISLAND_INFO_03	Al momento non ci sono battaglie in corso.
MISTS_ISLAND_MSG_01	%s è stato distrutto da %s.
MISTS_ISLAND_MSG_02	%s ha conquistato %s!
MISTS_ISLAND_MSG_03	%s ha occupato %s.
MISTS_ISLAND_MSG_04	%s attacca %s!
MISTS_ISLAND_MSG_05	%s ha eseguito il rafforzamento correttamente. %s è ora al livello %d.
MISTS_ISLAND_MSG_06	%s è comparso sul campo di battaglia.
MISTS_ISLAND_QUESTION_01	Vuoi abbandonare la Battaglia dei 5 Santuari?
MISTS_ISLAND_QUESTION_02	Vuoi teletrasportarti al santuario che ha subito l'attacco? \n Costo: %s Yang
MISTS_ISLAND_TOOLTIP_01	[%s]
MISTS_ISLAND_TOOLTIP_02	Regno occupatore: %s
MISTS_ISLAND_TOOLTIP_03	Livello miglioramento: +%d
MISTS_ISLAND_TOOLTIP_04	Buff occupazione: %s
MISTS_ISLAND_TOOLTIP_05	Conquista dei santuari
MISTS_ISLAND_TOOLTIP_06	1) Un santuario, per essere acquisito, deve essere prima distrutto.
MISTS_ISLAND_TOOLTIP_07	2) Il regno, che dopo 1 minuto riesce a far avvicinare il più possibile i suoi guerrieri al santuario, conquista il santuario.
MISTS_ISLAND_TOOLTIP_08	3) Dopo 3 minuti il santuario occupato acquisisce il colore del regno che l'ha conquistato.
MISTS_ISLAND_TOOLTIP_09	4) Più un santuario rimane sotto il controllo dello stesso regno e più diventa difficile espugnarlo.
MONETARY_UNIT0	Yang
MONETARY_UNIT1	diecimila
MONETARY_UNIT2	cento milioni
MONEY_INPUT_DIALOG_SELLPRICE	Prezzo di vendita:
MOVE_CHANNEL_99	CH0
MOVE_CHANNEL_CANCEL	Interrompi
MOVE_CHANNEL_NOTICE	Sei collegato al canale %d.
MOVE_CHANNEL_NOT_MOVE	Non puoi cambiare canale.
MOVE_CHANNEL_SELECT	Ok
MOVE_CHANNEL_TITLE	Scelta del canale
MOVE_ITEM_FAILURE_PRIVATE_SHOP	Non puoi spostare degli oggetti se hai un negozio privato aperto.
MUSIC_EMPTY_MUSIC_LIST	Nessuna musica di sottofondo.
MUSIC_METIN2_DEFAULT_THEMA	Musica standard di Metin2
MUSIC_NOT_SELECT_MUSIC	Non è stato scelto nessun file musicale.
NEEFD_REST	Devi prima riposarti.
NOT_YET_SUPPORT	Non è supportato.
OPEN_THE_SPECIAL_ACTION_KIT	%s fa ora parte delle emozioni.
OPTION_PVPMODE_CANNOT_SET_GUILD_MODE	Non puoi attivare la modalità Gilda se non appartieni ad una Gilda.
OPTION_PVPMODE_NOT_SUPPORT	Non puoi usare la configuarazione PvP.
OPTION_PVPMODE_PROTECT	Devi aver raggiunto il livello %d per modificare la modalità PvP.
PARTY_ANSWER_TIMEOVER	L'invito è stato rifiutato.
PARTY_BONUS_ATTACKER	Valore d'attacco: +%d	SA
PARTY_BONUS_BERSERKER	Velocità d'attacco: +%d	SA
PARTY_BONUS_BUFFER	Durata dell'abilità: +%d	SA
PARTY_BONUS_DEFENDER	Difesa: +%d	SA
PARTY_BONUS_EXP	Bonus EXP: %d%%	SA
PARTY_BONUS_SKILL_MASTER	Max. MP: +%d	SA
PARTY_BONUS_TANKER	Max. HP: +%d	SA
PARTY_BREAK_UP	Sciogli gruppo
PARTY_DO_YOU_ACCEPT	  desidera entrare nel gruppo.
PARTY_DO_YOU_JOIN	 ti ha invitato a unirti al suo gruppo. Accetti?
PARTY_EXP_DISTRIBUTION_MODE	Divisione per EXP
PARTY_EXP_DISTRIBUTION_MODE_LEVEL	In base al livello
PARTY_EXP_DISTRIBUTION_MODE_LEVEL_TOOLTIP	I membri di livello più alto ricevono più EXP.
PARTY_EXP_DISTRIBUTION_MODE_PARITY	Equilibrato
PARTY_EXP_DISTRIBUTION_MODE_PARITY_TOOLTIP	Tutti i membri del gruppo ricevono la stessa quantità di EXP.
PARTY_HEAL_ALL_MEMBER	Rigenerare tutto
PARTY_INCREASE_AREA_150	Raggio d'azione del gruppo alzato di fattore 1,5.	SNA
PARTY_INCREASE_AREA_200	Raggio d'azione del gruppo alzato di fattore 2.	SNA
PARTY_LEAVE	Abbandona il gruppo.
PARTY_LONGTIME_BONUS_EXP	EXP bonus per un gioco di gruppo lungo: +%d%%	SA
PARTY_MATCH_CANCEL	La Ricerca gruppi per [%s] è stata annullata.
PARTY_MATCH_FAIL_FULL_MEMBER	Il tuo gruppo non può accettare altri membri.
PARTY_MATCH_FAIL_IMPOSSIBLE_MAP	Non puoi registrarti per questo Dungeon.
PARTY_MATCH_FAIL_LEVEL	Il tuo livello è troppo basso.
PARTY_MATCH_FAIL_MEMBER_NOT_CONDITION	%s, uno dei membri del gruppo, non soddisfa i requisiti necessari.
PARTY_MATCH_FAIL_NONE_MAP_INDEX	Scegli innanzitutto un Dungeon.
PARTY_MATCH_FAIL_NOT_LEADER	Solo il capogruppo può effettuare la registrazione.
PARTY_MATCH_FAIL_NO_ITEM	Non hai abbastanza %s.
PARTY_MATCH_SEARCHING	Cerca
PARTY_MATCH_START	Hai registrato il tuo gruppo per il seguente Dungeon: [%s]!
PARTY_MEMBER_OFFLINE	[Offline]
PARTY_RECALL_MEMBER	Chiamare a sè un membro del gruppo.
PARTY_REGEN_BONUS	Bonus per HP + Rigenerazione MP: +%d%%	SA
PARTY_REQUEST_DENIED	La tua richiesta è stata rifiutata.
PARTY_RK_CATEGORY_CZ_CHICKEN	Classifica del Guardiano Yu
PARTY_RK_CATEGORY_CZ_COW	Classifica del Guardiano Chou
PARTY_RK_CATEGORY_CZ_DOG	Classifica del Guardiano Xu
PARTY_RK_CATEGORY_CZ_DRAGON	Classifica del Guardiano Chen
PARTY_RK_CATEGORY_CZ_HORSE	Classifica del Guardiano Wu
PARTY_RK_CATEGORY_CZ_MONKEY	Classifica del Guardiano Shen
PARTY_RK_CATEGORY_CZ_MOUSE	Classifica del Guardiano Zi
PARTY_RK_CATEGORY_CZ_PIG	Classifica del Guardiano Hai
PARTY_RK_CATEGORY_CZ_RABBIT	Classifica della Guardiana Mao
PARTY_RK_CATEGORY_CZ_SHEEP	Classifica del Guardiano Wei
PARTY_RK_CATEGORY_CZ_SNAKE	Classifica della Guardiana Si
PARTY_RK_CATEGORY_CZ_TIGER	Classifica del Guardiano Yin
PARTY_SET_ATTACKER	Annotare come aggressore.
PARTY_SET_BERSERKER	Annotare come feroce.
PARTY_SET_BUFFER	Annotare come bloccatore.
PARTY_SET_DEFENDER	Annotare come difensore.
PARTY_SET_NORMAL	Annullare le impostazioni.
PARTY_SET_SKILL_MASTER	Annotare come maestro delle abilità.
PARTY_SET_TANKER	Annotare come lottatore corpo a corpo.
PARTY_SKILL_ATTACKER	Valore d'attacco base aggressore  +%.0f
PARTY_SKILL_BERSERKER	Velocità d'attacco feroce +%.0f
PARTY_SKILL_BUFFER	Durata dell'abilità bloccatore +%.0f
PARTY_SKILL_DEFENDER	Difesa difensore +%.0f
PARTY_SKILL_HP_REGEN	Rigenerazione HP +%.0f%%
PARTY_SKILL_PARTY_AREA	Raggio d'azione del gruppo +%d%%
PARTY_SKILL_SKILL_MASTER	Max. MP maestro delle abilità +%.0f
PARTY_SKILL_SP_REGEN	Rigenerazione MP +%.0f%%
PARTY_SKILL_TANKER	Max. HP lottatore corpo a corpo +%.0f
PARTY_SKILL_WARP	Capacità di chiamare a sè i membri del gruppo.
PASSWORD_TITLE	Password Magazzino
PET_ATTR_CHANGE_DIALOG_TEXT	Vuoi modificare gli attributi del tuo pet?\n Quest'azione consuma l'item Incanta pet.\n Il processo potrebbe non andare a buon fine.
PET_ATTR_CHANGE_USE	Non è possibile eseguire quest'azione durante la modifica degli attributi del pet.
PET_ATTR_DETERMINE_TYPE1	Tipologia 1: goffo. Non è particolarmente forte.\nCon il tempo puoi migliorarne le abilità.
PET_ATTR_DETERMINE_TYPE2	Tipologia 2: curioso. Non è particolarmente forte.\nÈ un compagno fedele che con il tempo migliora le proprie abilità.
PET_ATTR_DETERMINE_TYPE3	Tipologia 3: intrepido. È moderatamente forte.\nCon il tempo puoi migliorarne le abilità.
PET_ATTR_DETERMINE_TYPE4	Tipologia 4: coraggioso. È moderatamente forte.\nÈ un compagno fedele che con il tempo migliora le proprie abilità.
PET_ATTR_DETERMINE_TYPE5	Tipologia 5: temerario. È forte.\nCon il tempo puoi migliorarne ulteriormente le abilità.
PET_ATTR_DETERMINE_TYPE6	Tipologia 6: leggendario. È forte.\nÈ un compagno fedele che con il tempo migliora ulteriormente le proprie abilità.
PET_ATTR_DETERMINE_TYPE7	Tipologia 7: mitico. È molto forte.\nCon il tempo, sprigionerà tutto il suo potenziale.
PET_ATTR_DETERMINE_TYPE8	Tipologia 8: prismatico. È estremamente forte.\nÈ un compagno fedele del quale ci si può fidare a occhi chiusi.
PET_BAG_DESC	%s
PET_CANNOT_FEED_CUBEOPEN	Non puoi nutrire il tuo pet, se la finestra del raffinamento è aperta.
PET_CAN_NOT_ATTRCHANGE_BECUASE_LIFE_TIME_END	Non puoi modificare gli attributi di un pet morto.
PET_CAN_NOT_EGG_ITEM_USE	Non puoi aprire l'Incubatrice mentre stai commerciando, oppure mentre il tuo magazzino o il negozio privato sono aperti.
PET_CAN_NOT_FEED_SPLIT_ITEM	Non puoi inserire un oggetto diviso in questa finestra.
PET_CAN_NOT_FEED_TYPE	In questo modo non potrai dar da mangiare al tuo pet. Prova con un'altra azione.
PET_CAN_NOT_OPEN_EVOL_BUTTON	Al fine di addestrare il tuo pet per portarlo al prossimo livello di evoluzione, è necessario che esso abbia raggiunto il livello %d.
PET_CAN_NOT_OPEN_EVOL_BUTTON_EXP_LACK	Al fine di addestrare il tuo pet per portarlo al prossimo livello di evoluzione, è necessario che esso abbia raggiunto il 100% di esperienza.
PET_CAN_NOT_OPEN_EVOL_BUTTON_LEVEL_MAX	Il tuo pet ha già raggiunto il massimo livello di evoluzione.
PET_CAN_NOT_OPEN_SHOP_BECAUSE_SUMMON	Non puoi aprire un negozio privato se hai già chiamato il tuo pet.
PET_CAN_NOT_OPEN_SPECIAL_EVOL_BUTTON	Al fine di addestrare il tuo pet per portarlo al prossimo livello di evoluzione, è necessario che esso abbia raggiunto %d giorni di età.
PET_CAN_NOT_SUMMON_BECAUSE_LIFE_TIME_END	Non puoi chiamare il pet perché il tempo è scaduto.
PET_CAN_NOT_USE_BAG	Non puoi usare il Trasportino se il periodo di utilizzo del pet è scaduto.
PET_EMPTY_SKILL_SLOT_USE_ITEM	Questo pet non ha delle abilità che si possano resettare.
PET_HATCHING_ACCEPT	Vuoi chiamare il tuo pet "%s"?
PET_HATCHING_MONEY	Prezzo: %s
PET_HATCHING_WINDOW_OPEN_CAN_NOT_USE	Non puoi eseguire nessuna interazione mentre l'Incubatrice è aperta.
PET_INFORMATION_STAGE1	Cucciolo
PET_INFORMATION_STAGE2	Selvatico
PET_INFORMATION_STAGE3	Coraggioso
PET_INFORMATION_STAGE4	Eroico
PET_INFO_EXP	Esperienza attuale:
PET_INFO_ITEM_EXP	Attuali item EXP
PET_INFO_NEXT_EXP	Esperienza rimanente:
PET_INFO_NEXT_ITEM_EXP	Item EXP rimanenti
PET_MSG_NOT_ENOUGH_MONEY	Non hai abbastanza Yang.
PET_NAME_CHANGE_ACCEPT	Vuoi modificare il nome del tuo pet in "%s"?
PET_NAME_MIN	Il nome inserito è troppo corto.
PET_REVIVE_FAIL_EMPTY_PET_SLOT	Non hai un pet da resuscitare.
PET_REVIVE_FAIL_NOT_ENOUGHT_MATERIAL	Non hai abbastanza materiale.
PET_REVIVE_UI_MATERIAL_COUNT	%d/%d
PET_SKILL_DELETE_QUESTION_DLG_MSG	Ora le abilità sono disponibili.
PET_SKILL_DELETE_QUESTION_DLG_MSG1	Il reset della/delle abilità del tuo pet è irreversibile.
PET_SKILL_DELETE_QUESTION_DLG_MSG2	Vuoi continuare?
PET_SKILL_LEARN_FAIL_CONDITIONS	Il tuo pet è troppo giovane o non possiede il livello richiesto. Solo i pet eroi possono apprendere le abilità.
PET_SKILL_LEARN_QUESTION_DLG_MSG	Vuoi avviare l'addestramento eroico con "%s".
PET_SKILL_TOOLTIP_COOLTIME	Tempo di ricarica: %d secondi
PET_SKILL_TOOLTIP_DURATION	Durata: %d secondi
PET_SKILL_TOOLTIP_FEATHER	Il pet potrebbe attivare Passo piumato (%d%% di probabilità) per %.1f secondi.\n Attacco %d - %d	SAAAA
PET_SKILL_TOOLTIP_HEAL	Se i tuoi HP scendono al di sotto del 20%%, ottieni un\n %d%% di possibilità che i tuoi HP aumentino di un %d.	SAA
PET_SKILL_TOOLTIP_INVINVIBILITY	Il tuo personaggio ha una possibilità di un %d%% di diventare invincibile\n quando i suoi HP scendono al di sotto di un 10%%.\n Durata dell'effetto: %.1f secondi.	SAA
PET_SKILL_TOOLTIP_REMOVAL	Rimuove immediatamente tutti gli effetti di avvelenamento, di rallentamento o\n di sanguinamento con una probabilità di un %d%%\n ogni volta che il tuo personaggio viene colpito.	SAN
PET_SKILL_UPGRADE_QUESTION_DLG_MSG1	Vuoi portare l'addestramento eroico al prossimo livello?
PET_SKILL_UPGRADE_QUESTION_DLG_MSG2	Costi: %s
PET_TOOLTIP_COSTUME_BONUS	
PET_TOOLTIP_DEF	Difesa
PET_TOOLTIP_HP	HP
PET_TOOLTIP_LEVEL	Livello
PET_TOOLTIP_LIFETIME_OVER	Scaduto
PET_TOOLTIP_SKILL_BONUS_VALUE	in fase di addestramento eroico
PET_TOOLTIP_SKILL_CUR_LEVEL	Livello: %d
PET_TOOLTIP_SKILL_NEXT_LEVEL	Prossimo livello: %d (max. %d)
PET_TOOLTIP_SP	MP
PET_TOOLTIP_TRADABLE	Commerciabile
PET_TOOLTUP_SKILL	%s (livello %d)
PICK_ITEM_TITLE	Numero dell'oggetto
PICK_MONEY_TITLE	Prezzo
PRIVATESHOPSEARCH_ABLITY_POTION	Rugiada
PRIVATESHOPSEARCH_ACCESSORY_SOCKET	Stoffa sottile
PRIVATESHOPSEARCH_ARMOR	Equipaggiamento
PRIVATESHOPSEARCH_ARROW	Frecce
PRIVATESHOPSEARCH_BELL	Campane
PRIVATESHOPSEARCH_BELT	Cintura
PRIVATESHOPSEARCH_BLEND	Pozioni
PRIVATESHOPSEARCH_BLOOD_PEARL	Perla rossa
PRIVATESHOPSEARCH_BLUE_PEARL	Perla blu
PRIVATESHOPSEARCH_BODY	Equipaggiamenti
PRIVATESHOPSEARCH_BOW	Archi
PRIVATESHOPSEARCH_BUYTIME	Vuoi acquistare l'oggetto selezionato?
PRIVATESHOPSEARCH_CLAW	Artigli
PRIVATESHOPSEARCH_CLEAR_POTION	Elisir
PRIVATESHOPSEARCH_COSTUME	Costumi
PRIVATESHOPSEARCH_COSTUMEBODY	Costume
PRIVATESHOPSEARCH_COSTUMEHAIR	Pettinatura
PRIVATESHOPSEARCH_COSTUME_ACCE	Stole
PRIVATESHOPSEARCH_COSTUME_MOUNT	Cavalcatura
PRIVATESHOPSEARCH_CRYSTAL	Cristallo
PRIVATESHOPSEARCH_DAGGER	Pugnali
PRIVATESHOPSEARCH_DEAD	senza vita
PRIVATESHOPSEARCH_DETACHMENT	Libro delle pietre
PRIVATESHOPSEARCH_DIAMOND	Diamante
PRIVATESHOPSEARCH_DS	Alchimia delle Pietre del drago
PRIVATESHOPSEARCH_DS_BLACK	Onice
PRIVATESHOPSEARCH_DS_BLUE	Zaffiro
PRIVATESHOPSEARCH_DS_GREEN	Giada
PRIVATESHOPSEARCH_DS_RED	Rubino
PRIVATESHOPSEARCH_DS_WHITE	Diamante
PRIVATESHOPSEARCH_DS_YELLOW	Granato
PRIVATESHOPSEARCH_EAR	Orecchini
PRIVATESHOPSEARCH_FAN	Ventagli
PRIVATESHOPSEARCH_FISH	Pesci
PRIVATESHOPSEARCH_FOOTS	Scarpe
PRIVATESHOPSEARCH_GEM	Pietre preziose
PRIVATESHOPSEARCH_GIFTBOX	Pacchi regalo
PRIVATESHOPSEARCH_HEAD	Elmi
PRIVATESHOPSEARCH_LIVE	in vita
PRIVATESHOPSEARCH_MATERIAL	Materiali
PRIVATESHOPSEARCH_METIN	Pietre spirituali
PRIVATESHOPSEARCH_NECK	Collane
PRIVATESHOPSEARCH_NEED_ITEM_BUY	Se non hai il fagotto giusto, non puoi comprare nessun oggetto.
PRIVATESHOPSEARCH_NEED_ITEM_FIND	Se non hai il fagotto giusto, non puoi cercare nessun oggetto.
PRIVATESHOPSEARCH_NODELAY_POTION	Oggetti HP
PRIVATESHOPSEARCH_ORE	Minerale
PRIVATESHOPSEARCH_PET	Sistema dei pet
PRIVATESHOPSEARCH_PETAGG	Uova del pet
PRIVATESHOPSEARCH_PETSKILLBOOK	Libri delle abilità del pet
PRIVATESHOPSEARCH_PICK	Picconi
PRIVATESHOPSEARCH_POTION	Pozioni
PRIVATESHOPSEARCH_QUEST	Missione
PRIVATESHOPSEARCH_QUIVER	Faretre per frecce
PRIVATESHOPSEARCH_RESOURCE	Miglioramento oggetti
PRIVATESHOPSEARCH_ROD	Pesca
PRIVATESHOPSEARCH_SELECTITEM	Oggetto selezionato
PRIVATESHOPSEARCH_SHIELD	Scudi
PRIVATESHOPSEARCH_SKILLBOOK	Libri delle abilità
PRIVATESHOPSEARCH_SKILLFORGET	Libro dell'amnesia
PRIVATESHOPSEARCH_SPECIAL	Varie
PRIVATESHOPSEARCH_STONE	Scaglia di energia
PRIVATESHOPSEARCH_SWORD	Spada a una mano
PRIVATESHOPSEARCH_TREASUREBOX	Bauli
PRIVATESHOPSEARCH_TUNING	Papiri
PRIVATESHOPSEARCH_TWOSWORD	Spada a due mani
PRIVATESHOPSEARCH_UNIQUE	Unico
PRIVATESHOPSEARCH_USEITEM	Beni di consumo
PRIVATESHOPSEARCH_USESPECIAL	Varie
PRIVATESHOPSEARCH_WEAPON	Armi
PRIVATESHOPSEARCH_WHITE_PEARL	Perla bianca
PRIVATESHOPSEARCH_WRIST	Bracciali
PRIVATE_SHOP_CANNOT_SELL_ITEM	Non puoi vendere questo oggetto in un neegozio privato.
PRIVATE_SHOP_CLOSE_QUESTION	Desideri chiudere il negozio privato?
PRIVATE_SHOP_INPUT_NAME_DIALOG_TITLE	Nome del negozio privato
PRIVATE_SHOP_INPUT_PRICE_DIALOG_TITLE	Prezzo
PVP_LEVEL0	Cavaliere
PVP_LEVEL1	Nobile
PVP_LEVEL2	Buono
PVP_LEVEL3	Gentile
PVP_LEVEL4	Neutrale
PVP_LEVEL5	Aggressivo
PVP_LEVEL6	Perfido
PVP_LEVEL7	Maligno
PVP_LEVEL8	Crudele
PVP_MODE_GUILD	La Gilda PvP è stata attivata.
PVP_MODE_KILL	PvP - Libero attivato.
PVP_MODE_NORMAL	PvP - Pace attivato.
PVP_MODE_PROTECT	PvP - Protezione attivato.
PVP_MODE_REVENGE	PvP - Nemico attivato.
PVP_OPTION_KILL	Libero
PVP_OPTION_NORMAL	Pace
PVP_OPTION_PROTECT	Protezione
PVP_OPTION_REVENGE	Nemico
PVP_TOURNAMENT_DO_NOT_AUTO	Non puoi usare l'attacco automatico durante il torneo PvP.
QUEST_APPEND	È stata formulata una nuova missione.
QUEST_HOUR	Ora/e
QUEST_MIN	Min.
QUEST_SEC	Sec.
QUEST_TIMEOVER	Tempo scaduto
QUEST_UNLIMITED_TIME	Non c'è limite di tempo
QUEST_ZEROSEC	0 Sec.
QUICKSLOT_REGISTER_DISABLE_ITEM	Questo oggetto non può essere inserito nei campi di utilizzo rapido.
RANKING	Rango
RANKING_BOARD_MEMBER	Membri
RECEIVE_MESSAGE	%s ti ha mandato un messaggio.
REFINE_COST	Costo del miglioramento: %d Yang
REFINE_DESTROY_WARNING	L'oggetto potrebbe essere distrutto durante il miglioramento.
REFINE_DESTROY_WARNING_WITH_BONUS_PERCENT_1	Vuoi veramente effettuare l'upgrade dell'oggetto?
REFINE_DESTROY_WARNING_WITH_BONUS_PERCENT_2	In caso di fallimento l'oggetto sarà distrutto. Desideri continuare?
REFINE_DOWN_GRADE_WARNING	L'oggetto durante il miglioramento potrebbe peggiorare.
REFINE_DO_YOU_SEPARATE_METIN	Desideri rimuovere tutte le Pietre Spirituali?
REFINE_ELEMENT_CHANGE_TEXT	Ora %s possiede l'elemento %s!
REFINE_ELEMENT_DOWNGRADE_TEXT	Il livello dell'incantesimo elementale è stato ridotto.
REFINE_ELEMENT_EXIST	L'oggetto possiede già un altro elemento.
REFINE_ELEMENT_GRADE_MAX	Il livello massimo dell'incantesimo elementale è già stato raggiunto.
REFINE_ELEMENT_NOT_ENOUGHT_GRADE	L'incantesimo elementale è disponibile solo per le armi di livello +7 o superiore.
REFINE_ELEMENT_NOT_ENOUGHT_YANG	Non hai abbastanza Yang.
REFINE_ELEMENT_NOT_EXSIT	Non si può utilizzare con questo oggetto.
REFINE_ELEMENT_TEXT_DARK	Oscurità +%d
REFINE_ELEMENT_TEXT_EARTH	Terra + %d
REFINE_ELEMENT_TEXT_ELECT	Lampo +%d
REFINE_ELEMENT_TEXT_FIRE	Fuoco +%d
REFINE_ELEMENT_TEXT_ICE	Ghiaccio +%d
REFINE_ELEMENT_TEXT_WIND	Vento +%d
REFINE_ELEMENT_UPGRADE_FAIL_TEXT	L'incantesimo elementale è fallito.
REFINE_ELEMENT_UPGRADE_SUCCESS_TEXT	L'incantesimo elementale è riuscito.
REFINE_FAILURE	Non è andata... Non ce l'abbiamo fatta.
REFINE_FAILURE_CAN_NOT_ATTACH	%s questo oggetto non può essere inserito.
REFINE_FAILURE_DEL_ITEM	Il raffinamento non ha avuto successo. L'oggetto è stato distrutto.
REFINE_FAILURE_EQUIP_ITEM	Non puoi migliorare gli oggetti in uso.
REFINE_FAILURE_GRADE_DOWN	Il raffinamento non ha avuto successo. Il grado dell'oggetto è stato ridotto.
REFINE_FAILURE_KEEP_GRADE	Il raffinamento non ha avuto successo. Fortunatamente, l'oggetto è stato preservato.
REFINE_FAILURE_METIN_INSEPARABLE_ITEM	Nessuna Pietra Spirituale può essere tolta.
REFINE_FAILURE_NEED_BETTER_SCROLL	Ti serve un migliore papiro del miglioramento .
REFINE_FAILURE_NO_GOLD_SOCKET	Non hai nessuna montatura d'oro per inserire %s.
REFINE_FAILURE_NO_MORE_SOCKET	Non puoi creare altre montature.
REFINE_FAILURE_NO_SOCKET0	Non hai nessuna montatura per inserire %s.
REFINE_FAILURE_SOCKET_DISABLE_ITEM	Su questo oggetto non può essere creata una montatura.
REFINE_FAILURE_UPGRADE_DISABLE_ITEM	Questo oggetto non può essere migliorato.
REFINE_SUCCESS	Il miglioramento è riuscito con successo.
REFINE_SUCCESS_PROBALITY	Probabilità di miglioramento: %d%%
REFINE_WARNING2	Desideri continuare?
RESTART_POPUP_GIVEUP_MIST_ISLAND	Hai perso nella Battaglia dei 5 Santuari. Ripartirai dal villaggio.
REVIVE_QUESTION	Vuoi rianimare %s? Quantità Prisma del risveglio: %d unità
REVIVE_SELF_QUESTION	Vuoi eseguire una rianimazione? Quantità Prisma del risveglio: %d unità
ROULETTE_REWARD_TEXT	Oggetto ricevuto
SAFEBOX_ERROR	Hai inserito la password sbagliata.
SAFEBOX_NEED_CHANGE_PASSWORD	La tua password è scaduta.\nImpostane una nuova.
SAFEBOX_SELL_DISABLE_SAFEITEM	Non puoi vendere gli oggetti salvati.
SAFEBOX_UNAVILABLE_PASSWORD_01	Non puoi usare questa password.
SAFEBOX_UNAVILABLE_PASSWORD_02	La password deve contenere almeno %d caratteri.
SAFEBOX_UNAVILABLE_PASSWORD_03	Hai inserito la tua password attuale. Scegli una nuova password.
SAFEBOX_UNAVILABLE_PASSWORD_04	La tua password non può contenere %d cifre uguali o posizionate di seguito l'una all'altra.
SAFEBOX_UNAVILABLE_PASSWORD_05	Non sono ammessi caratteri speciali. Caratteri ammessi: a-z, A-Z, 0-9
SAFEBOX_WRONG_PASSWORD	Le password devono essere identiche.
SCREENSHOT_SAVE1	È salvato in
SCREENSHOT_SAVE2	Cartella degli Screenshot
SCREENSHOT_SAVE_FAILURE	Salvataggio dello screenshot fallito.
SECOND	Sec
SECOND_CONFIRM_PET_FEED_QUESTION_1	L'oggetto possiede %d o più bonus.
SECOND_CONFIRM_PET_FEED_QUESTION_2	Vuoi davvero darlo in pasto al tuo pet?
SECOND_CONFIRM_SELL_ITEM_QUESTION_1	L'oggetto possiede %d o più bonus.
SECOND_CONFIRM_SELL_ITEM_QUESTION_2	Vuoi davvero venderlo?
SELECT_ATTR_NOTICE	Non puoi aprire un negozio privato mentre l'item Incanta oggetto+ è in uso.
SELECT_ATTR_NOT_OPEN	Non puoi utilizzare l'item Incanta oggetto+ mentre hai un negozio privato aperto.
SELECT_ATTR_NOT_SELECT	Scegli se mantenere i bonus o scambiarli.
SELECT_CAN_NOT_DELETE	Non puoi cancellare il personaggio.
SELECT_CAN_NOT_DELETE_ATTR67	Non si può eliminare un personaggio\n mentre si sta aggiungendo un bonus.
SELECT_CAN_NOT_DELETE_GUILD_MEMBER	Non puoi eliminare il tuo personaggio finché fa parte di una gilda.
SELECT_CAN_NOT_DELETE_HAVE_SEALED_ITEM	Non puoi eliminare il tuo personaggio finché possiede item legati all'anima.
SELECT_CAN_NOT_DELETE_LAST_CHAR_SAFEBOX	Non puoi eliminare il tuo unico personaggio finché hai ancora item nel tuo magazzino.
SELECT_CAN_NOT_DELETE_LIMITE_LEVEL	Puoi eliminare il tuo personaggio solo fino al livello 69.
SELECT_CAN_NOT_DELETE_MARRIAGE	Non puoi eliminare un personaggio sposato.
SELECT_CAN_NOT_DELETE_PRIVATE_CODE_ERROR	Il codice per l'eliminazione non era corretto.
SELECT_CAN_NOT_DELETE_REMAIN_TIME	Non puoi eliminare questo personaggio subito dopo averlo creato. Periodo d'attesa: %s
SELECT_CHANGED_NAME	Hai modificato il nome del personaggio.
SELECT_CHANGE_FAILURE_ALREADY_EXIST_NAME	Il nome del personaggio esiste già.
SELECT_CHANGE_FAILURE_STRANGE_INDEX	Riprovaci.
SELECT_CHANGE_FAILURE_STRANGE_NAME	Questo nome del personaggio è errato
SELECT_CHANGE_NAME_TITLE	Modifica il nome del personaggio
SELECT_DELEING	Il personaggio sta per essere cancellato.
SELECT_DELETED	Cancellato con successo
SELECT_DO_YOU_DELETE_REALLY	Desideri continuare?
SELECT_EMPTY_SLOT	Questo è un campo vuoto
SELECT_GM_NAME	GM
SELECT_INPUT_CHANGING_NAME	Inserisci un nuovo nome del personaggio.
SELECT_NOT_JOIN_GUILD	Nessuna Gilda
SERVER_NOTIFY_CLOSED	Server chiuso: vi possono accedere solo account con status VIP o account creati prima della chiusura.
SERVER_STATUS_CLOSE	CHIUSO
SERVER_STATUS_NEW	NOVITÀ
SERVER_STATUS_SPECIAL	SPECIALE
SHOP_BUY_INFO	Scegli dalla vetrina l'oggetto che vorresti acquistare.
SHOP_CANNOT_SELL_EQUIPMENT	Non puoi vendere degli oggetti in uso.
SHOP_CANNOT_SELL_ITEM	Questto oggetto non è in vendita
SHOP_ERROR_UNKNOWN	Errore di caricamento sconosciuto: %s
SHOP_EXCEED_LIMIT_TODAY	Hai già superato il limite giornaliero per l'utilizzo dei punti.
SHOP_INVALID_POS	Questo oggetto non è adatto.
SHOP_INVENTORY_FULL	Nel magazzino non c'è più posto.
SHOP_LIMITED_DATA_LOADING	I dati verranno caricati a breve. Riprova più tardi.
SHOP_LIMITED_ITEM_REMAIN_COUNT	Oggetti rimanenti: %d
SHOP_LIMITED_PURCHASE_OVER	Esaurito
SHOP_LIMIT_TODAY	Limite giornaliero: %d / %d
SHOP_MY_BATTLE_POINT	Punti battaglia: %d
SHOP_MY_MEDAL_OF_HONOR	Medaglia del coraggio: %d
SHOP_NOT_ENOUGH_10TH_COIN	Non hai abbastanza Monete dell'anniversario.
SHOP_NOT_ENOUGH_BATTLE_POINT	Non hai abbastanza punti battaglia.
SHOP_NOT_ENOUGH_BNW	Non hai abbastanza Monete Veggenza.
SHOP_NOT_ENOUGH_GUILD_LEVEL	Il livello della gilda è troppo basso.
SHOP_NOT_ENOUGH_MEDAL_OF_HONOR	Non hai abbastanza Medaglie del coraggio.
SHOP_NOT_ENOUGH_MONEY	Non hai abbastanza Won o Yang
SHOP_NOT_ENOUGH_MONEY_EX	Non hai Yang a sufficienza.
SHOP_SELL_INFO	Scegli dal tuo inventario l'oggetto che vuoi vendere.
SHOP_SOLDOUT	Esaurito
SHOT_ERROR_UNKNOWN	Errore sconosciuto nell'attacco a distanza: %s
SKILL_BLEEDING	Emorragia
SKILL_BOHO	Riflettere
SKILL_CANNOT_LEVEL_UP_ANYMORE_BY_BOOK	Ti serve EXP per imparare questa abilità.
SKILL_CANNOT_LEVEL_UP_ANYMORE_BY_STAT	Ti serve un libro per imparare questa abilità.
SKILL_CHEONGEUN	Corpo forte
SKILL_CRITICAL	Colpo critico
SKILL_ENCHANT_POISON	Applica il veleno
SKILL_EUNHYEONG	Camuffamento
SKILL_FAINT	Svenimento
SKILL_FIND_TRAP	Cerca trappola
SKILL_FIRE	Fuoco duraturo
SKILL_FISHMIND	La palla di pesce è usata.
SKILL_GAMJI	Mirare
SKILL_GEOMGYEONG	Aura della spada
SKILL_GICHEON	Aiuto del drago
SKILL_GIGONG	Rotazione Chi
SKILL_GONGPO	Terrore
SKILL_GRADE_NAME_GRAND_MASTER	%s Gran Maestro
SKILL_GRADE_NAME_MASTER	%s Maestro
SKILL_GRADE_NAME_PERFECT_MASTER	%s Maestro perfetto
SKILL_GROUP_ASSASSIN_1	Lama
SKILL_GROUP_ASSASSIN_2	Arco
SKILL_GROUP_HORSE	Equitazione
SKILL_GROUP_SHAMAN_1	Drago
SKILL_GROUP_SHAMAN_2	Guarigione
SKILL_GROUP_SURA_1	Armi
SKILL_GROUP_SURA_2	Magia
SKILL_GROUP_WARRIOR_1	Corpo
SKILL_GROUP_WARRIOR_2	Mentale
SKILL_GWIGEOM	Lama incantata
SKILL_GYEONGGONG	Passo piumato
SKILL_HEUKSIN	Protezione oscura
SKILL_HOSIN	Benedizione
SKILL_INC_ATKSPD	Velocità di attacco aumentata
SKILL_INC_MOVSPD	Velocità di movimento aumentata
SKILL_JEOJU	Maledizione
SKILL_JEONGEOP	Guarire
SKILL_JEONGWI	Estasi da combattimento
SKILL_JEONSINBANGEO	Difesa piena
SKILL_JEONSINGONGGYEOK	Attacco pieno
SKILL_JEUNGRYEOK	Attacco +
SKILL_JEUNGSOK	Vlocità +
SKILL_JUMAGAP	Armatura incantata
SKILL_KWAESOK	Velocità
SKILL_MUYEONG	Spirito della fiamma
SKILL_NEED_EMPTY_BOTTLE	Non ho altre bottiglie vuote.
SKILL_NEED_POISON_BOTTLE	Non ho bottiglie di veleno.
SKILL_ONLY_FOR_GUILD_WAR	Puoi usare questa abilità solo nella guerra tra Gilde.
SKILL_PABEOP	Annullamento magia
SKILL_POWERFUL_STRIKE	Attacco anestetizzante
SKILL_SEOMGWANG	Bomba lampo
SKILL_SLEEP	Sonno
SKILL_SLOW	Lento
SKILL_STUN	Anestetizzare
SKILL_SUHO	Guardiano
SKILL_SUMMON_DESCRIPTION	Possibilità di evocazione: %d%%
SKILL_TOOLTIP_INT	Intelligenza
SKILL_TOOLTIP_LEVEL	Livello
SKILL_TOXICDIE	Avvelenamento
SKILL_TOXICPOWER	Valore di avvelenamento migliorato
SKILL_TUSOK	Colpo dello spirito
SOUL_ITEM_TOOLTIP_APPLY	Effetto attivato
SOUL_ITEM_TOOLTIP_BLUE1	Tempo di gioco: %d/%d min. 
SOUL_ITEM_TOOLTIP_BLUE2	Quando si raggiunge il tempo di gioco il danno dell'abilità incrementa di %.1f volta/e.
SOUL_ITEM_TOOLTIP_COMMON	Non vale per: PvP, Trasformazione
SOUL_ITEM_TOOLTIP_RED1	Tempo di gioco: %d/%d min. 
SOUL_ITEM_TOOLTIP_RED2	Quando si raggiunge il tempo di gioco il danno dell'abilità incrementa di %.1f volta/e.
SOUL_ITEM_TOOLTIP_REMAIN_COUNT	Attacchi rimanenti: %d
SOUL_ITEM_TOOLTIP_REMOVE_TIME	L'anima si spegne tra
SOUL_ITEM_TOOLTIP_UNAPPLIED	Effetto non attivato
SOUL_REFINE_FAILURE	L'evoluzione non è andata buon fine.
SOUL_REFINE_SUCCESS	Evoluzione compiuta con successo!
STAT_MINUS_CON	Adattamento della vitalità (Possibilità rimaste: %d)
STAT_MINUS_DEX	Adattamento della destrezza (Possibilità rimaste: %d)
STAT_MINUS_INT	Adattamento dell'intelligenza (Possibilità rimaste: %d)
STAT_MINUS_STR	Adattamento della forza (Possibilità rimaste: %d)
STAT_TOOLTIP_CON	HP e Difesa aumentati
STAT_TOOLTIP_DEX	Precisione e Fuga aumentati
STAT_TOOLTIP_INT	MP e Difesa-Attacco magici aumentati
STAT_TOOLTIP_STR	Valori Attacco e Danno migliorati
SYMBOLLIST_TITLE	Registrare la bandiera della Gilda
TARGET_BUTTON_ACCEPT_FIGHT	Accetta
TARGET_BUTTON_AVENGE	Vendetta
TARGET_BUTTON_BLOCK	Blocca
TARGET_BUTTON_BLOCK_REMOVE	Sblocca
TARGET_BUTTON_BUILDING_DESTROY	Distruggi
TARGET_BUTTON_DISMOUNT	Scendi
TARGET_BUTTON_EMOTION_ALLOW	Emozioni
TARGET_BUTTON_EXCHANGE	Commercia
TARGET_BUTTON_EXCLUDE	Escludi
TARGET_BUTTON_EXIT_OBSERVER	Termina la modalità spettatore
TARGET_BUTTON_FIGHT	Duello
TARGET_BUTTON_FRIEND	Amico
TARGET_BUTTON_INVITE_GUILD	Invito Gilda.
TARGET_BUTTON_INVITE_PARTY	Invito Gruppo.
TARGET_BUTTON_LEAVE_PARTY	Lascia gruppo
TARGET_BUTTON_REQUEST_ENTER_PARTY	Entra nel gruppo
TARGET_BUTTON_REVIVE	Resuscita
TARGET_BUTTON_VIEW_EQUIPMENT	Armatura
TARGET_BUTTON_WHISPER	Chat privata
TARGET_LEVEL_BOSS	Boss
TARGET_LEVEL_KING	Grado 5
TARGET_LEVEL_KNIGHT	Grado 3
TARGET_LEVEL_PAWN	Grado 1
TARGET_LEVEL_S_KNIGHT	Grado 4
TARGET_LEVEL_S_PAWN	Grado 2
TARGET_TOOLTIP_ATTACK_COUNT	Punteggio totale: %d
TASKBAR_ATTACK	Attacca
TASKBAR_AUTO	Attacca automaticamente
TASKBAR_CAMERA	Videocamera
TASKBAR_EXP	Esperienza
TASKBAR_HP	HP
TASKBAR_MOVE	Muovi
TASKBAR_SKILL	Abilità
TASKBAR_SP	MP
TASKBAR_ST	AP
TENTH_COIN	Moneta/e dell'anniversario
TENTH_EVENT_ASK_EXCHANGE	Ti servono %d Bandiere dell'anniversario. Desideri continuare?
THING_COUNT	Tutti
TOOLTIP_AFFECT_ATT_GRADE_DOWN	Riduci danno	SNA
TOOLTIP_AFFECT_CONFUSION	Ti hanno stordito.
TOOLTIP_AFFECT_CRITICAL_GRADE_DOWN	Riduci la probabilità di colpo critico	SNA
TOOLTIP_AFFECT_CZ_UNLIMIT_ENTER	Signum del guardiano	SNA
TOOLTIP_AFFECT_DEFENSEWAVE_LASER	Non è stato possibile interrompere il raggio idrico.
TOOLTIP_AFFECT_DEF_GRADE_DOWN	Riduci difesa	SNA
TOOLTIP_AFFECT_ELECTRIC_SHOCK	Lampo
TOOLTIP_AFFECT_FISHING_GOLD_TUNA	Bonus Tonno dorato	SNA
TOOLTIP_AFFECT_FISHING_MOVE_SPEED_DOWN	Vestiti bagnati\nVelocità di movimento -50	SNA
TOOLTIP_AFFECT_LATE_SUMMER_EVENT_BUFF	Anime (%d/20)	SA
TOOLTIP_AFFECT_LATE_SUMMER_EVENT_PRIMIUM_BUFF	Anime preziose (%d/150)	SA
TOOLTIP_AFFECT_MI_BUFF	Buff occupazione: %s
TOOLTIP_AFFECT_MOUNT_FALL	Caduta dalla cavalcatura	SNA
TOOLTIP_AFFECT_POLYMORPH	Trasformazione	SNA
TOOLTIP_AFFECT_RCAST_SPEED	Incrementa tempo di ricarica	SNA
TOOLTIP_AFFECT_RED_DRAGONLAIR_BUFF	Resistenza contro i danni abilità +15% | Resistenza contro danni da attacco normali +15%
TOOLTIP_AFFECT_RESEARCHER_ELIXIR	Elisir del ricercatore	SNA
TOOLTIP_AFFECT_RHP_REGEN	Non è possibile riposarsi	SNA
TOOLTIP_AFFECT_SAFEBOX_BUFF_01	Bonus Magazzino\n +3% EXP	SNA
TOOLTIP_AFFECT_SAFEBOX_BUFF_02	Bonus Magazzino\n +20 difesa	SNA
TOOLTIP_AFFECT_SAFEBOX_BUFF_03	Bonus Magazzino\n +1% punti vita	SNA
TOOLTIP_AFFECT_SAFEBOX_BUFF_04	Bonus Magazzino\n +3% forte contro mostri	SNA
TOOLTIP_ALIGNMENT_DAMAGE_BONUS	In caso di punti karma bassi, il danno provocato aumenta.	SNA
TOOLTIP_ANTI_CRITICAL_PCT	Resistenza contro il colpo critico +%d%% 	SA
TOOLTIP_ANTI_PENETRATE_PCT	Resistenza contro i colpi trafiggenti +%d%%	SA
TOOLTIP_ANTI_SELL	Non può essere venduto nel negozio.
TOOLTIP_APPLY_ACCEDRAIN_RATE	Tasso di assorbimento: %d%%	SA
TOOLTIP_APPLY_ATTBONUS_ANIMAL	Forte contro Animali +%d%%	SA
TOOLTIP_APPLY_ATTBONUS_ASSASSIN	Forte contro Ninja +%d%%	SA
TOOLTIP_APPLY_ATTBONUS_BELL	Interruzione della difesa campana +%d%%	SA
TOOLTIP_APPLY_ATTBONUS_BOW	Interruzione della difesa frecce +%d%%	SA
TOOLTIP_APPLY_ATTBONUS_CLAW	Interruzione della difesa artigli +%d%%	SA
TOOLTIP_APPLY_ATTBONUS_CZ	Forte contro i mostri Zodiaco +%d%%	SA
TOOLTIP_APPLY_ATTBONUS_DAGGER	Interruzione della difesa pugnale +%d%%	SA
TOOLTIP_APPLY_ATTBONUS_DESERT	Forte contro mostri del deserto +%d%%	SA
TOOLTIP_APPLY_ATTBONUS_DEVIL	Forte contro Diavolo +%d%%	SA
TOOLTIP_APPLY_ATTBONUS_FAN	Interruzione della difesa ventaglio +%d%%	SA
TOOLTIP_APPLY_ATTBONUS_HUMAN	Forte contro Mezziuomini +%d%%	SA
TOOLTIP_APPLY_ATTBONUS_INSECT	Forte contro gli insetti +%d%%	SA
TOOLTIP_APPLY_ATTBONUS_MILGYO	Forte contro Esoterici +%d%%	SA
TOOLTIP_APPLY_ATTBONUS_MONSTER	Forte contro mostri +%d%%	SA
TOOLTIP_APPLY_ATTBONUS_ORC	Forte contro Orchi +%d%%	SA
TOOLTIP_APPLY_ATTBONUS_SHAMAN	Forte contro Shamane +%d%%	SA
TOOLTIP_APPLY_ATTBONUS_SURA	Forte contro Sura +%d%%	SA
TOOLTIP_APPLY_ATTBONUS_SWORD	Interruzione della difesa spada +%d%%	SA
TOOLTIP_APPLY_ATTBONUS_TWOHAND	Interruzione della difesa spadone +%d%%	SA
TOOLTIP_APPLY_ATTBONUS_UNDEAD	Forte contro Zombie +%d%%	SA
TOOLTIP_APPLY_ATTBONUS_WARRIOR	Forte contro Guerrieri +%d%%	SA
TOOLTIP_APPLY_ATTBONUS_WOLFMAN	Forte contro lican + %d%%	SA
TOOLTIP_APPLY_BLEEDING_PCT	Attacco sanguinante + %d%%	SA
TOOLTIP_APPLY_BLEEDING_REDUCE	Resistenza contro l'attacco sanguinante + %d%%	SA
TOOLTIP_APPLY_BLOCK	Possibilità blocco attacco corporale %d%%	SA
TOOLTIP_APPLY_COMBAT_SP_RECOVER	Rigenerare in battaglia %d MP ogni 5 Sec.	SA
TOOLTIP_APPLY_CRITICAL_PCT	+ %d%% di possibilità nei colpi critici	SA
TOOLTIP_APPLY_DAMAGE_SP_RECOVER	%d%% di possibilità di mantenere MP nei colpi	SA
TOOLTIP_APPLY_DODGE	%d%% di possibilità di schivare frecce	SA
TOOLTIP_APPLY_ENCHANT_DARK	Forza dell'oscurità +%d%%	SA
TOOLTIP_APPLY_ENCHANT_DARK2	Forza dell'oscurità +%d%% ~ +%d%%
TOOLTIP_APPLY_ENCHANT_EARTH	Forza della terra +%d%%	SA
TOOLTIP_APPLY_ENCHANT_EARTH2	Forza della terra +%d%% ~ +%d%%
TOOLTIP_APPLY_ENCHANT_ELECT	Forza del fulmine +%d%%	SA
TOOLTIP_APPLY_ENCHANT_ELECT2	Forza del fulmine +%d%% ~ +%d%%
TOOLTIP_APPLY_ENCHANT_FIRE	Forza del fuoco +%d%%	SA
TOOLTIP_APPLY_ENCHANT_FIRE2	Forza del fuoco +%d%% ~ +%d%%
TOOLTIP_APPLY_ENCHANT_ICE	Forza del ghiaccio +%d%%	SA
TOOLTIP_APPLY_ENCHANT_ICE2	Forza del ghiaccio +%d%% ~ +%d%%
TOOLTIP_APPLY_ENCHANT_WIND	Forza del vento +%d%%	SA
TOOLTIP_APPLY_ENCHANT_WIND2	Forza del vento +%d%% ~ +%d%%
TOOLTIP_APPLY_EXP_DOUBLE_BONUS	%d%% di possibilità sul EXP Bonus	SA
TOOLTIP_APPLY_GOLD_DOUBLE_BONUS	%d%% di possibilità di lasciar cadere Yang	SA
TOOLTIP_APPLY_IMMUNE_FALL	Immune contro caduta	SNA
TOOLTIP_APPLY_IMMUNE_SLOW	Difesa contro rallentamento	SNA
TOOLTIP_APPLY_IMMUNE_STUN	Difesa contro svenimento	SNA
TOOLTIP_APPLY_ITEM_DROP_BONUS	%d%% di possibilità di far cadere il doppio degli oggetti	SA
TOOLTIP_APPLY_KILL_HP_RECOVER	%d%% di possibilità di rigenerare HP	SA
TOOLTIP_APPLY_KILL_SP_RECOVER	%d%% di possibilità di rigenerare MP	SA
TOOLTIP_APPLY_MANA_BURN_PCT	%d%% di possibilità prendere MP dell'avversario	SA
TOOLTIP_APPLY_MAX_HP_PCT	HP max. +%d%% 	SA
TOOLTIP_APPLY_MAX_SP_PCT	MP max. +%d%% 	SA
TOOLTIP_APPLY_NOAFFECT	Nessun effetto
TOOLTIP_APPLY_NO_DEATH_PENALTY	Facendo rinascere il personaggio sul luogo della sua morte non perderà punti esperienza.	SNA
TOOLTIP_APPLY_NO_DEATH_PENALTY_PLUS	Il Dio Drago ti protegge con le sue ali. La rianimazione a bordo non consuma alcun punto esperienza.	SNA
TOOLTIP_APPLY_PENETRATE_PCT	%d%% di possibilità su colpi che trafiggono	SA
TOOLTIP_APPLY_POISON_PCT	Probabilità di avvelenamento: %d%%	SA
TOOLTIP_APPLY_POISON_REDUCE	Resistenza avvelenamento %d%%	SA
TOOLTIP_APPLY_POTION_BONUS	Pozione %d%% aumento dell'effetto	SA
TOOLTIP_APPLY_REFLECT_CURSE	Possibilità di riflettere maledizione: %d%%	SA
TOOLTIP_APPLY_REFLECT_MELEE	Possibilità di riflettere un attacco corporale: %d%%	SA
TOOLTIP_APPLY_RESIST_ASSASSIN	Possibilità di difesa dai ninja %d%%	SA
TOOLTIP_APPLY_RESIST_BELL	Difesa campana %d%%	SA
TOOLTIP_APPLY_RESIST_CLAW	Difesa artigli +%d%%	SA
TOOLTIP_APPLY_RESIST_DAGGER	Difesa pugnale %d%%	SA
TOOLTIP_APPLY_RESIST_FAN	Difesa ventaglio %d%%	SA
TOOLTIP_APPLY_RESIST_HUMAN	Resistenza ai Mezziuomini %d%%	SA
TOOLTIP_APPLY_RESIST_MOUNT_FALL	Resistenza alla caduta +%d%%	SA
TOOLTIP_APPLY_RESIST_SHAMAN	Possibilità di difesa dagli shamani %d%%	SA
TOOLTIP_APPLY_RESIST_SURA	Possibilità di difesa dai sura %d%%	SA
TOOLTIP_APPLY_RESIST_SWORD	Difesa spada %d%%	SA
TOOLTIP_APPLY_RESIST_TWOHAND	Difesa spadone %d%%	SA
TOOLTIP_APPLY_RESIST_WARRIOR	Possibilità di difesa dai guerrieri %d%%	SA
TOOLTIP_APPLY_RESIST_WIND	Resistenza vento %d%%	SA
TOOLTIP_APPLY_RESIST_WOLFMAN	Possibilità di difesa dai lican %d%%	SA
TOOLTIP_APPLY_SKILL_BOOK_BONUS	Possibilità di imparare dai libri migliorata di fattore 2,5	SNA
TOOLTIP_APPLY_SKILL_BOOK_NO_DELAY	Se l'apprendimento fallisce, hai a disposizione subito un altro tentativo.	SNA
TOOLTIP_APPLY_SLOW_PCT	Probabilità di rallentamento: %d%%	SA
TOOLTIP_APPLY_STEAL_HP	%d%% di danni assorbiti da HP.	SA
TOOLTIP_APPLY_STEAL_SP	%d%% di danni assorbiti da MP.	SA
TOOLTIP_APPLY_STUN_PCT	Probabilità di svenimento: %d%%	SA
TOOLTIP_ARMOR	Armatura
TOOLTIP_ARROW	Freccia
TOOLTIP_ASSASSIN	Ninja
TOOLTIP_ATTBONUS_STONE	+%d%% forte contro Rocce Metin	SA
TOOLTIP_ATT_GRADE	Valore d'attacco +%d	SA
TOOLTIP_ATT_SPEED	Velocità d'attacco +%d%%	SA
TOOLTIP_ATT_SPEED_SLOW	Velocità di attacco ridotta	SNA
TOOLTIP_AUTO_POTION_HP	Elisir del Sole
TOOLTIP_AUTO_POTION_REST	Quantità rimasta: %.2f%%
TOOLTIP_AUTO_POTION_SP	Elisir della Luna
TOOLTIP_AUTO_POTION_USING	Attivo
TOOLTIP_AUTO_SYSTEM_PRIMIUM	Autocaccia	SNA
TOOLTIP_BATTLE_POTION	Pozione da battaglia per la zona di combattimento	SNA
TOOLTIP_BOW_DISTANCE	Raggio d'azione dell'arco +%dm	SA
TOOLTIP_BUYPRICE	Prezzo: %s
TOOLTIP_CAST_SPEED	Velocità della magia +%d%%	SA
TOOLTIP_CON	Vitalità  +%d	SA
TOOLTIP_COSTUME_ATTR_BONUS	Bonus costume %d%% 	SA
TOOLTIP_DAMAGE_HP_RECOVERY	Assorbe %d%% di danno come HP	SA
TOOLTIP_DAMAGE_SP_RECOVERY	Assorbe %d%% di danno come MP	SA
TOOLTIP_DEF_GRADE	Difesa +%d	SA
TOOLTIP_DEX	Destrezza +%d	SA
TOOLTIP_DRAGON_SOUL_DECK1	Cielo	SNA
TOOLTIP_DRAGON_SOUL_DECK2	Terra	SNA
TOOLTIP_DS_SET	Effetto set DSS	SNA
TOOLTIP_EAR	Orecchino
TOOLTIP_ENERGY	Energia %d	SA
TOOLTIP_ETC	Ecc.
TOOLTIP_EXP_BONUS_EVENT	EXP +%d%%	SA
TOOLTIP_FIFTH_ATTRIBUTE_BONUS	5° bonus aggiunto +%d%%	SA
TOOLTIP_FIRST_ATTRIBUTE_BONUS	1° bonus aggiunto +%d%%	SA
TOOLTIP_FISHINGROD_EXP	Punti: %d / %d
TOOLTIP_FISHINGROD_LEVEL	Livello: %d
TOOLTIP_FISHINGROD_UPGRADE1	Consegnare al pescatore
TOOLTIP_FISHINGROD_UPGRADE2	per ottenere una migliore
TOOLTIP_FISHINGROD_UPGRADE3	canna da pesca
TOOLTIP_FISH_LEN	Lunghezza: %.2fcm
TOOLTIP_FOURTH_ATTRIBUTE_BONUS	4° bonus aggiunto +%d%%	SA
TOOLTIP_GUILD_SKILL_ACCEL	Accelerazione +%d	SA
TOOLTIP_GUILD_SKILL_BLESS	Benedizione del Dio Drago +%d	SA
TOOLTIP_GUILD_SKILL_BLOOD	Sangue del Dio Drago +%d	SA
TOOLTIP_GUILD_SKILL_BUNNO	Rabbia del Dio Drago +%d%%	SA
TOOLTIP_GUILD_SKILL_JUMUN	Aiuto della magia +%d%%	SA
TOOLTIP_GUILD_SKILL_SEONGHWI	Armatura benedetta +%d	SA
TOOLTIP_HALLOWEEN_EVENT_BUFF	+20% di EXP | +5% di drop di item | +10% di forte contro mostri	SNA
TOOLTIP_HELMET	Elmo
TOOLTIP_HIT_BUFF_ENCHANT_DARK	Forza dell'oscurità per %d sec. in battaglia	SA
TOOLTIP_HIT_BUFF_ENCHANT_EARTH	Forza della terra per %d sec. in battaglia	SA
TOOLTIP_HIT_BUFF_ENCHANT_ELEC	Forza del fulmine per %d sec. in battaglia	SA
TOOLTIP_HIT_BUFF_ENCHANT_FIRE	Forza del fuoco per %d sec. in battaglia	SA
TOOLTIP_HIT_BUFF_ENCHANT_ICE	Forza del ghiaccio per %d sec. in battaglia	SA
TOOLTIP_HIT_BUFF_ENCHANT_WIND	Forza del vento per %d sec. in battaglia	SA
TOOLTIP_HIT_BUFF_RESIST_DARK	Resistenza vs. Oscurità per %d sec. in battaglia	SA
TOOLTIP_HIT_BUFF_RESIST_EARTH	Resistenza terra per %d sec. in battaglia	SA
TOOLTIP_HIT_BUFF_RESIST_ELEC	Resistenza lampo per %d sec. in battaglia	SA
TOOLTIP_HIT_BUFF_RESIST_FIRE	Resistenza fuoco per %d sec. in battaglia	SA
TOOLTIP_HIT_BUFF_RESIST_ICE	Resistenza ghiaccio per %d sec. in battaglia	SA
TOOLTIP_HIT_BUFF_RESIST_WIND	Resistenza vento per %d sec. in battaglia	SA
TOOLTIP_HP_REGEN	Rigenerazione HP +%d%%	SA
TOOLTIP_INT	Intelligenza +%d	SA
TOOLTIP_ITEM_ATT_GRADE	Valore d'attacco %d
TOOLTIP_ITEM_ATT_POWER	Valore d'attacco %d - %d
TOOLTIP_ITEM_ATT_POWER_ONE_ARG	Valore d'attacco %d
TOOLTIP_ITEM_ATT_POWER_REFINE	Valore d'attacco %d - %d (+%d)
TOOLTIP_ITEM_ATT_SPEED	Velocità d'attacco %s
TOOLTIP_ITEM_DEF_GRADE	Difesa %d
TOOLTIP_ITEM_FAST	Veloce
TOOLTIP_ITEM_LIMIT_CON	Valore massimo vitalità: %d
TOOLTIP_ITEM_LIMIT_DEX	Valore massimo destrezza: %d
TOOLTIP_ITEM_LIMIT_INT	Valore massimo intelligenza: %d
TOOLTIP_ITEM_LIMIT_LEVEL	Da liv: %d
TOOLTIP_ITEM_LIMIT_STR	Valore massimo forza: %d
TOOLTIP_ITEM_MAGIC_ATT_POWER	Valore attacco magico %d - %d
TOOLTIP_ITEM_MAGIC_ATT_POWER_ONE_ARG	Valore attacco magico %d
TOOLTIP_ITEM_MAGIC_DEF_POWER	Difesa magica %d
TOOLTIP_ITEM_NORMAL	Normale
TOOLTIP_ITEM_SLOW	Lento
TOOLTIP_ITEM_VERY_FAST	Molto veloce
TOOLTIP_ITEM_VERY_SLOW	Molto lento
TOOLTIP_ITEM_WEARABLE_JOB	[ Equipaggiabile ]
TOOLTIP_LOTTERY_STEP_NUMBER	%d
TOOLTIP_LOTTO_NUMBER	Numero fortuna: %d
TOOLTIP_MAGIC_ATTBONUS_PER	Attacco magico +%d%% 	SA
TOOLTIP_MAGIC_ATT_GRADE	Valore d'attacco magico +%d	SA
TOOLTIP_MAGIC_DEF_GRADE	Difesa magica +%d	SA
TOOLTIP_MALL_ATTBONUS	Valore d'attacco +%d%%	SA
TOOLTIP_MALL_ATTBONUS_STATIC	Valore d'attacco	SNA
TOOLTIP_MALL_AUTOLOOT	Drop di Yang vengono raccolti automaticamete.	SNA
TOOLTIP_MALL_DEFBONUS	Difesa +%d%%	SA
TOOLTIP_MALL_DEFBONUS_STATIC	Difesa 	SNA
TOOLTIP_MALL_EXPBONUS	EXP +%d%%	SA
TOOLTIP_MALL_EXPBONUS_P_STATIC	iCafe EXP-Bonus +%d%%	SA
TOOLTIP_MALL_EXPBONUS_STATIC	50% in più EXP	SNA
TOOLTIP_MALL_FISH_MIND	La possibilità di catturare un pesce è aumentata.	SNA
TOOLTIP_MALL_GOLDBONUS	Probabilità di drop di Yang incrementata (%d%%)	SA
TOOLTIP_MALL_GOLDBONUS_STATIC	Doppia probabilità di drop di Yang	SNA
TOOLTIP_MALL_ITEMBONUS	Probabilità di drop di oggetti incrementata (%d%%)	SA
TOOLTIP_MALL_ITEMBONUS_P_STATIC	iCafe Possibilità di razziare oggetti "+" %.1f%%	SA
TOOLTIP_MALL_ITEMBONUS_STATIC	Probabilità di drop di oggetti incrementata del 200%.	SNA
TOOLTIP_MALL_MARRIAGE_FAST	Punti amore aumentano più veocemente.	SNA
TOOLTIP_MALL_SAFEBOX	Più spazio a disposizione nel magazzino.	SNA
TOOLTIP_MAX_HP	Max. HP +%d	SA
TOOLTIP_MAX_HP_PCT	Max. HP +%d%%	SA
TOOLTIP_MAX_SP	Max. MP +%d	SA
TOOLTIP_MAX_SP_PCT	Max. MP +%d%%	SA
TOOLTIP_MAX_STAMINA	Max. resistenza +%d	SA
TOOLTIP_MELEE_MAGIC_ATTBONUS_PER	Attacco/magico Attacco/corpo a corpo +%d%% 	SA
TOOLTIP_MEMORIZED_POSITION	%s(%d, %d)
TOOLTIP_MEMORIZED_POSITION_ERROR	GPS-ERRORE(%d, %d)
TOOLTIP_MORE_THEN_HP90_DAMAGE_REDUCE	Se hai più del 90%% di HP, il danno subito diminuisce (-%d%%).	SA
TOOLTIP_MOV_SPEED	Velocità movimento %d%%	SA
TOOLTIP_NECK	Collana
TOOLTIP_NEED_ALL_SP	MP necessari: Max.
TOOLTIP_NEED_GSP	Spirito del drago necessario: %d
TOOLTIP_NEED_HP	HP necessari: %d
TOOLTIP_NEED_HP_PER_SEC	HP / Sec.: %d
TOOLTIP_NEED_SKILL_POINT	Punti abilità necessari:
TOOLTIP_NEED_SP	MP necessari: %d
TOOLTIP_NEED_SP_PER_SEC	MP / Sec.:%d
TOOLTIP_NEXT_SKILL_LEVEL_1	Prossimo livello: %d (Max. %d)
TOOLTIP_NEXT_SKILL_LEVEL_2	Prossimo livello: %d (Max. %d-%d)
TOOLTIP_NORMAL_DAMAGE_GUARD	Probabilità blocco danni da attacco: %d%%	SA
TOOLTIP_NORMAL_HIT_DAMAGE_BONUS	Danni medi %d%%	SA
TOOLTIP_NORMAL_HIT_DAMAGE_BONUS_BOSS_OR_MORE	Danni da attacco contro boss: +%d%%	SA
TOOLTIP_NORMAL_HIT_DEFEND_BONUS	Resistenza ai danni medi %d%%	SA
TOOLTIP_NORMAL_HIT_DEFEND_BONUS_BOSS_OR_MORE	Danni da attacco da boss: -%d%%	SA
TOOLTIP_PARTY_INFO_GRADE_UP1	Più di %d membri del gruppo
TOOLTIP_PARTY_INFO_GRADE_UP2	Grado d'attacco +%d
TOOLTIP_PARTY_INFO_GRADE_UP3	Grado di difesa +%d
TOOLTIP_PARTY_INFO_HEAL_18_LEVEL	Ripristinare una volta in 60 minuti gli HP/MP di tutti i membri del gruppo.
TOOLTIP_PARTY_INFO_HEAL_40_LEVEL	Ripristinare una volta in 30 minuti gli HP/MP di tutti i membri del gruppo.
TOOLTIP_PARTY_INFO_RECALL_12_LEVEL	Devi aspettare 3 minuti dopo la morte del membro del gruppo.
TOOLTIP_PARTY_INFO_RECALL_20_LEVEL	Puoi richiamare in ogni momento i membri del gruppo che sono sul server.
TOOLTIP_PARTY_INFO_SET_ATTACKER	Grado d'attacco +(Numero dei membri/2) %d attaccanti possono essere scelti.
TOOLTIP_PARTY_INFO_SET_TANKER	Grado di difesa +(Numero dei membri del gruppo).  Può essere scelto lottatore corpo a corpo 1.
TOOLTIP_PARTY_SKILL_LEVEL	Livello attuale: %d
TOOLTIP_PARTY_TITLE_GRADE_UP	[Attacco/Difesa migliorata]
TOOLTIP_PARTY_TITLE_HEAL	[Ripristina]
TOOLTIP_PARTY_TITLE_INFO_BONUS_EXP	Per più di %d membri del gruppo c'è un Bonus EXP %d%%.
TOOLTIP_PARTY_TITLE_MEMBER_BONUS_EXP	[Bonus-EXP]
TOOLTIP_PARTY_TITLE_RECALL	[Richiama]
TOOLTIP_PARTY_TITLE_SET_ATTACKER	[scegli attaccante]
TOOLTIP_PARTY_TITLE_SET_TANKER	[annota lottatore corpo a corpo]
TOOLTIP_PEPSI_EVENT	5% in più di bonus EXP e 5% in più di probabilità di razziare oggetti.	SNA
TOOLTIP_PICK_EXP	Punti: %d / %d
TOOLTIP_PICK_LEVEL	Livello: %d
TOOLTIP_PICK_UPGRADE1	Consegnalo al boscaiolo
TOOLTIP_PICK_UPGRADE2	per ottenere
TOOLTIP_PICK_UPGRADE3	un piccone migliore.
TOOLTIP_POTION_CURE	Annullare effetto negativo.
TOOLTIP_POTION_MIN	Min.
TOOLTIP_POTION_PLUS_ATTACK_SPEED	Velocità d'attacco: +%d
TOOLTIP_POTION_PLUS_ATTBONUS_MONSTER	BONUS ATT. MOSTRO: +%d%%
TOOLTIP_POTION_PLUS_ATT_POINT	ATT: +%d
TOOLTIP_POTION_PLUS_ATT_POINT_PER	ATT: +%d%%
TOOLTIP_POTION_PLUS_DEF_POINT	DIF: +%d
TOOLTIP_POTION_PLUS_DEX_POINT	DEX: +%d
TOOLTIP_POTION_PLUS_EXP_BONUS	EXP: +%d%%
TOOLTIP_POTION_PLUS_HIT_DEFEND_POINT	RESISTENZA DANNI: +%d%%
TOOLTIP_POTION_PLUS_HP_PERCENT	HP +%d%%
TOOLTIP_POTION_PLUS_HP_POINT	HP +%d
TOOLTIP_POTION_PLUS_MOVING_SPEED	Velocità di movimento: +%d
TOOLTIP_POTION_PLUS_RESIST_DARK	RESISTENZA OSCURITÀ: +%d%%
TOOLTIP_POTION_PLUS_RESIST_EARTH	RESISTENZA TERRA: +%d%%
TOOLTIP_POTION_PLUS_RESIST_ICE	RESISTENZA GHIACCIO: +%d%%
TOOLTIP_POTION_PLUS_RESIST_MAGIC	RESISTENZA MAGIA: +%d%%
TOOLTIP_POTION_PLUS_SP_PERCENT	MP +%d%%
TOOLTIP_POTION_PLUS_SP_POINT	MP +%d
TOOLTIP_POTION_PLUS_STR_POINT	FORTE: +%d
TOOLTIP_POTION_SEC	Sec.
TOOLTIP_POTION_TIME	Durata:
TOOLTIP_PVP_TOURNAMENT_ENTER	Partecipazione al torneo PvP
TOOLTIP_PVP_TOURNAMENT_EXPBONUS	EXP torneo PvP +%d%%	SA
TOOLTIP_REQUIREMENT_21_LEVEL	Devi aver raggiunto livello 21
TOOLTIP_REQUIREMENT_41_LEVEL	Devi aver raggiunto livello 41
TOOLTIP_REQUIREMENT_LEVEL	Devi aver raggiunto livello %d
TOOLTIP_REQUIREMENT_SKILL_LEVEL	%s Livello %d necessario
TOOLTIP_REQUIREMENT_STAT_LEVEL	%s %d necessario
TOOLTIP_RESIST_BOW	Difesa frecce %d%%	SA
TOOLTIP_RESIST_DARK	Resistenza contro l'oscurità +%d%% 	SA
TOOLTIP_RESIST_EARTH	Resistenza terra +%d%%	SA
TOOLTIP_RESIST_ELEC	Resistenza lampo %d%%	SA
TOOLTIP_RESIST_FIRE	Resistenza fuoco %d%%	SA
TOOLTIP_RESIST_ICE	Resistenza ghiaccio +%d%%	SA
TOOLTIP_RESIST_MAGIC	Resistenza magia %d%%	SA
TOOLTIP_RESIST_MAGIC_REDUCTION	Anti-magia del seguente valore: %d%%	SA
TOOLTIP_REST_USABLE_COUNT	Rimane: %d
TOOLTIP_SEALED	Legato all'anima
TOOLTIP_SEASON_PVE_BUFF	Aumenta i danni PvE dell'80% per 10 minuti.	SNA
TOOLTIP_SEASON_RANKING_BUFF	Aumenta i punti karma del 20% per 10 minuti.	SNA
TOOLTIP_SECOND_ATTRIBUTE_BONUS	2° bonus aggiunto +%d%%	SA
TOOLTIP_SELLPRICE	Prezzo %s
TOOLTIP_SET_ITEM	Bonus del Set	SNA
TOOLTIP_SHAMAN	Shamana
TOOLTIP_SHIELD	Scudo
TOOLTIP_SHOES	Scarpe
TOOLTIP_SKILL	Abilità	SNA
TOOLTIP_SKILLBOOK_NAME	Libro dell'abilità
TOOLTIP_SKILL_AFFECT_ATT_GRADE	Valore d'attacco: +
TOOLTIP_SKILL_AFFECT_ATT_POWER	Valore d'attacco:
TOOLTIP_SKILL_AFFECT_ATT_SPEED	Velocità d'attacco: +
TOOLTIP_SKILL_AFFECT_DEF_GRADE	Difesa:
TOOLTIP_SKILL_AFFECT_DODGE	Valore d'attacco avversario: -
TOOLTIP_SKILL_AFFECT_HEAL	ripristinare HP:
TOOLTIP_SKILL_AFFECT_MOV_SPEED	Velocità di movimento: +
TOOLTIP_SKILL_AFFECT_REFLECT_MELEE	Possibilità di riflettere un attacco corporale:
TOOLTIP_SKILL_AFFECT_RESIST_NORMAL	Resistenza ai danni corporali:
TOOLTIP_SKILL_COOL_TIME	Tempo di ricarica: 
TOOLTIP_SKILL_DAMAGE_AMSEOP	Danni da Tranello +%d%%	SA
TOOLTIP_SKILL_DAMAGE_BIPABU	Danni da Talismano volante +%d%%	SA
TOOLTIP_SKILL_DAMAGE_BONUS	Danni abilità %d%%	SA
TOOLTIP_SKILL_DAMAGE_BONUS_BOSS_OR_MORE	Danni abilità contro boss +%d%%	SA
TOOLTIP_SKILL_DAMAGE_BYEURAK	Danni da Evocare i lampi +%d%%	SA
TOOLTIP_SKILL_DAMAGE_CHAIN	Danni da Artiglio di lampo +%d%%	SA
TOOLTIP_SKILL_DAMAGE_CHARYUN	Danni da Vortice del pugnale +%d%%	SA
TOOLTIP_SKILL_DAMAGE_CHAYEOL	Danni da Dilania +%d%%	SA
TOOLTIP_SKILL_DAMAGE_GEOMPUNG	Danni da Colpo di spada +%d%%	SA
TOOLTIP_SKILL_DAMAGE_GIGONGCHAM	Danni da Penetrazione +%d%%	SA
TOOLTIP_SKILL_DAMAGE_GIGUNG	Danni da Freccia avvelenata +%d%%	SA
TOOLTIP_SKILL_DAMAGE_GONGDAB	Danni da Salto del lupo +%d%%	SA
TOOLTIP_SKILL_DAMAGE_GUNGSIN	Danni da Attacco lampo +%d%%	SA
TOOLTIP_SKILL_DAMAGE_GYOKSAN	Danni da Colpo potente +%d%%	SA
TOOLTIP_SKILL_DAMAGE_HWAJO	Danni da Freccia di fuoco +%d%%	SA
TOOLTIP_SKILL_DAMAGE_HWAYEOMPOK	Danni da Colpo di fiamma +%d%%	SA
TOOLTIP_SKILL_DAMAGE_KWANKYEOK	Danni da Pioggia di frecce +%d%%	SA
TOOLTIP_SKILL_DAMAGE_MAHWAN	Danni da Pietra oscura +%d%%	SA
TOOLTIP_SKILL_DAMAGE_MARYUNG	Danni da Colpo oscuro +%d%%	SA
TOOLTIP_SKILL_DAMAGE_NOEJEON	Danni da Lancio di lampi +%d%%	SA
TOOLTIP_SKILL_DAMAGE_PABEOB	Danni da Annullamento magia +%d%%	SA
TOOLTIP_SKILL_DAMAGE_PAERYONG	Danni da Ruggito del drago +%d%%	SA
TOOLTIP_SKILL_DAMAGE_PALBANG	Danni da Vortice di spada +%d%%	SA
TOOLTIP_SKILL_DAMAGE_PASWAE	Danni da Artiglio di lupo +%d%%	SA
TOOLTIP_SKILL_DAMAGE_SALPOONG	Danni da Respiro del lupo +%d%%	SA
TOOLTIP_SKILL_DAMAGE_SAMYEON	Danni da Taglio a tre vie +%d%%	SA
TOOLTIP_SKILL_DAMAGE_SANGONG	Danni da Nuvola velenosa +%d%%	SA
TOOLTIP_SKILL_DAMAGE_SWAERYUNG	Danni da Schiocco di dita +%d%%	SA
TOOLTIP_SKILL_DAMAGE_TANHWAN	Danni da Sibilare +%d%%	SA
TOOLTIP_SKILL_DAMAGE_YEONSA	Danni da Tiro ripetuto +%d%%	SA
TOOLTIP_SKILL_DAMAGE_YONGBI	Danni da Tiro del drago +%d%%	SA
TOOLTIP_SKILL_DAMAGE_YONGKWON	Danni da Vortice del drago +%d%%	SA
TOOLTIP_SKILL_DEFEND_BONUS	Resistenza contro i danni abilità %d%%	SA
TOOLTIP_SKILL_DEFEND_BONUS_BOSS_OR_MORE	Danni abilità da boss -%d%%	SA
TOOLTIP_SKILL_DURATION	Durata: %d sec.
TOOLTIP_SKILL_DURATION_INCREASE_EUNHYUNG	Durata Camuffamento +%d sec.	SA
TOOLTIP_SKILL_DURATION_INCREASE_GEOMKYUNG	Durata Aura della spada +%d sec.	SA
TOOLTIP_SKILL_DURATION_INCREASE_GYEONGGONG	Durata di Passo piumato +%d sec.	SA
TOOLTIP_SKILL_DURATION_INCREASE_JEOKRANG	Durata Anima lupo purpureo +%d sec.	SA
TOOLTIP_SKILL_FORGET_BOOK_NAME	Libro dell'amnesia
TOOLTIP_SKILL_LEVEL	Livello attuale: %d
TOOLTIP_SKILL_LEVEL_MASTER	Livello attuale: %d (Maestro)
TOOLTIP_SKILL_LEVEL_WITH_MAX	Livello attuale: %d (Max. %d)
TOOLTIP_SOCKET_EMPTY	Vuoto
TOOLTIP_SOCKET_REFINABLE_ITEM	[Oggetto con montatura]
TOOLTIP_SP_REGEN	Rigenerazione MP +%d%%	SA
TOOLTIP_STR	Forza +%d	SA
TOOLTIP_SURA	Sura
TOOLTIP_THIRD_ATTRIBUTE_BONUS	3° bonus aggiunto +%d%%	SA
TOOLTIP_TIME_CHARGER_FIX	Tempo di ricarica %d sec. 	SA
TOOLTIP_TIME_CHARGER_PER	Tempo di ricarica %d%% 	SA
TOOLTIP_UNIQUE	Unico
TOOLTIP_UNSEAL_LEFT_TIME	Slegamento dall'anima tra: %dH %dM
TOOLTIP_USE_SKILL_AMSEOP_HP_ABSORB	Assorbi %d%% HP utilizzando Tranello	SA
TOOLTIP_USE_SKILL_BIPABU_NEXT_COOLTIME_DECREASE_10PER	Tempo di ricarica Talismano volante: -%d sec. (10%% di chance )	SA
TOOLTIP_USE_SKILL_BIPABU_NEXT_COOLTIME_DECREASE_20PER	Tempo di ricarica Talismano volante: -%d sec. (20%% di chance)	SA
TOOLTIP_USE_SKILL_BYEURAK_HP_ABSORB	Assorbi max. %d%% HP utilizzando Evocare i lampi	SA
TOOLTIP_USE_SKILL_CHAIN_HP_ABSORB	Assorbi %d%% HP utilizzando Artiglio di lampo	SA
TOOLTIP_USE_SKILL_CHARYUN_STUN	Vortice del pugnale stordisce l'avversario (%d%% di chance)	SA
TOOLTIP_USE_SKILL_CHAYEOL_CRITICAL_PCT	Aumenti chance di attacco critico per %d sec. utilizzando Dilania	SA
TOOLTIP_USE_SKILL_CHAYEOL_HP_ABSORB	Assorbi %d%% HP utilizzando Dilania	SA
TOOLTIP_USE_SKILL_CHEONGRANG_CASTING_SPEED	Aumenti Velocità magia per %d sec. utilizzando Anima del lupo indaco	SA
TOOLTIP_USE_SKILL_CHEONGRANG_MOV_SPEED	Aumenti Velocità di movimento per %d sec. utilizzando Anima del lupo indaco	SA
TOOLTIP_USE_SKILL_CHUNKEON_CASTING_SPEED	Aumenti Velocità magia per %d sec. utilizzando Corpo forte	SA
TOOLTIP_USE_SKILL_GEOMPUNG_NEXT_COOLTIME_DECREASE_10PER	Tempo di ricarica Colpo di spada: -%d sec. (10%% di chance )	SA
TOOLTIP_USE_SKILL_GEOMPUNG_NEXT_COOLTIME_DECREASE_20PER	Tempo di ricarica Colpo di spada: -%d sec. (20%% di chance)	SA
TOOLTIP_USE_SKILL_GICHEON_ATT_GRADE_BONUS	Bonus attacco per %d sec. utilizzando Aiuto del drago	SA
TOOLTIP_USE_SKILL_GIGONGCHAM_STUN	Penetrazione stordisce l'avversario (%d%% di chance)	SA
TOOLTIP_USE_SKILL_GIGUNG_ATT_GRADE_BONUS	Bonus attacco per %d sec. utilizzando Freccia avvelenata	SA
TOOLTIP_USE_SKILL_GIHYEOL_ATT_GRADE_BONUS	Bonus attacco per %d sec. utilizzando Volontà di vivere	SA
TOOLTIP_USE_SKILL_GONGDAB_KNOCKBACK	Salto del lupo respinge gli avversari (%d%% di chance)	SA
TOOLTIP_USE_SKILL_GONGDAB_STUN	Salto del lupo stordisce l'avversario (%d%% di chance)	SA
TOOLTIP_USE_SKILL_GUNGSIN_NEXT_COOLTIME_DECREASE_10PER	Tempo di ricarica Attacco lampo: -%d sec. (10%% di chance )	SA
TOOLTIP_USE_SKILL_GUNGSIN_NEXT_COOLTIME_DECREASE_20PER	Tempo di ricarica Attacco lampo: -%d sec. (20%% di chance )	SA
TOOLTIP_USE_SKILL_GWIGEOM_DEF_BONUS	Bonus difesa per %d sec. utilizzando Lama incantata	SA
TOOLTIP_USE_SKILL_GYOKSAN_KNOCKBACK	Colpo potente respinge gli avversari (%d%% di chance)	SA
TOOLTIP_USE_SKILL_HOSIN_DEF_BONUS	Bonus difesa per %d sec. utilizzando Benedizione	SA
TOOLTIP_USE_SKILL_HWAYEOMPOK_KNOCKBACK	Colpo di fiamma respinge gli avversari (%d%% di chance)	SA
TOOLTIP_USE_SKILL_JEOKRANG_DEF_BONUS	Bonus difesa per %d sec. utilizzando Anima del lupo purpureo	SA
TOOLTIP_USE_SKILL_JEONGEOP_ATT_GRADE_BONUS	Bonus attacco per %d sec. utilizzando Cura	SA
TOOLTIP_USE_SKILL_JEUNGRYEOK_DEF_BONUS	Bonus difesa per %d sec. utilizzando Attacco+	SA
TOOLTIP_USE_SKILL_KWANKYEOK_KNOCKBACK	Pioggia di frecce respinge gli avversari (%d%% di chance)	SA
TOOLTIP_USE_SKILL_KWANKYEOK_NEXT_COOLTIME_DECREASE_10PER	Tempo di ricarica Pioggia di frecce: -%d sec. (10%% di chance )	SA
TOOLTIP_USE_SKILL_KWANKYEOK_NEXT_COOLTIME_DECREASE_20PER	Tempo di ricarica Pioggia di frecce: -%d sec. (20%% di chance )	SA
TOOLTIP_USE_SKILL_MAHWAN_STUN	Pietra oscura stordisce l'avversario (%d%% di chance)	SA
TOOLTIP_USE_SKILL_MANASHILED_CASTING_SPEED	Aumenti Velocità magia per %d sec. utilizzando Protezione oscura	SA
TOOLTIP_USE_SKILL_MARYUNG_NEXT_COOLTIME_DECREASE_10PER	Tempo di ricarica Colpo oscuro: -%d sec. (10%% di chance )	SA
TOOLTIP_USE_SKILL_MARYUNG_NEXT_COOLTIME_DECREASE_20PER	Tempo di ricarica Colpo oscuro: -%d sec. (20%% di chance )	SA
TOOLTIP_USE_SKILL_MUYEONG_ATT_GRADE_BONUS	Bonus attacco per %d sec. utilizzando Spirito della fiamma	SA
TOOLTIP_USE_SKILL_NOEGEOM_ATT_GRADE_BONUS	Bonus attacco per %d sec. utilizzando Orb della spada	SA
TOOLTIP_USE_SKILL_NOEJEON_NEXT_COOLTIME_DECREASE_10PER	Tempo di ricarica Lancio di lampi: -%d sec. (10%% di chance )	SA
TOOLTIP_USE_SKILL_NOEJEON_NEXT_COOLTIME_DECREASE_20PER	Tempo di ricarica Lancio di lampi: -%d sec. (20%% di chance )	SA
TOOLTIP_USE_SKILL_PABEOB_STUN	Annullamento magia stordisce l'avversario (%d%% di chance)	SA
TOOLTIP_USE_SKILL_PAERYONG_HP_ABSORB	Assorbi %d%% HP utilizzando Ruggito del drago	SA
TOOLTIP_USE_SKILL_PALBANG_HP_ABSORB	Assorbi %d%% HP utilizzando Vortice di spada	SA
TOOLTIP_USE_SKILL_PASWAE_NEXT_COOLTIME_DECREASE_10PER	Tempo di ricarica Artiglio di lupo: -%d sec. (10%% di chance )	SA
TOOLTIP_USE_SKILL_PASWAE_NEXT_COOLTIME_DECREASE_20PER	Tempo di ricarica Artiglio di lupo: -%d sec. (20%% di chance )	SA
TOOLTIP_USE_SKILL_PASWAE_SP_ABSORB	Assorbi %d%% MP utilizzando Artiglio di lupo	SA
TOOLTIP_USE_SKILL_SALPOONG_NEXT_COOLTIME_DECREASE_10PER	Tempo di ricarica Respiro del lupo: -%d sec. (10%% di chance )	SA
TOOLTIP_USE_SKILL_SALPOONG_NEXT_COOLTIME_DECREASE_20PER	Tempo di ricarica Respiro del lupo: -%d sec. (20%% di chance )	SA
TOOLTIP_USE_SKILL_SAMYEON_NEXT_COOLTIME_DECREASE_10PER	Tempo di ricarica Taglio a tre vie: -%d sec. (10%% di chance )	SA
TOOLTIP_USE_SKILL_SAMYEON_NEXT_COOLTIME_DECREASE_20PER	Tempo di ricarica Taglio a tre vie: -%d sec. (20%% di chance )	SA
TOOLTIP_USE_SKILL_SAMYEON_STUN	Taglio a tre vie stordisce l'avversario (%d%% di chance)	SA
TOOLTIP_USE_SKILL_SANGONG_ATT_GRADE_BONUS	Bonus attacco per %d sec. utilizzando Nuvola velenosa	SA
TOOLTIP_USE_SKILL_SEOMJEON_KNOCKBACK	Veleno insidioso respinge gli avversari (%d%% di chance)	SA
TOOLTIP_USE_SKILL_SWAERYUNG_KNOCKBACK	Schiocco di dita respinge gli avversari (%d%% di chance)	SA
TOOLTIP_USE_SKILL_TERROR_ATT_GRADE_BONUS	Bonus attacco per %d sec. utilizzando Terrore	SA
TOOLTIP_USE_SKILL_TUSOK_HP_ABSORB	Assorbi %d%% HP utilizzando Colpo dello spirito	SA
TOOLTIP_USE_SKILL_YEONSA_HP_ABSORB	Assorbi %d%% HP utilizzando Tiro ripetuto	SA
TOOLTIP_USE_SKILL_YONGBI_HP_ABSORB	Assorbi %d%% HP utilizzando Tiro del drago	SA
TOOLTIP_USE_SKILL_YONGKWON_NEXT_COOLTIME_DECREASE_10PER	Tempo di ricarica Vortice del drago: -%d sec. (10%% di chance )	SA
TOOLTIP_USE_SKILL_YONGKWON_NEXT_COOLTIME_DECREASE_20PER	Tempo di ricarica Vortice del drago: -%d sec. (20%% di chance )	SA
TOOLTIP_WARRIOR	Guerriero
TOOLTIP_WEAPON	Arma
TOOLTIP_WOLFMAN	Lican
TOOLTIP_WRISTLET	Bracciale
UI_ACCEPT	Accetta
UI_BOLD_FONT	Tahoma:12b
UI_CANCEL	Interrompi
UI_CLOSE	Chiudi
UI_DEF_FONT	Tahoma:12
UI_DEF_FONT_LARGE	Tahoma:14
UI_DEF_FONT_SMALL	Tahoma:9
UI_DENY	Rifiuta
UI_ITEM	Oggetto
UI_LEFT_TIME	Tempo rimanente: %d sec.
UI_NEXT	Avanti
UI_NEXTPAGE	Continua
UI_NOCONTENTS	Nessun contenuto
UI_NONAME	Nessun nome
UI_OK	Ok
UI_POS_UNKNOWN	Luogo sconosciuto
UI_PREVPAGE	Indietro
UI_UNKNOWN	Sconosciuto
UNLIMIT_ENTER_CZ_QUESTION	Puoi entrare nel Tempio dello Zodiaco per %d min. Vuoi usarlo?
UPDATE_TIME	Data
UPLOAD_MARK_CHECK_NEED_RECONNECT	Rifai l'upload
UPLOAD_MARK_UPLOAD_NEED_RECONNECT	Rifai l'upload
USE_ITEM_BUTTON_01	Ritorna immediatamente
USE_ITEM_BUTTON_02	Entra
USE_ITEM_FAILURE_PRIVATE_SHOP	Non puoi usare degli oggetti se hai un negozio privato aperto.
USE_ITEM_POPUP_01	La Battaglia dei 5 Santuari è terminata. \n Prossima battaglia:
USE_ITEM_QUESTION_01	Vuoi partecipare alla Battaglia dei 5 Santuari?
USE_ITEM_QUESTION_02	Vuoi tornare nel punto in cui hai perso la vita?\n Ti costerà %s Yang.
USE_ITEM_QUESTION_03	Verrai teletrasportato in un punto a caso. Vuoi entrare?
USE_SKILL_ERROR_UNKNOWN	Errore abilità sconosciuto: %s
