ACCE_ABSORB_COST	Absorberrings pris: %d
ACCE_ALREADY_REGISTER	Denne genstand er allerede blevet brugt.
ACCE_DEL_ABSORDITEM	Absorber genstand, øde læg det i processen?
ACCE_DEL_SERVEITEM	Bånd 2 vil blive ødelagt hvis kombinationen fejler.
ACCE_DEL_SERVEITEM2	Bånd 2 vil blive ødelagt hvis kombinationen fejler.
ACCE_INITEM	Træk genstanden ind i vinduet.
ACCE_MAXGRADE	Dette er allerede blevet tilpasset.
ACCE_MAX_DRAINRATE	Maks. Absorberings Sats
ACCE_NOTABSORBITEM	Du kan ikke bruge et våben eller rustnings stykke som allerede er blevet absorberet.
ACCE_NOT_SEALITEM	Du kan ikke bruge en sjælebunden genstand.
ACCE_NOT_USINGITEM	Du kan ikke kombinere en genstand du bruger.
ACCE_NOT_WINDOWOPEN	Du kan ikke bruge genstanden når kombinerings vinduet er åbent.
ACCE_POSSIBLE_ACCE	Du kan kun bruge skulderbånd.
ACCE_POSSIBLE_ACCEITEM	Du kan kun uddrage bonusser fra våben og rustning.
AFF_LOVE_POINT	Kærlighedspoint: %d%%
ALIGNMENT_NAME	Rang:
ATTACK_ERROR_UNKNOWN	Ukendt angrebsfejl: %s
ATTENDANCE_REWARD_QUESTION	Vil du tage imod din belønning?
ATTR_6TH_7TH_ADD_QUESTION1	Du kan ikke bruge denne genstand mens en bonus bliver tilføjet.
ATTR_6TH_7TH_ADD_QUESTION2	Ønsker du virkelig at tilføje bonussen?
ATTR_6TH_7TH_CHANGE_FAIL	Du kan ikke ændre bonussen.
ATTR_6TH_7TH_DESC1	a. Du skal tilføje de nødvendige materialer til genstanden for at tilføje en 6. og 7. bonus.
ATTR_6TH_7TH_DESC2	b. Hvert krafts skår øger succesraten med 2%.
ATTR_6TH_7TH_DESC3	c. Brug et tilsætningsstof for at øge succesraten endnu mere.
ATTR_6TH_7TH_DESC4	d. Det tager 24 timer at tilføje en bonus. I løbet af denne tid, vil NPC beholde den genstand hvor bonussen bliver tilføjet. Så snart at processen er gennemført, kan du indsamle det igen.
ATTR_6TH_7TH_POSSIBILITY	Du kan tilføje en yderligere bonus.
ATTR_6TH_7TH_TOTAL_SUCCESS_PERCENT	Succesrate: %.1f%%
AURA_DRAIN_PER	Absorberings sats %.1f%%
AURA_EVOLUTION_GOLD	[Aura] Ikke nok Yang til at udvikle den.
AURA_IMPOSSIBLE_ABSORBITEM	[Aura] Overførte genstand kan ikke bruges.
AURA_IMPOSSIBLE_EQUIPITEM	[Aura] Udstyrede genstande kan ikke blive overført.
AURA_IMPOSSIBLE_EVOLUTION_ITEM	[Aura] Kan ikke blive udviklet.
AURA_IMPOSSIBLE_EVOLUTION_ITEMCOUNT	[Aura] Det nuværende antal genstande er ikke nok til at udvikle den.
AURA_IMPOSSIBLE_GROWTHITEM	[Aura] Kan ikke blive forbedret.
AURA_IMPOSSIBLE_REFINEITEM	[Aura] Kun Aura Outfit, Skjold, Halskæde, Ørering og Armbånd kan bruges.
AURA_IMPOSSIBLE_SEALITEM	[Aura] Sjælebundne genstande kan ikke blive overført.
AURA_ITEM_NEED_REGISTER	[Aura] Genstande skal blive indsat.
AURA_LEVEL_STEP	Lvl%d (Stadie %d)
AURA_MAX_LEVEL	[Aura] Aura Outfitet har nået det maksimale level.
AURA_NOTICE_DEL_ABSORDITEM	[Aura] Overførte genstand er blevet ødelagt.
AURA_OPEN_OTHER_WINDOW	Du kan ikke gøre dette mens vinduet til forbedring, udvikling eller overførelse af stats er åbent.
AURA_POSSIBLE_AURAITEM	[Aura] Kun Aura Outfit kan blive brugt.
AURA_POSSIBLE_REGISTER_AURAITEM	[Aura] Aura Outfit skal blive indsat først.
AURA_TITLE_ABSORB	Overfør værdierne over på Aura Outfit
AURA_TITLE_EVOLUTION	Udvikl Aura Outfit
AURA_TITLE_GROWTH	Forbedre Aura Outfit
AURA_TOOLTIP_EXP	EXP (%d%% / 100%%)
AURA_TOOLTIP_LEVEL	Lvl%d (Stadie %d) (Absorberings sats %.1f%%)
AURA_TOOLTIP_NEED_YANG	%s Yang
AURA_TOOLTIP_NEXT	Ny
AURA_TOOLTIP_NOW	Nuværende
AURA_TOOLTIP_RESOURCE	Forbrugsartikler
AURA_TOOLTIP_RESOURCE_ITEM	%s * %d
AUTO_TOOLTIP_LINE1	Færdigheder: Vælg færdigheder til kamp og træk dem over i bjælken. (Premium)
AUTO_TOOLTIP_LINE2	Tip: Du kan skifte aktiverings intervallet (i sekunderr) under hver færdighed.
AUTO_TOOLTIP_LINE3	Eliksirer: Vælg eliksirer til kamp og træk dem over i bjælken. (Premium)
AUTO_TOOLTIP_LINE4	Tip: HP og MP eliksirer vil blive aktiveret så snart niveauet falder under den % værdi under hver eliksir.
AUTO_TOOLTIP_LINE5	Tip: Varigheden af andre eliksirer er vist i sekunder.
AUTO_TOOLTIP_TITLE	Auto-Jagt hjælp
BATTLE_POINT	Kamp Point
BEAD	Animasphere
BEAD_TIME_REMAINING_TO_GET	Animasphere opladt om: %d min.
BNW_COIN	Seer Mønt
BUY_LIMIT_LEVEL	Købs grænse: %s
CANNOT_ATTACK_DEST_IN_SAFE	Afstanden til fjenden er for stor.
CANNOT_ATTACK_SELF_IN_SAFE	Jeg kan ikke angribe fjenden herfra.
CANNOT_EQUIP_IN_EXCHANGE	Du kan ikke skifte din udrustning mens du handler.
CANNOT_EQUIP_IN_SHOP	Du kan ikke skifte din udrustning mens du handler.
CANNOT_OPEN_PRIVATE_SHOP_IN_SAFE_AREA	Du kan ikke åbne en privat butik på et offentligt areal.
CANNOT_SHOOT_DEST_IN_SAFE	Afstanden til fjenden er for stor.
CANNOT_SHOOT_EMPTY_ARROW	Jeg har brug for en pil.
CANNOT_SHOOT_SELF_IN_SAFE	Jeg kan ikke angribe fjenden herfra.
CANNOT_SKILL_APPROACH	Jeg er sikker på, at jeg ikke kan komme tættere på.
CANNOT_SKILL_ATTACK	Det kan jeg ikke angribe.
CANNOT_SKILL_BLUE	Du kan ikke bruge Indigo Ulve sjæl når højrød Ulve sjæl er aktiveret.
CANNOT_SKILL_DEST_IN_SAFE	Afstanden til fjenden er for stor.
CANNOT_SKILL_EQUIP_FISHING_ROD	Du kan ikke fiske uden en udstyret fiskestang.
CANNOT_SKILL_HAVE_TO_RIDE	Jeg har brug for en hest for at kunne anvende det.
CANNOT_SKILL_NEED_EMPTY_BOTTLE	Jeg har ingen tom flaske.
CANNOT_SKILL_NEED_POISON_BOTTLE	Jeg har ingen giftflaske.
CANNOT_SKILL_NEED_TARGET	Hvem er målet?
CANNOT_SKILL_NOT_ENOUGH_HP	Jeg har ikke nok HP!
CANNOT_SKILL_NOT_ENOUGH_SP	Jeg har ikke nok MP!
CANNOT_SKILL_NOT_HORSE_SKILL	Jeg kan ikke bruge det, mens jeg ridder.
CANNOT_SKILL_NOT_MATCHABLE_WEAPON	Denne færdighed kan jeg ikke bruge med mit våben.
CANNOT_SKILL_NOT_YET_LEARN	Denne færdighed har jeg ikke lært.
CANNOT_SKILL_ONLY_FOR_ALLIANCE	Det virker kun på gruppemedlemmer.
CANNOT_SKILL_ONLY_FOR_CORPSE	Det virker kun på døde.
CANNOT_SKILL_RED	Du kan ikke bruge højrød ulve sjæl når Indigo Ulve sjæl er aktiveret.
CANNOT_SKILL_REMOVE_FISHING_ROD	Denne færdighed kan jeg ikke bruge med en fiskestang.
CANNOT_SKILL_SELF_IN_SAFE	Jeg kan ikke angribe fjenden herfra.
CANNOT_SKILL_USE_SELF	Jeg kan ikke bruge det på mig selv.
CANNOT_SKILL_WAIT_COOLTIME	Denne færdighed er ikke klar.
CANNOT_USE	Du kan ikke bruge denne.
CANNOT_WHISPER_DEST_REFUSE	%s har blokeret hvisken.	SA
CANNOT_WHISPER_NOT_LOGON	%s er ikke online.	SA
CANNOT_WHISPER_SELF_REFUSE	Du kan ikke hviske med nogen, når du selv har blokeret for hvisken.	SNA
CATEGORY_ARMOR_ARMOR_BODY	Rustning
CATEGORY_ARMOR_ARMOR_HEAD	Hjelme
CATEGORY_ARMOR_ARMOR_SHIELD	Skjolde
CATEGORY_COSTUMES	Kostumer
CATEGORY_COSTUMES_COSTUME_BODY	Kostumer
CATEGORY_COSTUMES_COSTUME_HAIR	Frisurer
CATEGORY_COSTUMES_COSTUME_WEAPON	Våbenskin
CATEGORY_COSTUMES_ETC	Andet
CATEGORY_COSTUMES_SASH	Skulder Bånd
CATEGORY_DRAGON_STONE	Dragesten alkymi
CATEGORY_DRAGON_STONE_DRAGON_DIAMOND	Diamant
CATEGORY_DRAGON_STONE_DRAGON_GARNET	Granat
CATEGORY_DRAGON_STONE_DRAGON_JADE	Jade
CATEGORY_DRAGON_STONE_DRAGON_ONYX	Onyx
CATEGORY_DRAGON_STONE_DRAGON_RUBY	Rubin
CATEGORY_DRAGON_STONE_DRAGON_SAPPHIRE	Safir
CATEGORY_DRAGON_STONE_ETC	Andet
CATEGORY_EQUIPMENT_ARMOR	Udrustning
CATEGORY_EQUIPMENT_JEWELRY	Smykker
CATEGORY_EQUIPMENT_WEAPON	Våben
CATEGORY_ETC	Andet
CATEGORY_ETC_ETC	Andet
CATEGORY_ETC_EVENT	Event Genstande
CATEGORY_ETC_GIFTBOX	Kister | Bokse
CATEGORY_ETC_MATRIMORY	Gift
CATEGORY_ETC_PARTI	Krigens Kunst Bøger
CATEGORY_ETC_POLYMORPH	Forvandlingskugler
CATEGORY_ETC_RECIPE	Drik Fremstilling
CATEGORY_ETC_SEAL	Sjælebinding
CATEGORY_FISHING_PICK	Fiske | Mine
CATEGORY_FISHING_PICK_EQUIPMENT_PICK	Hakker
CATEGORY_FISHING_PICK_ETC	Andet
CATEGORY_FISHING_PICK_FISHING_POLE	Fiskestænger
CATEGORY_FISHING_PICK_FOOD	Fisk
CATEGORY_FISHING_PICK_PICK_BOOK	Minedrift Bøger
CATEGORY_FISHING_PICK_STONE	Malm
CATEGORY_JEWELRY_ARMOR_EAR	Øreringe
CATEGORY_JEWELRY_ARMOR_FOOTS	Sko
CATEGORY_JEWELRY_ARMOR_NECK	Halskæder
CATEGORY_JEWELRY_ARMOR_PENDANT	Talisman
CATEGORY_JEWELRY_ARMOR_WRIST	Armbånd
CATEGORY_JEWELRY_ITEM_BELT	Belter
CATEGORY_MOUNT_PET	Ganger | Kæledyr
CATEGORY_MOUNT_PET_CHARGED_PET	Kæledyr
CATEGORY_MOUNT_PET_EGG	Kæledyrs Æg
CATEGORY_MOUNT_PET_FREE_PET	Udviklings Kæledyr
CATEGORY_MOUNT_PET_MOUNT	Gangere
CATEGORY_POTION	Drikke
CATEGORY_POTION_ABILITY	Forbrugsgenstande
CATEGORY_POTION_ETC	Andet
CATEGORY_POTION_HAIRDYE	Hårfarve
CATEGORY_SKILL	Færdigheder
CATEGORY_SKILL_BOOK_OF_OBLIVION	Glemsomhedens Bøger
CATEGORY_SKILL_ETC	Andet
CATEGORY_SKILL_PAHAE	Beskyttelse | Boost
CATEGORY_SKILL_SKILL_BOOK	Færdighedsbøger
CATEGORY_TUNING	Opgraderinger
CATEGORY_TUNING_ETC	Andet
CATEGORY_TUNING_RESOURCE	Materialer
CATEGORY_TUNING_STONE	Åndesten
CATEGORY_UNIQUE	Specielle Genstande
CATEGORY_UNIQUE_ABILITY	Forbrugsgenstande
CATEGORY_UNIQUE_ETC	Andet
CATEGORY_WEAPON_WEAPON_ARROW	Pile
CATEGORY_WEAPON_WEAPON_BELL	Klokker
CATEGORY_WEAPON_WEAPON_BOW	Buer
CATEGORY_WEAPON_WEAPON_CLAW	Kløer
CATEGORY_WEAPON_WEAPON_DAGGER	Daggerter
CATEGORY_WEAPON_WEAPON_FAN	Vifter
CATEGORY_WEAPON_WEAPON_MOUNT_SPEAR	Spyd
CATEGORY_WEAPON_WEAPON_QUIVER	Kogger
CATEGORY_WEAPON_WEAPON_SWORD	Et-hånds Våben
CATEGORY_WEAPON_WEAPON_TWO_HANDED	To-hånds Våben
CHANGE_ALREADY_REGISTER	[Transmutation] Denne genstand er allerede tilføjet.
CHANGE_LOOK_CHANGE_ITEM	Ønsker du at transmutere denne genstand?
CHANGE_LOOK_CHECK_OUT_REGISTER_ITEM	[Transmutation] Fjern venligst først den genstand som du ønsker at transmutere.
CHANGE_LOOK_COST	Pris på transmutation: %s Yang
CHANGE_LOOK_DEL_ITEM	Den absorberede genstand vil blive slettet.
CHANGE_LOOK_DO_NOT_CHANGE_LOOK_ITEM	[Transmutation] Denne genstand kan ikke transmuteres.
CHANGE_LOOK_DO_NOT_EQUIP_ITEM	[Transmutation] Du kan ikke transmutere en genstand mens den bæres.
CHANGE_LOOK_DO_NOT_REGISTER_ITEM	[Transmutation] Du kan ikke tilføje denne genstand.
CHANGE_LOOK_DO_NOT_SEAL_ITEM	[Transmutation] Denne genstand er sjælebunden.
CHANGE_LOOK_INSERT_CHANGE_LOOK_ITEM	[Transmutation] Tilføj venligst den genstand som du ønsker at transmutere.
CHANGE_LOOK_INSERT_ITEM	[Transmutation] Du skal tilføje genstanden først.
CHANGE_LOOK_NEED_MONEY	Du har enten ikke nok Yang, eller ikke nok genstande.
CHANGE_LOOK_OPEN_OTHER_WINDOW	[Transmutation] Denne handling er ikke mulig mens Transmutation vinduet er åbent.
CHANGE_LOOK_TITLE	Transmutation
CHANGE_LOOK_TITLE2	Ganger Transformation
CHANGE_PET_PLEASE_APPEND_FIRST	Kæledyret skal være valgt først.
CHANGE_TOOLTIP2_LINE1	Tilføj mål genstanden til venstre og materialet til højre.
CHANGE_TOOLTIP2_LINE2	Klik på feltet for at bruge Yang, eller en Transformations Polet og ændre din gangers udseende.
CHANGE_TOOLTIP2_LINE3	Ved at bruge en Transformations Polet, ændre det din gangers udseende uden det koster noget Yang (dette bruger poletten).
CHANGE_TOOLTIP2_LINE4	Hvis man ændre på en gangers udseende med en varighed, så forbliver gangerens varighed uændret.
CHANGE_TOOLTIP2_LINE5	Hvis mål gangeren er permanent og den materiale ganger har en varighed, vil gangeren have den ændrede udseende så længe den materiale ganger varer.
CHANGE_TOOLTIP_LINE1	Placer den genstand du ønsker til transmutere i venstre side.
CHANGE_TOOLTIP_LINE2	Placer den anden genstand i højre side.
CHANGE_TOOLTIP_LINE3	Udseendet på genstanden i venstre side vil ændres.
CHANGE_TOOLTIP_LINE4	så snart du bekræfter transmutationen (V) og betaler med Yang.
CHANGE_TOOLTIP_LINE5	Brug af denne genstand tillader dig
CHANGE_TOOLTIP_LINE6	at transmutere din genstand uden at bruge Yang.
CHANGE_TOOLTIP_TITLE	Transmutation
CHANNEL	Kanal
CHANNELING_CANNOT_LOGOUT	Du kan ikke gå tilbage til startskærmen.
CHANNEL_EMPTY_SERVER	Ingen server
CHANNEL_NORMAL	Kanal %d
CHANNEL_NOTIFY_FULL	Denne kanal er fyldt. Vælg venligst en anden.
CHANNEL_NOT_FIND_INFO	Du får ingen kanal-informationer.
CHANNEL_PVP	Fri duel
CHANNEL_SELECT_CHANNEL	Vælg en kanal
CHANNEL_SELECT_REGION	Vælg området for regningen
CHANNEL_SELECT_SERVER	Vælg server
CHANNEL_STATUS_BUSY	Optaget
CHANNEL_STATUS_FULL	Fyldt
CHANNEL_STATUS_OFFLINE	Ukendt
CHANNEL_STATUS_RECOMMENDED	Anbefalet
CHANNEL_STATUS_VACANT	Lav
CHANNEL_TEST_SERVER	Test server
CHANNEL_TEST_SERVER_ADDR	Test %s:%d
CHARACTER_CREATE_MODE	Opret karakter
CHARACTER_NAME	Navn
CHARACTER_SELECT_MODE	Vælg karakter
CHARGE_BEAD_QUESTION	Animasphere krævet: %d. Ønsker du at fortsætte?
CHAT_ALL	Alle
CHAT_BLOCK	Bloker
CHAT_DICE_INFO	Kast
CHAT_GUILD	Orden
CHAT_INFORMATION	Info
CHAT_INSULT_STRING	Sætningen indeholder spærrede ord.
CHAT_LOG	Vis gamle meddelelser [L]
CHAT_LOG_TITLE	Chat-log
CHAT_NORMAL	Normal
CHAT_NOTICE	Server
CHAT_PARTY	Gruppe
CHAT_SEND_CHAT	Send chat
CHAT_SEND_MEMO	Send hvisken [Shift+Enter]
CHAT_SHOUT	Råbe
CHAT_SHOUT_LIMIT	Du kan kun råbe alle 15 sekunder.
CHAT_WHISPER	Hviske
CHEQUE_SYSTEM_DO_NOT_DROP_MONEY	Du kan ikke smide penge.
CHEQUE_SYSTEM_PICK_WON	Du har modtaget %s Won.
CHEQUE_SYSTEM_SELL_PRICE	[Salgspris]
CHEQUE_SYSTEM_UNIT_WON	Won
CHEQUE_SYSTEM_UNIT_YANG	Yang
CHEQUE_SYSTEM_WON	%s Won
CHEQUE_SYSTEM_YANG	%s Yang
CLEAR_FLOOR	Level
CLEAR_TIME	Tid
ClosePetChangeWndButton	Luk
COMB_ACCE_IS_CONTINUE_PROCESS	Ønsker du at fortsætte?
COMB_ACCE_WARNING_MESSAGE	Kilden vil blive ødelagt på fuld eller delvis succes. Overførslen kan mislykkes. Mål genstandendes absorberings sats vil blive reduceret ved en delvis succes eller hvis det mislykkes.
COMB_ACCE_WARNING_MESSAGE1	Kilden vil blive ødelagt på fuld eller delvis succes.
COMB_ACCE_WARNING_MESSAGE2	Overførslen kan mislykkes.
COMB_ACCE_WARNING_MESSAGE3	Mål genstandendes absorberings sats vil blive reduceret ved en delvis succes eller hvis det mislykkes.
COMB_ACCE_WILL_REMOVE_MATERIAL	Kilden vil blive ødelagt på fuld eller delvis succes.
COMB_ALREADY_APPEND	Denne genstand er allerede blevet valgt.
COMB_CANT_APPEND_ITEM	Denne genstand kan ikke bruges.
COMB_CANT_APPEND_SEALED_ITEM	Du kan ikke bruge en sjælebunden genstand.
COMB_CANT_BASE_ITEM	En skærf som allerede har en bonus, kan ikke blive brugt som mål.
COMB_CANT_MATCH_DRAINRATE	Absorberings satsen for begge genstande skal være den samme til en bonus overførsel.
COMB_CANT_MATCH_GRADE	Karakteren for begge genstande skal være den samme til en bonus overførsel.
COMB_CANT_MATERIAL_ITEM	Kilde genstanden skal have en bonus.
COMB_COST	Pris: %s
COMB_IS_CONTINUE_PROCESS	Ønsker du at fortsætte?
COMB_NOTICE	Du kan ikke åbne en privat shop mens du bytter bøger.
COMB_NOTICE_NOT_OPEN	Du kan ikke bytte bøger mens du har en privat shop åben.
COMB_NOT_ALL_SLOT_APPEND_ITEM	Du skal bruge en kilde og mål genstand, plus overførelses genstanden for at overføre bonusser.
COMB_NOT_FULL_BOOK	Nej, vi kan ikke gøre forretning på denne måde. Som jeg allerede fortalte dig, så er jeg kun klar på at bytte hvis du giver mig 10 bøger igen.
COMB_NOT_ITEM_IN_INVENTORY	Du kan ikke aktivere genstande der er i brug.
COMB_NOT_MEDIUM_ITEM	Denne genstand kan ikke bruges.
COMB_WILL_REMOVE_MATERIAL	Kilde genstanden vil blive ødelagt ved succes.
CREATE_ERROR_GM_NAME	Dit karakternavn må ikke indeholde "GM".
CREATE_ERROR_INSULT_NAME	Dette navn er ikke tilladt.
CREATE_ERROR_LIMIT_LEVEL	Din karakter skal mindst være level 80.
CREATE_ERROR_TIME_LIMIT	Du kan kun oprette en karakter per 30 sekunder.
CREATE_ERROR_WRONG_STRING	Dette karakter navn er ikke tilladt.
CREATE_EXIST_SAME_NAME	En anden karakter har allerede dette navn.
CREATE_FAILURE	Du kan ikke oprette denne karakter.
CREATE_FULL	Du kan ikke oprette flere karakterer.
CREATE_GM_NAME	GM
CREATE_INPUT_NAME	Vælg et navn
CREATE_PLUS_STAT	Du har stadig nogle status-points.
CUBE_CATEGORY_ACCESSORY	Smykker
CUBE_CATEGORY_ARMOR	Rustning
CUBE_CATEGORY_BELT	Bælter
CUBE_CATEGORY_ETC	Osv.
CUBE_CATEGORY_EVENT	Event
CUBE_CATEGORY_WEAPON	Våben
CUBE_MAKE_CONFIRM_QUESTION_1	Mindst en af genstandene der bliver brugt, er af høj værdi (har mere end %d bonusser).
CUBE_MAKE_CONFIRM_QUESTION_2	Ønsker du virkelig at fortsætte?
CUBE_NOT_ENOUGH_GOLD	Ikke nok Yang til at skabe.
CUBE_NOT_ENOUGH_MATERIAL	Ikke nok materialer til at skabe.
CUBE_PLEASE_SELECT	Der er ikke blevet valgt nogen genstande.
CZ_REWARD_QUESTION_COMPLETE	Ønsker du at indløse denne plads?
CZ_REWARD_TOOLTIP_10GAN	Zodiac Emblem
CZ_REWARD_TOOLTIP_10GAN_COUNT	Antal i inventar
CZ_REWARD_TOOLTIP_10GAN_NEED_COUNT	Nødvendig mængde
CZ_REWARD_TOOLTIP_12ZI	Vagt Emblem
CZ_REWARD_TOOLTIP_12ZI_COUNT	Antal i inventar
CZ_REWARD_TOOLTIP_12ZI_NEED_COUNT	Nødvendig mængde
CZ_REWARD_TOOLTIP_ALL_BOX	Astral Skat
CZ_REWARD_TOOLTIP_CAN_GET_ALL_BOX	Klik her for at indsamle din Astralske Skat som belønning.
CZ_REWARD_TOOLTIP_CAN_GET_GREEN_BOX	Klik her for at indsamle din Aventurinske Skat som belønning.
CZ_REWARD_TOOLTIP_CAN_GET_YELLOW_BOX	Klik her for at indsamle din Aureolinske Skat som belønning.
CZ_REWARD_TOOLTIP_COMPLETABLE	Indløs
CZ_REWARD_TOOLTIP_GREEN_BOX	Aventurin Skat
CZ_REWARD_TOOLTIP_GREEN_BOX_COMP_CNT	Indløst Aventurinske Skatte: %d
CZ_REWARD_TOOLTIP_WEEKLY	Dag
CZ_REWARD_TOOLTIP_WEEKLY_FRI	Fredag
CZ_REWARD_TOOLTIP_WEEKLY_MON	Mandag
CZ_REWARD_TOOLTIP_WEEKLY_SAT	Lørdag
CZ_REWARD_TOOLTIP_WEEKLY_SAT_SUN	Lørdag/Søndag
CZ_REWARD_TOOLTIP_WEEKLY_THU	Torsdag
CZ_REWARD_TOOLTIP_WEEKLY_TUE	Tirsdag
CZ_REWARD_TOOLTIP_WEEKLY_WED	Onsdag
CZ_REWARD_TOOLTIP_YELLOW_BOX	Aureolin Skat
CZ_REWARD_TOOLTIP_YELLOW_BOX_COMP_CNT	Indløst Aureolinske Skatte: %d
DAY	d
DETAILS_1	Stæ. vs Halv Mennes.
DETAILS_10	Stæ. vs Ørken Monst.
DETAILS_11	Stæ. vs Insekter
DETAILS_12	Angrebsværdi
DETAILS_13	Forsvarsværdi
DETAILS_14	Gennemsnitlig Skade
DETAILS_15	Gennemsni. Skd. Mod.
DETAILS_16	Færdigheds Skade
DETAILS_17	Færdigheds Skade Modstand
DETAILS_18	Magi/Nærkamps Angreb
DETAILS_19	Magisk Angreb
DETAILS_2	Mod. im. Halv Menne.
DETAILS_20	Kritisk Slag Chance
DETAILS_21	Gennemborende Træf
DETAILS_22	Kritisk Slag Mods.
DETAILS_23	Gennembo. Træf Mods.
DETAILS_24	Lynmodstand
DETAILS_25	Is Modstand
DETAILS_26	Mørke Modstand
DETAILS_27	Ild Modstand
DETAILS_28	Luft Modstand
DETAILS_29	Jord Modstand
DETAILS_3	Stærk imod Orker
DETAILS_30	Lynets Kraft
DETAILS_31	Isens Kraft
DETAILS_32	Mørkets Kraft
DETAILS_33	Ildens Kraft
DETAILS_34	Vindens Kraft
DETAILS_35	Jordens Kraft
DETAILS_36	Stærk imod Krigere
DETAILS_37	Stærk imod Ninjaer
DETAILS_38	Stærk imod Suraer
DETAILS_39	Stærk imod Shamaner
DETAILS_4	Stærk imod Udøde
DETAILS_40	Stærk imod Lycaner
DETAILS_41	Forsvar vs Krigere
DETAILS_42	Forsvar vs Ninjaer
DETAILS_43	Forsvar vs Suraer
DETAILS_44	Forsvar vs Shamaner
DETAILS_45	Forsvar vs Lycaner
DETAILS_46	Sværd Forsvar
DETAILS_47	To-hånds Forsvar
DETAILS_48	Dolk Forsvar
DETAILS_49	Klo Forsvar
DETAILS_5	Stærk imod Monstre
DETAILS_50	Klokkeforsvar
DETAILS_51	Vifteforsvar
DETAILS_52	Pil Forsvar
DETAILS_53	Besvimelses Chance
DETAILS_54	Sløv Chance
DETAILS_55	Gift Chance
DETAILS_56	Gift Modstand
DETAILS_57	Blødnings Angreb
DETAILS_58	Blødning Angreb Mod.
DETAILS_59	Stjæl HP
DETAILS_6	Stæ. vs Zodiac Mon.
DETAILS_60	Stjæl MP
DETAILS_61	HP Gendannelse
DETAILS_62	MP Gendannelse
DETAILS_63	Bloker Angreb
DETAILS_64	Undgå Pil Angreb
DETAILS_65	Ref. Nærkamps Angreb
DETAILS_66	HP Gendan. på Drab
DETAILS_67	MP Gendan. på Drab
DETAILS_68	Dobbelt EXP
DETAILS_69	Dobbelt Yang
DETAILS_7	Stærk imod Dyr
DETAILS_70	Drop Sandsynlighed
DETAILS_71	Angrebsværdi
DETAILS_72	Forsvarsværdi
DETAILS_73	EXP
DETAILS_74	Drop Sandsynlighed
DETAILS_75	Dobbelt Yang
DETAILS_76	Magi Modstand
DETAILS_77	Anti-Magi
DETAILS_8	Stærk vs Esoterikere
DETAILS_9	Stærk imod Djævle
DETAILS_ATTBONUS_BELL	Klokke brud
DETAILS_ATTBONUS_BOW	Pil brud
DETAILS_ATTBONUS_CLAW	Klo brud
DETAILS_ATTBONUS_DAGGER	Dolk brud
DETAILS_ATTBONUS_FAN	Vifte brud
DETAILS_ATTBONUS_SWORD	Sværd brud
DETAILS_ATTBONUS_TWOHAND	To-hånds brud
DETAILS_CATE_1	Skade/Forsvar
DETAILS_CATE_2	Elementær bonus
DETAILS_CATE_3	Klasse bonus
DETAILS_CATE_4	Våben bonus
DETAILS_CATE_5	Anden bonus
DETAILS_CATE_6	Special bonus
DETAILS_RESIST_MOUNT_FALL	Falds modstand
DETAILS_TITLE	Detaljer
DETAILS_TOOLTIP_1	Stærke imod Halv Mennesker: Giver tungere skade imod Halv Mennesker.
DETAILS_TOOLTIP_10	Stærke imod Ørken Monstre: Giver tungere skade imod ørken monstre.
DETAILS_TOOLTIP_11	Stærke imod Insekter: Giver tungere skade imod insekter.
DETAILS_TOOLTIP_12	Øger din angrebsværdi.
DETAILS_TOOLTIP_13	Øger din forsvarsværdi.
DETAILS_TOOLTIP_14	Øger den gennemsnitlige skade du giver imod fjender på et angreb.
DETAILS_TOOLTIP_15	Modstand imod gennemsnitlig skade: reducerer den skade du tager på et angreb.
DETAILS_TOOLTIP_16	Øger skaden der gives med en færdighed.
DETAILS_TOOLTIP_17	Modstand imod færdigheds skade: Reducerer skaden der gives mod dig med en færdighed.
DETAILS_TOOLTIP_18	Øger både din fysiske og magiske angrebsværdi.
DETAILS_TOOLTIP_19	Øger den skade du giver imod fjender på et magisk angreb.
DETAILS_TOOLTIP_2	Modstand imod Halv Mennesker: Reducerer den skade du tager fra Halv Mennesker.
DETAILS_TOOLTIP_20	Øger chancen for at lave et kritisk slag.
DETAILS_TOOLTIP_21	Sandsynlighed for gennemborende træf: Øger chancen for at lave et gennemborende træf.
DETAILS_TOOLTIP_22	Kritisk slag modstand: Reducerer skaden der påføres af et kritisk slag.
DETAILS_TOOLTIP_23	Gennemborende træf modstand: Reducerer skaden der påføres af et gennemborende træf.
DETAILS_TOOLTIP_24	Reducerer den skade du tager fra nogen monstre.
DETAILS_TOOLTIP_25	Reducerer den skade du tager fra nogen monstre.
DETAILS_TOOLTIP_26	Mørke modstand: Reducerer den skade du tager fra nogen monstre.
DETAILS_TOOLTIP_27	Reducerer den skade du tager fra nogen monstre.
DETAILS_TOOLTIP_28	Reducerer den skade du tager fra nogen monstre.
DETAILS_TOOLTIP_29	Reducerer den skade du tager fra nogen monstre.
DETAILS_TOOLTIP_3	Stærke imod Orker: Giver tungere skade imod orker.
DETAILS_TOOLTIP_30	Øger den skade du forvolder igennem lynets kraft.
DETAILS_TOOLTIP_31	Øger den skade du forvolder igennem isens kraft.
DETAILS_TOOLTIP_32	Øger den skade du forvolder igennem mørkets kraft.
DETAILS_TOOLTIP_33	Øger den skade du forvolder igennem ildens kraft.
DETAILS_TOOLTIP_34	Øger den skade du forvolder igennem vindens kraft.
DETAILS_TOOLTIP_35	Øger den skade du forvolder igennem jordens kraft.
DETAILS_TOOLTIP_36	Stærke imod Krigere: Giver tungere skade imod krigere.
DETAILS_TOOLTIP_37	Stærke imod Ninjaer: Giver tungere skade imod ninjaer.
DETAILS_TOOLTIP_38	Stærke imod Suraer: Giver tungere skade imod suraer.
DETAILS_TOOLTIP_39	Stærke imod Shamaner: Giver tungere skade imod shamaner.
DETAILS_TOOLTIP_4	Stærke imod Udøde: Giver tungere skade imod udøde.
DETAILS_TOOLTIP_40	Stærke imod Lycaner: Giver tungere skade imod lycaner.
DETAILS_TOOLTIP_41	Forsvars chance imod kriger angreb: Reducerer den skade du tager fra krigere.
DETAILS_TOOLTIP_42	Forsvars chance imod ninja angreb: Reducerer den skade du tager fra ninjaer.
DETAILS_TOOLTIP_43	Forsvars chance imod sura angreb: Reducerer den skade du tager fra suraer.
DETAILS_TOOLTIP_44	Forsvars chance imod shaman angreb: Reducerer den skade du tager fra shamaner.
DETAILS_TOOLTIP_45	Forsvars chance imod lycan angreb: Reducerer den skade du tager fra lycaner.
DETAILS_TOOLTIP_46	Reducerer skaden der uddeles med et sværd.
DETAILS_TOOLTIP_47	Reducerer skaden der uddeles med et to-hånds våben.
DETAILS_TOOLTIP_48	Reducerer skaden der uddeles med en dolk.
DETAILS_TOOLTIP_49	Reducerer skaden der uddeles med en klo.
DETAILS_TOOLTIP_5	Stærke imod Monstre: Giver tungere skade imod monstre.
DETAILS_TOOLTIP_50	Reducerer skaden der uddeles med en klokke.
DETAILS_TOOLTIP_51	Reducerer skaden der uddeles med en vifte.
DETAILS_TOOLTIP_52	Reducerer skaden der uddeles med buer og pile.
DETAILS_TOOLTIP_53	Øger chancen for at slå en modstander ud.
DETAILS_TOOLTIP_54	Øger chancen for at sløve en modstander.
DETAILS_TOOLTIP_55	Øger chancen for at forgifte en fjende.
DETAILS_TOOLTIP_56	Reducerer skaden der uddeles med gift.
DETAILS_TOOLTIP_57	Øger chancen for at lave et blødnings angreb.
DETAILS_TOOLTIP_58	Modstand imod blødnings angreb: Reducerer skaden der uddeles med et blødnings angreb.
DETAILS_TOOLTIP_59	Dræner din fjendes HP når du slår dem.
DETAILS_TOOLTIP_6	Stærke imod Zodiac Monstre: Giver tungere skade imod Zodiac monstre.
DETAILS_TOOLTIP_60	Dræner din fjendes MP når du slår dem.
DETAILS_TOOLTIP_61	Øger gendannelsen af dine angrebspoint.
DETAILS_TOOLTIP_62	Øger gendannelsen af dine fortryllelses point.
DETAILS_TOOLTIP_63	Sandsynligheden for at blokere et nærkamps angreb: Øger chancen for at undgå et nærkamps angreb.
DETAILS_TOOLTIP_64	Sandsynligheden for at undgå et pil angreb: Øger chancen for at undgå en pil eller varieret angreb fra en monster.
DETAILS_TOOLTIP_65	Sandsynligheden for at reflektere nærkamps slag: En del af fjendens nærkamps skade bliver reflekteret tilbage på dem.
DETAILS_TOOLTIP_66	HP gendannelse ved drab: Dine angrebspoint øges når du dræber en fjende.
DETAILS_TOOLTIP_67	MP gendannelse ved drab: Dine fortryllelses point øges når du dræber en fjende.
DETAILS_TOOLTIP_68	Sandsynligheden for at få dobbelt erfaring: Øger chancen for at få en EXP bonus når du besejrer din modstander.
DETAILS_TOOLTIP_69	Sandsynlighed for at smide dobbelt Yang: Øger chancen for at modtage dobbelt så meget Yang.
DETAILS_TOOLTIP_7	Stærke imod Dyr: Giver tungere skade imod vilde dyr.
DETAILS_TOOLTIP_70	Sandsynlighed for at smide genstande: Øger chancen for at plyndre dobbelt så mange genstande.
DETAILS_TOOLTIP_71	Øger din angrebsværdi.
DETAILS_TOOLTIP_72	Øger din forsvarsværdi.
DETAILS_TOOLTIP_73	Øger indsamlingen af erfaring.
DETAILS_TOOLTIP_74	Genstands drop chance: Øger sandsynligheden for plyndring af genstande.
DETAILS_TOOLTIP_75	Yang drop chance: Øger sandsynligheden for plyndring af mere Yang.
DETAILS_TOOLTIP_76	Reducerer den skade du tager fra et magisk angreb.
DETAILS_TOOLTIP_77	Reducerer fjendens magi modstand.
DETAILS_TOOLTIP_8	Stærke imod Esoterikere: Giver tungere skade imod esoterikere.
DETAILS_TOOLTIP_9	Stærke imod Djævle: Giver tungere skade imod djævle.
DETAILS_TOOLTIP_ATTBONUS_BELL	Klokke forsvars brud: Reducerer din modstanders klokke forsvar.
DETAILS_TOOLTIP_ATTBONUS_BOW	Pil forsvars brud: Reducerer din modstanders pil forsvar.
DETAILS_TOOLTIP_ATTBONUS_CLAW	Klo forsvars brud: Reducerer din modstanders klo forsvar.
DETAILS_TOOLTIP_ATTBONUS_DAGGER	Dolk forsvars brud: Reducerer din modstanders dolk forsvar.
DETAILS_TOOLTIP_ATTBONUS_FAN	Vifte forsvars brud: Reducerer din modstanders vifte forsvar.
DETAILS_TOOLTIP_ATTBONUS_SWORD	Sværd forsvars brud: Reducerer din modstanders sværd forsvar.
DETAILS_TOOLTIP_ATTBONUS_TWOHAND	To-hånds forsvars brud: Reducerer din modstanders to-hånds forsvar.
DETAILS_TOOLTIP_RESIST_MOUNT_FALL	Falds modstand: Reducerer din chance for at falde fra din ganger.
DONT_USE_ITEM_WHEN_SHOW_CONFIRM	Du kan ikke fjerne en genstand når der er en forespørgsel igang.
DO_NOT_INSERT_UPBRINGING_PET	Det aktive kæledyr kan ikke blive valgt.
DO_YOU_BUY_ITEM1	Vil du købe %s for %s Yang?
DO_YOU_BUY_ITEM2	Vil du købe %s (%s styk) for %s Yang?
DO_YOU_BUY_ITEM3	Ønsker du at købe %s for %s Won og %s Yang?
DO_YOU_BUY_ITEM4	Ønsker du at købe %s (%s styk) for %s Won og %s Yang?
DO_YOU_DROP_MONEY	Vil du smide %d Yang væk?
DO_YOU_SELL_ITEM1	Vil du sælge %s for %s Yang?
DO_YOU_SELL_ITEM2	Vil du sælge %s (%s styk) for %s Yang?
DRAGON_SOUL_CANNOT_REFINE	Denne drage sten kan ikke blive forædlet.
DRAGON_SOUL_CANNOT_REFINE_MORE	Denne drage sten har allerede nået det højeste level.
DRAGON_SOUL_EQUIP_WARNING1	Det er svært at fjerne en drage sten, når den først er tilføjet.
DRAGON_SOUL_EQUIP_WARNING2	Vil du stadig gerne fortsætte?
DRAGON_SOUL_EXPIRED	Udløbet drage sten
DRAGON_SOUL_INVALID_DRAGON_SOUL	Det er den forkerte drage sten.
DRAGON_SOUL_IS_NOT_DRAGON_SOUL	Det er ikke en drage sten.
DRAGON_SOUL_NOT_DRAGON_SOUL_REFINE_STONE	Dette er ikke den rigtige drage sten.
DRAGON_SOUL_NOT_ENOUGH_MATERIAL	Du har ikke materialer nok til forædlingen.
DRAGON_SOUL_NOT_ENOUGH_MATERIAL2	Til din %s\nskal du bruge: %s %dx
DRAGON_SOUL_NOT_ENOUGH_MONEY	Du har ikke nok Yang til at ændre bonussen.
DRAGON_SOUL_NOT_MATCHED_SLOT	Denne drage sten passer ikke til denne plads.
DRAGON_SOUL_STEP_LEVEL1	Klarhed: mat,
DRAGON_SOUL_STEP_LEVEL2	Klarhed: klar,
DRAGON_SOUL_STEP_LEVEL3	Klarhed: fejlfri,
DRAGON_SOUL_STEP_LEVEL4	Klarhed: strålende,
DRAGON_SOUL_STEP_LEVEL5	Klarhed: fremragende,
DRAGON_SOUL_STRENGTH	Level: +%d	SA
DRAGON_SOUL_UNEQUIP_WARNING1	Denne drage sten kan blive ødelagt i processen.
DRAGON_SOUL_UNEQUIP_WARNING2	Vil du stadig gerne forsætte?
DRAGON_SOUL_UNMATCHED_SLOT	Det er den forkerte plads.
DRAGON_SOUL_UNQUALIFIED	Du kan endnu ikke bruge drage stens alkymisten.
DROP_ITEM_FAILURE_EQUIP_ITEM	Du kan ikke smide genstande i brug væk.
DROP_ITEM_FAILURE_PRIVATE_SHOP	Du kan ikke smide genstande i brug væk, mens du åbner en privat butik.
DROP_MONEY_FAILURE_1000_OVER	Du kan maksimalt smide 999 Yang.
DS_SYSTEM_MSG_1	Du har brug for %s (%dx).
DUTCH_AUCTION_CLOSE_OTHER_WINDOW	Luk venligst alle andre vinduer før du åbner Lyn Auktioner.
EMOTION_ALCOHOL	Skål!
EMOTION_ANGRY	Forarget
EMOTION_ATTRACTIVE	Forførende
EMOTION_BANTER	Spydig
EMOTION_BUSY	Stress
EMOTION_CALL	Kald
EMOTION_CELEBRATION	Fest
EMOTION_CHARGING	Oplader
EMOTION_CHEERS_1	Jubel 1
EMOTION_CHEERS_2	Jubel 2
EMOTION_CHEERUP	Juble
EMOTION_CHOOSE_ONE	Vælg et mål.
EMOTION_CLAP	Applaus
EMOTION_CLAP_KISS	Kys
EMOTION_CONGRATULATION	Understøtte
EMOTION_DANCE_1	Dans 1
EMOTION_DANCE_2	Dans 2
EMOTION_DANCE_3	Dans 3
EMOTION_DANCE_4	Dans 4
EMOTION_DANCE_5	Dans 5
EMOTION_DANCE_6	Gumsan Style
EMOTION_DANCE_7	Samba
EMOTION_DOZE	Døs Hen
EMOTION_EXERCISE	Varm Op
EMOTION_FORGIVE	Tilgive
EMOTION_FRENCH_KISS	Tungekys
EMOTION_HUNGRY	Sulten
EMOTION_JOY	Glæde
EMOTION_LETTER	Kærligheds Brev
EMOTION_NOSAY	Målløs
EMOTION_PUSH_UP	Armbøjninger
EMOTION_SAD	Bedrøvet
EMOTION_SELFIE	Selfie
EMOTION_SHY	Afvise
EMOTION_SIREN	Sirene
EMOTION_SLAP	Slag
EMOTION_WEATHER_1	Solskind
EMOTION_WEATHER_2	Regnbue
EMOTION_WEATHER_3	Måne
EMOTION_WHIRL	Forvirret
EMPIRE_A	Shinsoo-Rige
EMPIRE_B	Chunjo-Rige
EMPIRE_C	Jinno-Rige
EMPIRE_SELECT_MODE	Vælg rige
EXCHANGE_CANNOT_GIVE	Denne genstand kan ikke handles med.
EXCHANGE_CANT_EDIT_MONEY	Du kan ikke redigere bidraget nu.
EXCHANGE_FAILURE_EQUIP_ITEM	Du kan ikke skifte udrustede genstande.
EXCHANGE_MONEY	Bidrag
EXCHANGE_TITLE	Handl med %s (%d)
EXINVEN_USE_ITEM_FAIL_FALL_SHORT	Du har stadig brug for %d Inventar Udvidelser
EXINVEN_USE_ITEM_FAIL_FOURTH_PAGE_STAGE_MAX	Dit inventar har nået den maksimale udvidelse.
EXINVEN_USE_ITEM_QUESTION	Vil du udvide dit inventar med %d Inventar Udvidelser?
FINDM_BUTTON_01	Indsaml
FINDM_BUTTON_02	Forbedre
FINDM_POPUP_01	Du har ikke alle de nødvendige genstande til at starte minispillet.
FINDM_POPUP_02	Du har ikke nok %s.
FINDM_POPUP_03	Du kan ikke bruge det længere.
FINDM_POPUP_04	Det er allerede den bedste belønning.
FINDM_POPUP_05	Utilstrækkeligt Yang til minispillet.
FINDM_POPUP_06	Tre kort vil automatisk blive afsløret, hvis du ikke afslører dem indenfor %d sekunder.
FINDM_QUESTION_01	Dette kræver %d Yang og %s.\n Ønsker du at fortsætte?
FINDM_QUESTION_02	Ønsker du at prøve igen og bruge %s (%d)?
FINDM_QUESTION_03	Belønning: %s
FINDM_QUESTION_04	Prøv igen? Din nuværende belønning forbliver sikker, selv hvis forsøget mislykkes.
FINDM_QUESTION_05	Afslut spillet og indsaml belønning?
FINDM_TOOLTIP_01	Hvis du ikke prøver indenfor den tildelte tid, vil tre kort automatisk blive afsløret.
FISHING_FAILURE	Du har tabt fiskemaddingen.
FISHING_NOTIFY1	Ser ud til, at en %s har bidt på.
FISHING_NOTIFY2	Ser ud til, at en %s blev fanget.
FISHING_RENEWAL_CANNOT_EMOTION	Du kan ikke vise følelser mens du fisker.
FISHING_RENEWAL_CANNOT_OPEN_1	Du kan ikke åbne den mens du fisker.
FISHING_RENEWAL_CANNOT_OPEN_2	Du kan ikke udføre denne handling mens du fisker.
FISHING_RENEWAL_QUESTION	Du har fået et bid. Ønsker du at fange den?
FISHING_RENEWAL_TIMEOUT	Du har ventet for længe. Fisken slap væk.
FISHING_SUCCESS1	Du har fanget en %s !
FISHING_SUCCESS2	Du har fanget %s!
FISHING_UNKNOWN	Jeg ved ikke hvad jeg har fanget.
FISHING_WRONG_PLACE	Her kan jeg ikke fiske.
FLOWER_EVENT_USE_ITEM_TEXT1	Ønsker du at erstatte den aktive effekt?
FLOWER_EVENT_USE_ITEM_TEXT2	Forsøget kan mislykkes, så blomsten visner.
FOR_FEMALE	For kvinder
FOR_MALE	For mænd
FRAGMENT_COMB_COST	Kombinations omkostninger: %s
GAME_CANNOT_MINING	Du kan ikke hakke malm mens du ridder.
GAME_CANNOT_PICK_ITEM	Du kan ikke indsamle denne genstand, da det ikke er dit bytte.
GAME_GUILDWAR_NOW_JOIN	Vil du tilslutte dig Ordenskrigen?
GAME_INIT_ERROR_CURSOR	Musviseren kunne ikke oprettes.
GAME_INIT_ERROR_DIRECTX	DirectX 8.1 skal være installeret for at spillet virker.\nInstaller DirectX 8.1 eller højere.
GAME_INIT_ERROR_GRAPHICS_BAD_PERFORMANCE	Ikke fundet noget grafikkort.\nVær så venligt at kontrollere om dit VGA-kort er installeret korrekt.
GAME_INIT_ERROR_GRAPHICS_NOT_EXIST	Grafikkort blev ikke fundet.\nCheck om du har et VGA-kort.\nAlternativ kan du aktivere for hardware-accelerationen.\n(Hardware-acceleration på maksimum i grafikkortets indstillinger)
GAME_INIT_ERROR_GRAPHICS_NOT_SUPPORT_32BIT	Dit grafikkort understøtter ikke 32bit-vinduesmode.\nSkift til 16bit eller brug fuld skærm.
GAME_INIT_ERROR_ITEM_PROTO	Ikke fundet nogen genstandsfil.\nVær så venlig at geninstallere spillet.
GAME_INIT_ERROR_MAIN_WINDOW	Hovedvinduet kunne ikke oprettes.
GAME_INIT_ERROR_MOB_PROTO	Ikke fundet nogen monsterfil.\nVær så venlig at geninstallere spillet.
GAME_INIT_ERROR_NETWORK	Netværksforbindelsen kunne ikke oprettes.\nCheck din internet-forbindelse.
GAME_PICK_MONEY	Du har fundet %d Yang.
GEM_SYSTEM_ADD_SLOT	Krævet genstand: %s.\nØnsker du at bruge %d af dem for at låse op endnu et felt?
GEM_SYSTEM_BUY_ITEM	Ønsker du at købe denne genstand?
GEM_SYSTEM_NAME	Gaya
GEM_SYSTEM_NOT_ENOUGHT_REFRESHITEM	[Gaya] Du har ikke nok Opdater Gaya Marked genstande.
GEM_SYSTEM_NOT_ENOUGH_HP_GEM	[Gaya] Du har ikke nok Gaya.
GEM_SYSTEM_NO_MORE_ADDSLOT	[Gaya] Der kan ikke låses op for flere felter.
GEM_SYSTEM_OPEN_GEMSHOP	[Gaya] Åben Gaya Markedet først.
GEM_SYSTEM_PICK_GEM	[Gaya] Antal Gaya: %d
GEM_SYSTEM_REFRESH_SHOP_ITEMS	Ønsker du at opdatere butikken?
GIVEUP_QUESTION	Ønsker du virkelig at give op?
GUILDBANK_CLEARBANK	Advarsel: Ordens Lagerhuset skal tømmes!
GUILDBANK_DONT_MONEY_OUT	Du har ingen Yang i ordens banken!.
GUILDBANK_GOLD_IN	Indbetal
GUILDBANK_GOLD_OUT	Udbetal
GUILDBANK_ITEM_IN	Gem
GUILDBANK_ITEM_OUT	Fjern
GUILDBANK_MONEYIN	Indbetal Yang
GUILDBANK_MONEYOUT	Udbetal Yang
GUILDBANK_NOTUSE	Du har ikke de nødvendige rettigheder.
GUILDBANK_NOT_ENOUGH_MONEY	Du har ikke nok Yang til indbetaling.
GUILDBANK_OVER_INCOME	Konto begrænsning nået.
GUILDBANK_OVER_MONEY	Orden kontoen er fyldt.
GUILDLAND_ABANDON	Opgiv Ordens Området
GUILDLAND_ABANDON_VOTE	Opgiv ordenen [%s]s område.
GUILDLAND_ABANDON_VOTE_RESULT1	Ordenen [%s]s område blev opgivet.
GUILDLAND_ABANDON_VOTE_RESULT2	Ordens området er blevet opgivet.
GUILDLAND_ABANDON_VOTE_RESULT3	Resultat af afstemning:
GUILDLAND_ABANDON_VOTE_RESULT4	Afstemning er ugyldig.
GUILDLAND_ABANDON_VOTE_TEXT	Ønsker du virkelig at starte denne afstemning?
GUILDLAND_ABANDON_VOTE_TEXT1	Er du indforstået med at opgive ordens territoriet?
GUILDLAND_ACCEPT	Ja
GUILDLAND_DEAL	Sælg Ordens Område
GUILDLAND_DEAL_TEXT1	Ordenen [%s] ønsker at sælge deres
GUILDLAND_DEAL_TEXT2	område for [%s] Yang.
GUILDLAND_DEAL_TEXT3	Accepterer du tilbuddet?
GUILDLAND_DELA_VOTE	Ordenen [%s] ønsker at købe vores ordens område.
GUILDLAND_DELA_VOTE_RESULT1	Ordens område salg til ordeden [%s]
GUILDLAND_DELA_VOTE_RESULT2	Afstemningen er afsluttet.
GUILDLAND_DELA_VOTE_RESULT3	Afstemningsresultat for salget af ordens området:
GUILDLAND_DELA_VOTE_RESULT4	Afstemning er ugyldig.
GUILDLAND_DELA_VOTE_TEXT	Hvilken orden ønsker du at sælge dit område til?
GUILDLAND_DELA_VOTE_TEXT1	Er du indforstået med at sælge ordens territoriet?
GUILDLAND_DONTHAVE_LAND	Du ejer ikke noget ordens område.
GUILDLAND_NOT	Nej
GUILDLAND_VOTE_TEXT	Ønsker du at give [%s] området?
GUILDLIST_APPLICANT	Ønsker du at anvende?
GUILDMARK_UPLOADER_ERROR_128_HEIGHT	Højden skal være 128 pixel
GUILDMARK_UPLOADER_ERROR_12_HEIGHT	Højden skal være 12 pixel
GUILDMARK_UPLOADER_ERROR_16_WIDTH	Bredde skal være 16 pixel
GUILDMARK_UPLOADER_ERROR_64_WIDTH	Bredde skal være 64 pixel
GUILDMARK_UPLOADER_ERROR_FILE_FORMAT	Spillet understøtter ikke den slags billedformater.
GUILDMARK_UPLOADER_ERROR_PATH	Flyt filerne i mappen metin2/upload.
GUILDMARK_UPLOADER_ERROR_SELECT	Du har ikke valgt nogen billed-fil.
GUILDVOTE_CHANGEMASTER	Skift Ordensleder
GUILDVOTE_CHANGEMASTER_RESULT1	Ordenen blev overført med success.
GUILDVOTE_CHANGEMASTER_RESULT2	Ordenen [%s] blev overført til dig.
GUILDVOTE_CHANGEMASTER_RESULT3	Overfør orden til medlemmet [%s]
GUILDVOTE_CHANGEMASTER_RESULT4	Afstemning er ugyldig.
GUILDVOTE_CHANGEMASTER_RESULT5	Ny ordensleder: %s
GUILDVOTE_CHANGEMASTER_TEXT1	Ønsker du at overføre ordenen til [%s]?
GUILDVOTE_CHANGEMASTER_TEXT2	
GUILDVOTE_CHANGEMASTER_TEXT3	Ønsker du virkelig at opgive lederskabet af ordenen?
GUILDVOTE_CHANGEMASTER_TEXT4	
GUILDVOTE_CHANGEMASTER_VOTETEXT1	Overfør orden til medlemmet [%s]
GUILDVOTE_CHANGEMASTER_VOTETEXT2	Accepterer du ordensleder overførslen?
GUILDVOTE_MEMBEROUT	Fjern Medlem
GUILDVOTE_MEMBEROUT_AUTH	Du har ikke de nødvendige rettigheder.
GUILDVOTE_MEMBEROUT_NOMAL	Ønsker du virkelig at fjerne dette medlem?
GUILDVOTE_MEMBEROUT_RESULT1	Fjern Medlem: [%s]
GUILDVOTE_MEMBEROUT_RESULT2	Afstemningsresultat
GUILDVOTE_MEMBEROUT_RESULT3	Du er blevet fjernet fra ordenen [%s].
GUILDVOTE_MEMBEROUT_RESULT4	Afstemningsresultat
GUILDVOTE_MEMBEROUT_RESULT5	Afstemning er ugyldig.
GUILDVOTE_MEMBEROUT_TEXT1	Ønsker du at starte en afstemning mod [%s]?
GUILDVOTE_MEMBEROUT_TEXT2	Afstemning: Fjern medlem fra ordenen?
GUILDVOTE_MEMBEROUT_VOTETEXT1	Afstemning: Skal [%s] fjernes fra ordenen?
GUILDVOTE_MEMBEROUT_VOTETEXT2	
GUILDVOTE_NO	Imod
GUILDVOTE_OK	For
GUILDVOTE_RESULT_AGGRE_MEMBER	For: %d
GUILDVOTE_RESULT_ALL_MEMBER	Deltagere: %d
GUILDVOTE_RESULT_OPPESE_MEMBER	Imod: %d
GUILDVOTE_RESULT_TIME	%d dage %d timer %d minutter %d sekunder
GUILDVOTE_SELECT_ONE	Vælg venligst en karakter.
GUILDWAR_ALL	Kampe (K)
GUILDWAR_CTF_TITLE	Fang Flaget
GUILDWAR_DRAW	Uafgjorte (U)
GUILDWAR_GAINSCORE_FIFTY	50 point
GUILDWAR_GAINSCORE_HUNDRED	100 point
GUILDWAR_GAINSCORE_THIRTY	30 point
GUILDWAR_GAMETIME_SIXTY	60 minutter
GUILDWAR_GAMETIME_TEN	10 minutter
GUILDWAR_GAMETIME_THIRTY	30 minutter
GUILDWAR_INPUT_OTHERGUILD	Indtast venligst ordens modstanderen.
GUILDWAR_LADDER	Rangpoint
GUILDWAR_LIMIT_MEMBER_FIVE	Minimum 5 Deltagere.
GUILDWAR_LOSE	Tab (T)
GUILDWAR_NORMAL_TITLE	Kampfelt
GUILDWAR_OVER_MEMBERCOUNT	Du har nået medlems begrænsningen.
GUILDWAR_QUESTION_LINE_1	%s-Ordenen har erklæret krig mod jer.
GUILDWAR_QUESTION_LINE_2	tager du imod? (%s)
GUILDWAR_RANKING	Rang
GUILDWAR_RECODE_ALL	%d K, %d V, %d T, %d U
GUILDWAR_SELECT_MEMBER_COUNT	Vælg antallet af deltagere.
GUILDWAR_TYPE_DEFENSE	Skjold Kamp
GUILDWAR_TYPE_TIGER	Udslettelse
GUILDWAR_TYPE_TIME	Tids Angreb
GUILDWAR_UNKNOWN_TITLE	...
GUILDWAR_WARP_TITLE	Arena krig
GUILDWAR_WIN	Vundet (V)
GUILDWAR_WIN_FIVE	5 runder
GUILDWAR_WIN_ONE	1 runde
GUILDWAR_WIN_THREE	3 runder
GUILDWINDOW_BUTTON_BANKGOLDINFO	Ordens Lagerhus Historik
GUILDWINDOW_BUTTON_BASEABANDON	Opgiv Ordens Området
GUILDWINDOW_BUTTON_BASEDEAL	Sælg Ordens Område
GUILDWINDOW_BUTTON_BASEDEALVOTE	Stem
GUILDWINDOW_BUTTON_BOARD	Ordens Meddelelser
GUILDWINDOW_BUTTON_CHANGEMASTER	Skift Ordensleder
GUILDWINDOW_BUTTON_DECLARE	Erklær Krig
GUILDWINDOW_BUTTON_DONATE	Doner
GUILDWINDOW_BUTTON_GOLDIN	Indbetal
GUILDWINDOW_BUTTON_GOLDOUT	Udbetal
GUILDWINDOW_BUTTON_GRADE	Administrer Rettigheder
GUILDWINDOW_BUTTON_GUILDLIST	Ordensliste
GUILDWINDOW_BUTTON_HEALGSP	Genopret Dragegudens Styrke
GUILDWINDOW_BUTTON_INFO	Ordens Informationer
GUILDWINDOW_BUTTON_LANDINFO	Område Informationer
GUILDWINDOW_BUTTON_MARK	Upload Ordens Symbol
GUILDWINDOW_BUTTON_MEMBER	Medlem
GUILDWINDOW_BUTTON_OFFER	Donér EXP
GUILDWINDOW_BUTTON_OUTMEMBER	Fjern Medlem
GUILDWINDOW_BUTTON_SKILL	Ordensfærdigheder
GUILDWINDOW_BUTTON_SYMBOL	Upload Ordensflag
GUILDWINDOW_BUTTON_VOTECHECK	Tjek Stemmer
GUILDWINDOW_BUY_GUILD_LAND	Køb Land
GUILDWINDOW_CHANGE_BLACKSMITH	Ændre Profession
GUILDWINDOW_CHANGE_OBJECT	Rekonstruktion
GUILDWINDOW_CHANGE_SMELTER	Skift Højovn
GUILDWINDOW_CREATE_OBJECT	Konstruktion
GUILDWINDOW_DEAL_GUILD_LAND	Sælg Land
GUILDWINDOW_GRADE_BANK	Kan bruge ordens banken og lagerhuset
GUILDWINDOW_GRADE_DRIVEOUTAUTHORITY	Kan fjerne medlemmer fra ordenen
GUILDWINDOW_GRADE_GRADENAME	Rang Navn
GUILDWINDOW_GRADE_GRADENUMBER	Rang Nummer
GUILDWINDOW_GRADE_GUILDWAR	Kan vælge medlemmer som krigsdeltagere
GUILDWINDOW_GRADE_INVITEAUTHORITY	Kan acceptere spillere til ordenen
GUILDWINDOW_GRADE_NOTICEAUTHORITY	Kan sende ordens beskeder
GUILDWINDOW_GRADE_SKILLAUTHORITY	Kan bruge ordensfærdigheder
GUILDWINDOW_INFO_LEVEL10	Forøget maks. medlemstal
GUILDWINDOW_INFO_LEVEL15	Reduk.: Dragegudens Styrke
GUILDWINDOW_INFO_LEVEL20	Bank: Skattefritagelse
GUILDWINDOW_INFO_LEVEL5	+5% EXP til orden donation
GUILDWINDOW_LIST_ALL	Alle Riger
GUILDWINDOW_LIST_ALREADY_REGISTER	[Orden] Du har allerede ansøgt.
GUILDWINDOW_LIST_APPLICANT_LIST	Ansøgnings Liste
GUILDWINDOW_LIST_CHRACTER_JOB	Karakterklasse
GUILDWINDOW_LIST_CHRACTER_LV	Level
GUILDWINDOW_LIST_CHRACTER_NAME	Karakternavn
GUILDWINDOW_LIST_CHRACTER_SUB_JOB	Klasse
GUILDWINDOW_LIST_EMPIRE_A	Shinsoo
GUILDWINDOW_LIST_EMPIRE_B	Chunjo
GUILDWINDOW_LIST_EMPIRE_C	Jinno
GUILDWINDOW_LIST_GUILDMEMBER	Medlem
GUILDWINDOW_LIST_GUILD_LIST	Ordensliste
GUILDWINDOW_LIST_GUILD_LV	Level
GUILDWINDOW_LIST_GUILD_NAME	Orden
GUILDWINDOW_LIST_INPUT_GUILDNAME	[Orden] Indtast venligst et ordensnavn.
GUILDWINDOW_LIST_LADDER	Rangpoint
GUILDWINDOW_LIST_NOTPROMOTEGUILD	[Orden] Denne orden søger ikke.
GUILDWINDOW_LIST_PROMOTE_GUILD	Ansøgning
GUILDWINDOW_LIST_PROMOTE_GUILD_LIST	Ordensliste
GUILDWINDOW_LIST_RANKING	Position
GUILDWINDOW_LIST_RANKING_COUNT	Position
GUILDWINDOW_LIST_REGISTER	Ansøgninger
GUILDWINDOW_LIST_REGISTER_GUILD	Ansøg til ordenen
GUILDWINDOW_LIST_SEARCH	Søg
GUILDWINDOW_LIST_SELECT_GUILD	[Orden] Vælg venligst en orden du vil ansøge til.
GUILDWINDOW_PROMOTE_REFRESH	Annoncer
GUILDWINDOW_PROMOTE_REGISTER	Annoncer
GUILDWINDOW_SP_RECOVER	Dragegudens Magt
GUILDWINDOW_UPGRADE_ALTEROFPOWER	Opgrader Alter
GUILDWINDOW_UPGRADE_GUILDBANK	Opgrader Bank
GUILD_ATTENDANCE_FAIL_ALREADY	Du har allerede deltaget i dag.
GUILD_ATTENDANCE_FAIL_JOIN_TIME	Du kan ikke deltage nu. Deltagelsen bliver nulstillet hver dag kl. 05:00.
GUILD_BANKINFO_CLOSE	Luk
GUILD_BANKINFO_NAME	Medlem
GUILD_BANKINFO_TYPE	Genstand/Valuta
GUILD_BANKINFO_USETYPE	Handling
GUILD_BANK_CLOSE	Luk
GUILD_BANK_INFO	Ordens Lagerhus Historik
GUILD_BOARD_ID	Medlem
GUILD_BOARD_TEXT	Besked
GUILD_BUILDING_FIX_CHANGE	Er du sikker på du vil skifte placering
GUILD_BUILDING_FIX_CHANGE_GOLD	Pris: 1.000.000 Yang
GUILD_BUILDING_FIX_DELETE	Er du sikker på at du vil slette objektet?
GUILD_BUILDING_FIX_NEED_BUILDING	Ingen bygning til stede.
GUILD_BUILDING_GRADE	Rang
GUILD_BUILDING_NAME	Bygningsnavn
GUILD_CANNOT_HEAL_GSP_ANYMORE	Drageånd er allerede fyldt.
GUILD_COMMENT	Skriv
GUILD_CREATE_ERROR_INSULT_NAME	Ordensnavnet er ikke tilladt.
GUILD_DEFAULT_GRADE	Ordensmedlemmer
GUILD_DELETE	Slet
GUILD_DEPOSIT	Deponere
GUILD_DONATE_FAIL_NOT_ENOUGH_HIGH_ITEM	Du har ikke nok Store Donations Billetter.
GUILD_DONATE_FAIL_NOT_ENOUGH_INVENTORY	Dit inventar er fyldt. Du kan ikke donere.
GUILD_DONATE_FAIL_NOT_ENOUGH_LEVEL	Din karakter skal mindst være level 30.
GUILD_DONATE_FAIL_NOT_ENOUGH_MIDDLE_ITEM	Du har ikke nok Mellem Donations Billetter.
GUILD_DONATE_FAIL_NOT_ENOUGH_YANG	Ikke nok Yang.
GUILD_DONATE_FAIL_TIME	Vi ses om 24 timer!
GUILD_DONATE_QUESTION_HIGH	Ønsker du at lave en Stor Donation?
GUILD_DONATE_QUESTION_MIDDLE	Ønsker du at lave en Mellem Donation?
GUILD_DONATE_QUESTION_NORMAL	Ønsker du at lave en Lille Donation?
GUILD_DO_YOU_HEAL_GSP	Vil du bruge %d Yang for at reproducere %d stykker drageånd?
GUILD_DO_YOU_JOIN	 har inviteret dig. Vil du tilslutte dig ordenen?
GUILD_DRAGONLAIR_MIN	min.
GUILD_DRAGONLAIR_PARTY_ALL	Samlede Rangliste
GUILD_DRAGONLAIR_PARTY_LINE_FOUR	11 Plads og Mindre: 100 Gaya
GUILD_DRAGONLAIR_PARTY_LINE_HELP	Hjælp
GUILD_DRAGONLAIR_PARTY_LINE_ONE	1 Plads: 400 Gaya
GUILD_DRAGONLAIR_PARTY_LINE_THREE	4-10 Plads: 200 Gaya
GUILD_DRAGONLAIR_PARTY_LINE_TWO	2-3 Plads: 300 Gaya
GUILD_DRAGONLAIR_PARTY_MEMBER	Medlemmer
GUILD_DRAGONLAIR_PARTY_NOW	Ugentlig Rangliste
GUILD_DRAGONLAIR_PARTY_PAST	Forrige Rangliste
GUILD_DRAGONLAIR_PARTY_TIME	Tid
GUILD_DRAGONLAIR_PARTY_TOOLTIP_TITLE	Belønning
GUILD_DRAGONLAIR_RANKING_FAIL	MISLYKKEDES
GUILD_DRAGONLAIR_RANKING_NONE	NY
GUILD_DRAGONLAIR_RANKING_SUCCESS	SUCCES
GUILD_DRAGONLAIR_SECOND	sek.
GUILD_EMPTY_AREA	Tomt areal
GUILD_ENEMY_GUILD_NAME	Fjendens Ordensnavn
GUILD_FACILITY	Sidebygning
GUILD_GEM	Ædelsten
GUILD_HEADQUARTER	Hovedbygning
GUILD_HEAL_GSP	Gendan drageånd.
GUILD_INFO_ENEMY_GUILD_EMPTY	Ingen
GUILD_MARK_NOT_ENOUGH_LEVEL	Level skal minimum være 3
GUILD_MARK_UPLOAD_NOTICE	Vent venligst et øjeblik så du kan tilføje ordens logoer.
GUILD_MEMBER_JOB	Karakterklasse
GUILD_MEMBER_KNIGHT	Krigsdeltager
GUILD_MEMBER_LEVEL	Level
GUILD_MEMBER_NAME	Medlem
GUILD_MEMBER_RANK	Rang
GUILD_MEMBER_SPECIFIC_GRAVITY	Donéret EXP
GUILD_NAME	Ordensnavn
GUILD_NOT_ENOUGH_MATERIAL	Du har ikke materialer nok til denne bygningen.
GUILD_NOT_ENOUGH_MONEY	Du har ikke Yang nok til denne bygningen.
GUILD_NO_NOTICE_PERMISSION	Du har ingen rettigheder til bekendtgørelser.
GUILD_OBJECT	Objekter
GUILD_OFFER_EXP	Investere erfaring
GUILD_SHORT_EXP	Ikke nok erfaring.
GUILD_TILE_BASEINFO	Område Informationer
GUILD_TILE_BOARD	Ordens Meddelelser
GUILD_TILE_GRADE	Forvaltning af rettigheder
GUILD_TILE_INFO	Ordensinformationer
GUILD_TILE_MEMBER	Medlem
GUILD_TILE_SKILL	Ordensfærdigheder
GUILD_USE_MASTER_ONLY	Kun ordenslederen har denne rettighed.
GUILD_VILLAGE_01	Miryang
GUILD_VILLAGE_02	Songpa
GUILD_VILLAGE_03	Daeyami
GUILD_WAR1	Ordenskrigs område
GUILD_WAR2	Ordenskrigs område
GUILD_WAR3	Ordenskrigs område
GUILD_WAR4	Ordenskrigs område
GUILD_WAR_GAINSCORE_FIFTY	50 point
GUILD_WAR_GAINSCORE_HUNDRED	100 point
GUILD_WAR_GAINSCORE_THIRTY	30 point
GUILD_WAR_GAMETIME_SIXTY	60 minutter
GUILD_WAR_GAMETIME_TEN	10 minutter
GUILD_WAR_GAMETIME_THIRTY	30 minutter
GUILD_WAR_LIMIT_30MIN	Tid: 30 Minutter
GUILD_WAR_REWARD_POTION	Belønning: Vinderen får eliksirer.
GUILD_WAR_SELECT_WAR	Vælg type
GUILD_WAR_TYPE_DEFENSE	Skjold Kamp
GUILD_WAR_TYPE_DIE	Arena Kamp
GUILD_WAR_TYPE_FLAG	Fang Flaget
GUILD_WAR_TYPE_NORMAL	Kampfelt
GUILD_WAR_TYPE_TIGER	Udslettelse
GUILD_WAR_TYPE_TIME	Tids Angreb
GUILD_WAR_USE_BATTLE_MAP	Sted: Ordenskrig Arena
GUILD_WAR_USE_NORMAL_MAP	Sted: Normal kort
GUILD_WAR_WIN_CHECK_SCORE	Højest resultat vinder krigen.	
GUILD_WAR_WIN_FIVE	5 runder
GUILD_WAR_WIN_ONE	1 runde
GUILD_WAR_WIN_TAKE_AWAY_FLAG1	Få fat i fjendens flag
GUILD_WAR_WIN_TAKE_AWAY_FLAG2	og bring det til din base.
GUILD_WAR_WIN_THREE	3 runder
GUILD_WAR_WIN_WIPE_OUT_GUILD	Besejre alle fjender for at vinde.
GUILD_WITHDRAW	Tilbagetræk
GUILD_YOU_DO_NOT_JOIN	Du er ikke medlem i nogen Orden.
HORSE_HEALTH0	Død
HORSE_HEALTH1	Sulter
HORSE_HEALTH2	Sulten
HORSE_HEALTH3	Fuld
HORSE_LEVEL1	Normal hest
HORSE_LEVEL2	Krigs hest
HORSE_LEVEL3	Militærhest
HOUR	t
HOW_MANY_ITEM_DO_YOU_DROP1	Ønsker du at smide %s væk?
HOW_MANY_ITEM_DO_YOU_DROP2	Vil du smide %s %d væk
INPUT_MATRIX_CARD_NUMBER	Indtast matrix-kortnr.
INPUT_MATRIX_CARD_TITLE	Matrix-kort
INPUT_PRIVATE_CODE_DIALOG_DESCRIPTION	Indtast slet-koden fra din account-forvaltning.
INPUT_PRIVATE_CODE_DIALOG_TITLE	Slet karakter
INVENTORY_DO_NOT_PACK_WARP_SCROLL	Dokumenter kan ikke sammenføres.
INVENTORY_REALLY_USE_ITEM	Brug genstand på denne genstand?
INVENTORY_REALLY_USE_ITEM2	Ønsker du virkelig at bruge denne genstand?
INVENTORY_REALLY_USE_PET_BAG_ITEM	Ønsker du virkelig at komme dit kæledyr i Transportkassen?
INVENTORY_REALLY_USE_PET_BAG_TAKE_OUT	Ønsker du at åbne en Transportkasse?
INVENTORY_REALLY_USE_PET_FEEDSTUFF_ITEM	Ønsker du at fodre %s til %s?
IS_NOT_PET_CHANGE_ITEM	Det er ikke et Fortryl Kæledyr genstand.
IS_NOT_PET_ITEM	Det er ikke et kæledyr.
JOB_ASSASSIN	Ninja
JOB_ASSASSIN0	Ingen
JOB_ASSASSIN1	Nærkamp Ninja
JOB_ASSASSIN2	Distancekamp Ninja
JOB_SHAMAN	Shaman	
JOB_SHAMAN0	Ingen
JOB_SHAMAN1	Dragemagt Shaman
JOB_SHAMAN2	Helbredelses Shaman
JOB_SURA	Sura
JOB_SURA0	Ingen
JOB_SURA1	Magi-våben Sura
JOB_SURA2	Sort-magi Sura
JOB_WARRIOR	Kriger
JOB_WARRIOR0	Ingen
JOB_WARRIOR1	Kampstyrke Kriger
JOB_WARRIOR2	Mentalstyrke Kriger
JOB_WOLFMAN	Lycan
JOB_WOLFMAN0	Amatør Lycan
JOB_WOLFMAN1	Instinkt
JOB_WOLFMAN2	N.A.
KEYCHANGE_DONT_SAVE_EXIT	Forlad uden af at gemme?
KEYCHANGE_IMPOSSIBLE_CHANGE	[Ctrl], [Alt], [Shift] er ikke tilladt her!
KEYCHANGE_SAVE_EXIT	Gem og luk?
KEY_0	0
KEY_0_LALT	Alt + 0
KEY_0_LCONTROL	Ctrl + 0
KEY_0_LSHIFT	Shift + 0
KEY_1	1
KEY_1_LALT	Alt + 1
KEY_1_LCONTROL	Ctrl + 1
KEY_1_LSHIFT	Shift + 1
KEY_2	2
KEY_2_LALT	Alt + 2
KEY_2_LCONTROL	Ctrl + 2
KEY_2_LSHIFT	Shift + 2
KEY_3	3
KEY_3_LALT	Alt + 3
KEY_3_LCONTROL	Ctrl + 3
KEY_3_LSHIFT	Shift + 3
KEY_4	4
KEY_4_LALT	Alt + 4
KEY_4_LCONTROL	Ctrl + 4
KEY_4_LSHIFT	Shift + 4
KEY_5	5
KEY_5_LALT	Alt + 5
KEY_5_LCONTROL	Ctrl + 5
KEY_5_LSHIFT	Shift + 5
KEY_6	6
KEY_6_LALT	Alt + 6
KEY_6_LCONTROL	Ctrl + 6
KEY_6_LSHIFT	Shift + 6
KEY_7	7
KEY_7_LALT	Alt + 7
KEY_7_LCONTROL	Ctrl + 7
KEY_7_LSHIFT	Shift + 7
KEY_8	8
KEY_8_LALT	Alt + 8
KEY_8_LCONTROL	Ctrl + 8
KEY_8_LSHIFT	Shift + 8
KEY_9	9
KEY_9_LALT	Alt + 9
KEY_9_LCONTROL	Ctrl + 9
KEY_9_LSHIFT	Shift + 9
KEY_A	A
KEY_ADD	+
KEY_A_LALT	Alt + A
KEY_A_LCONTROL	Ctrl + A
KEY_A_LSHIFT	Shift + A
KEY_B	B
KEY_B_LALT	Alt + B
KEY_B_LCONTROL	Ctrl + B
KEY_B_LSHIFT	Shift + B
KEY_C	C
KEY_COMMA	,
KEY_COMMA_LALT	Alt + ,
KEY_COMMA_LCONTROL	Ctrl + ,
KEY_COMMA_LSHIFT	Shift + ,
KEY_C_LALT	Alt + C
KEY_C_LCONTROL	Ctrl + C
KEY_C_LSHIFT	Shift + C
KEY_D	D
KEY_DOWN	Ned
KEY_D_LALT	Alt + D
KEY_D_LCONTROL	Ctrl + D
KEY_D_LSHIFT	Shift + D
KEY_E	E
KEY_E_LALT	Alt + E
KEY_E_LCONTROL	Ctrl + E
KEY_E_LSHIFT	Shift + E
KEY_F	F
KEY_F1	F1
KEY_F10	F10
KEY_F10_LALT	Alt + F10
KEY_F10_LCONTROL	Ctrl + F10
KEY_F10_LSHIFT	Shift + F10
KEY_F1_LALT	Alt + F1
KEY_F1_LCONTROL	Ctrl + F1
KEY_F1_LSHIFT	Shift + F1
KEY_F2	F2
KEY_F2_LALT	Alt + F2
KEY_F2_LCONTROL	Ctrl + F2
KEY_F2_LSHIFT	Shift + F2
KEY_F3	F3
KEY_F3_LALT	Alt + F3
KEY_F3_LCONTROL	Ctrl + F3
KEY_F3_LSHIFT	Shift + F3
KEY_F4	F4
KEY_F4_LALT	Alt + F4
KEY_F4_LCONTROL	Ctrl + F4
KEY_F4_LSHIFT	Shift + F4
KEY_F5	F5
KEY_F5_LALT	Alt + F5
KEY_F5_LCONTROL	Ctrl + F5
KEY_F5_LSHIFT	Shift + F5
KEY_F6	F6
KEY_F6_LALT	Alt + F6
KEY_F6_LCONTROL	Ctrl + F6
KEY_F6_LSHIFT	Shift + F6
KEY_F7	F7
KEY_F7_LALT	Alt + F7
KEY_F7_LCONTROL	Ctrl + F7
KEY_F7_LSHIFT	Shift + F7
KEY_F8	F8
KEY_F8_LALT	Alt + F8
KEY_F8_LCONTROL	Ctrl + F8
KEY_F8_LSHIFT	Shift + F8
KEY_F9	F9
KEY_F9_LALT	Alt + F9
KEY_F9_LCONTROL	Ctrl + F9
KEY_F9_LSHIFT	Shift + F9
KEY_F_LALT	Alt + F
KEY_F_LCONTROL	Ctrl + F
KEY_F_LSHIFT	Shift + F
KEY_G	G
KEY_GRAVE	½
KEY_GRAVE_LALT	Alt + ½
KEY_GRAVE_LCONTROL	Ctrl + ½
KEY_GRAVE_LSHIFT	Shift + ½
KEY_G_LALT	Alt + G
KEY_G_LCONTROL	Ctrl + G
KEY_G_LSHIFT	Shift + G
KEY_H	H
KEY_H_LALT	Alt + H
KEY_H_LCONTROL	Ctrl + H
KEY_H_LSHIFT	Shift + H
KEY_I	I
KEY_I_LALT	Alt + I
KEY_I_LCONTROL	Ctrl + I
KEY_I_LSHIFT	Shift + I
KEY_J	J
KEY_J_LALT	Alt + J
KEY_J_LCONTROL	Ctrl + J
KEY_J_LSHIFT	Shift + J
KEY_K	K
KEY_K_LALT	Alt + K
KEY_K_LCONTROL	Ctrl + K
KEY_K_LSHIFT	Shift + K
KEY_L	L
KEY_LALT	Alt
KEY_LCONTROL	Ctrl
KEY_LEFT	Venstre
KEY_LSHIFT	Shift
KEY_L_LALT	Alt + L
KEY_L_LCONTROL	Ctrl + L
KEY_L_LSHIFT	Shift + L
KEY_M	M
KEY_M_LALT	Alt + M
KEY_M_LCONTROL	Ctrl + M
KEY_M_LSHIFT	Shift + M
KEY_N	N
KEY_NUMLOCK	Num Lock
KEY_NUMPAD0	NUMPAD 0
KEY_NUMPAD1	NUMPAD 1
KEY_NUMPAD2	NUMPAD 2
KEY_NUMPAD3	NUMPAD 3
KEY_NUMPAD4	NUMPAD 4
KEY_NUMPAD5	NUMPAD 5
KEY_NUMPAD6	NUMPAD 6
KEY_NUMPAD7	NUMPAD 7
KEY_NUMPAD8	NUMPAD 8
KEY_NUMPAD9	NUMPAD 9
KEY_N_LALT	Alt + N
KEY_N_LCONTROL	Ctrl + N
KEY_N_LSHIFT	Shift + N
KEY_O	O
KEY_O_LALT	Alt + O
KEY_O_LCONTROL	Ctrl + O
KEY_O_LSHIFT	Shift + O
KEY_P	P
KEY_PERIOD	.
KEY_PERIOD_LALT	Alt + .
KEY_PERIOD_LCONTROL	Ctrl + .
KEY_PERIOD_LSHIFT	Shift + .
KEY_PGDN	Page Down
KEY_PGUP	Page Up
KEY_P_LALT	Alt + P
KEY_P_LCONTROL	Ctrl + P
KEY_P_LSHIFT	Shift + P
KEY_Q	Q
KEY_Q_LALT	Alt + Q
KEY_Q_LCONTROL	Ctrl + Q
KEY_Q_LSHIFT	Shift + Q
KEY_R	R
KEY_RIGHT	Højre
KEY_R_LALT	Alt + R
KEY_R_LCONTROL	Ctrl + R
KEY_R_LSHIFT	Shift + R
KEY_S	S
KEY_SPACE	Mellemrum
KEY_SUBTRACT	-
KEY_SYSRQ	Print Screen
KEY_S_LALT	Alt + S
KEY_S_LCONTROL	Ctrl + S
KEY_S_LSHIFT	Shift + S
KEY_T	T
KEY_TAB	Tab
KEY_T_LALT	Alt + T
KEY_T_LCONTROL	Ctrl + T
KEY_T_LSHIFT	Shift + T
KEY_U	U
KEY_UP	Op
KEY_U_LALT	Alt + U
KEY_U_LCONTROL	Ctrl + U
KEY_U_LSHIFT	Shift + U
KEY_V	V
KEY_V_LALT	Alt + V
KEY_V_LCONTROL	Ctrl + V
KEY_V_LSHIFT	Shift + V
KEY_W	W
KEY_W_LALT	Alt + W
KEY_W_LCONTROL	Ctrl + W
KEY_W_LSHIFT	Shift + W
KEY_X	X
KEY_X_LALT	Alt + X
KEY_X_LCONTROL	Ctrl + X
KEY_X_LSHIFT	Shift + X
KEY_Y	Y
KEY_Y_LALT	Alt + Y
KEY_Y_LCONTROL	Ctrl + Y
KEY_Y_LSHIFT	Shift + Y
KEY_Z	Z
KEY_Z_LALT	Alt + Z
KEY_Z_LCONTROL	Ctrl + Z
KEY_Z_LSHIFT	Shift + Z
LEADER_NAME	Lederens Navn
LEFT_TIME	Resterende tid	
LIMIT_LEVEL_GUILD	Ordens level: %d
LOGIN_CONNECT_FAILURE	En fejl opstod ved forbindelsen til serveren.	
LOGIN_CONNECT_SUCCESS	Du er forbundet til serveren.
LOGIN_CONNETING	Vent venligst mens du er forbundet til serveren.
LOGIN_FAILURE_ALREAY	Din konto er allerede forbundet.
LOGIN_FAILURE_BACKEND_ERR	Der opstod en fejl. Kontakt venligst Support.
LOGIN_FAILURE_BE_SAME_KEY	Registrerings problem.	
LOGIN_FAILURE_BLOCK_ID	Denne konto er blevet blokeret.
LOGIN_FAILURE_BLOCK_LOGIN	Vælg venligst en anden servere.
LOGIN_FAILURE_COUNTRY_ERR	Landekoden er forkert.\nKontakt venligst Support.
LOGIN_FAILURE_INTEGRTING	Denne konto bliver i øjeblikket fusioneret. Prøv venligst igen senere.
LOGIN_FAILURE_IOVATION_ERR	Der er desværre opstået en fejl. Kontakt venligst Support.
LOGIN_FAILURE_NOBILL	Denne konto har ingen spilletid.
LOGIN_FAILURE_NOT_AVAIL	Denne konto er ikke tilgængelig.
LOGIN_FAILURE_NOT_EXIST_ID	Forkert brugernavn eller password.
LOGIN_FAILURE_NOT_MAIL_CONFIRM	Du skal bekræfte din konto via email.
LOGIN_FAILURE_REPAIR_ID	Genstandene er blevet gendannet på denne konto.
LOGIN_FAILURE_SAMELOGIN	En person har forbundet sig til din konto.
LOGIN_FAILURE_SHUTDOWN	Denne server er ikke åben.
LOGIN_FAILURE_STEAM_SESSION	Din session er udløbet. Genstart venligst klienten.
LOGIN_FAILURE_TNT_SESSION	Klienten kan ikke åbnes. Genstart venligst lancereren og log in.
LOGIN_FAILURE_TOO_MANY_USER	Du kan ikke få forbindelse med serveren, da der er for mange spillere online.
LOGIN_FAILURE_UNKNOWN	Du kunne ikke logge på. Årsagen er ukendt.
LOGIN_FAILURE_WEB_BLOCK	Du blev blokeret på websiden. Tjek venligst din e-mail.
LOGIN_FAILURE_WRONG_MATRIX_CARD_NUMBER	Du har indtastet et forkert nr.
LOGIN_FAILURE_WRONG_MATRIX_CARD_NUMBER_TRIPLE	Du har 3 gange i træk indtastet et forkert nr. - din forbindelse blev afbrudt.
LOGIN_FAILURE_WRONG_PASSWORD	Forkert brugernavn eller password.
LOGIN_INPUT_ID	Angiv ID.
LOGIN_INPUT_PASSWORD	Angiv kodeordet.
LOGIN_PROCESSING	Registreringen med serveren er i gang...
LUCKY_BOX_DIALOG_RECV_TEXT	Ønsker du at acceptere genstanden?
LUCKY_BOX_DIALOG_RETRY_TEXT	Ønsker du at prøve lykken igen?
MAILBOX_FAIL_USE_TIME_LIMIT	Opdaterer Postkasse. Prøv venligst igen senere.
MAILBOX_POST_ALL_DELETE_FAIL_EMPTY	Ingen beskeder
MAILBOX_POST_ALL_DELETE_QUESTION1	Slet alle beskeder?
MAILBOX_POST_ALL_DELETE_QUESTION2	Beskeder med vedhæftninger vil ikke blive slettet.
MAILBOX_POST_ALL_GET_ITEMS_FAIL_EMPTY	Du har ikke nogen beskeder med vedhæftninger i din postkasse.
MAILBOX_POST_ALL_GET_ITEMS_QUESTION	Accepter vedhæftning? (Minus 5% i skat i Yang)
MAILBOX_POST_DELETE_FAIL_EXIST_ITEMS	Beskeden kunne ikke slettes. Accepter venligst vedhæftningen først.
MAILBOX_POST_DELETE_QUESTION	Vil du virkelig slette denne besked?
MAILBOX_POST_GET_ITEMS_NOT_ENOUGHT_INVENTORY	Genstandene kunne ikke blive accepteret. Dit inventar er fyldt.
MAILBOX_POST_GET_ITEMS_QUESTION	Accepter vedhæftning? (Minus 5% i skat i Yang)
MAILBOX_POST_GET_ITEMS_WON_OVERFLOW	Du kan ikke acceptere flere Won.
MAILBOX_POST_GET_ITEMS_YANG_OVERFLOW	Du kan ikke acceptere flere Yang.
MAILBOX_POST_GM_ARRIVE	GM Besked
MAILBOX_POST_NOT_CONFIRM_INFO_1	Ulæste beskeder: %d
MAILBOX_POST_NOT_CONFIRM_INFO_2	Uden vedhæftning: %d / Med vedhæftning: %d
MAILBOX_POST_READ_BLOCK	Er du sikker på at du gerne vil blokere %s?
MAILBOX_POST_WRITE_ALREADY_ITEM	Du kan kun sende en genstand per besked.
MAILBOX_POST_WRITE_CAN_NOT_SPLIT_ITEM	Opdel de stablede genstande i dit inventar, inden du vedhæfter en til meddelelsen.
MAILBOX_POST_WRITE_CONFIRM_FAIL	Ukendt modtager. Beskeden kunne ikke blive sendt.
MAILBOX_POST_WRITE_CONFIRM_FULL_MAILBOX	Din modtagers postkasse er fyldt. Beskeden kunne ikke blive sendt.
MAILBOX_POST_WRITE_LEVEL_LIMIT	Du kan sende beskeder fra level 20.
MAILBOX_POST_WRITE_MONEY_NOT_ENOUGHT	Du har ikke nok Yang til at sende denne besked.
MAILBOX_POST_WRITE_NAME_CHECK	Bekræft modtagerens navn ved at klikke på Tjek Modtager.
MAILBOX_POST_WRITE_NAME_EMPTY	Indtast modtageren.
MAILBOX_POST_WRITE_QUESTION1	Ønsker du at sende beskeden til %s nu?
MAILBOX_POST_WRITE_QUESTION2	Forsendelsesgebyr: %d Yang
MAILBOX_POST_WRITE_SEND_FAIL_EMPTY_NAME	Indtast en modtager.
MAILBOX_POST_WRITE_SEND_FAIL_EMPTY_TITLE	Indtast et emne.
MAILBOX_POST_WRITE_SEND_MONEY_TITLE	Penge
MAILBOX_POST_WRITE_WRONG_ITEM	Du kan ikke sende sjælebundene genstande.
MAILBOX_POST_WRITE_WRONG_MESSAGE	Beskeden indeholder ulovlige ord.
MAILBOX_POST_WRITE_WRONG_TITLE	Emnet indeholder ulovlige ord.
MALL_CANNOT_INSERT	Du kan ikke placere den genstand.
MALL_PASSWORD_TITLE	Kodeord
MAP_A1	Område Yongan
MAP_A2	Seungryong Dal
MAP_A2_1	
MAP_A3	Område Yayang
MAP_AG	Jungrang
MAP_B1	Område Joan
MAP_B2	Imji dalen
MAP_B3	Område Bokjung
MAP_BATTLE_FIELD	Kamp Zone
MAP_BAY	Nefrit bugten
MAP_BAYBLACKSAND	Nefrit bugten
MAP_BG	Waryong
MAP_BOSS_AWAKEN_DAWNMIST	GO: Fortryllede Skov
MAP_BOSS_AWAKEN_FLAME	GO: Røde Drages Fort
MAP_BOSS_AWAKEN_SKIPIA	GO: Forbandelsens Grotte
MAP_BOSS_AWAKEN_SNOW	GO: Nemere's Vagttårn
MAP_BOSS_CRACK_DAWNMIST	TS: Fortryllede Skov
MAP_BOSS_CRACK_FLAME	TS: Røde Drages Fort
MAP_BOSS_CRACK_SKIPIA	TS: Forbandelsens Grotte
MAP_BOSS_CRACK_SNOW	TS: Nemere's Vagttårn
MAP_BOSS_LABYRINTH	Illusionernes Højslette
MAP_C1	Område Pyungmoo
MAP_C2	Bangsan dalen
MAP_C3	Område Bakra
MAP_CAPE	Kap Drageild
MAP_CAPEDRAGONHEAD	Kap Drageild
MAP_CG	Imha
MAP_CZ_DUNGEON	Zodiac Tempel
MAP_DAWN	Gautama Klippe
MAP_DAWNMISTWOOD	Gautama Klippe
MAP_DAWNMIST_DUNGEON_01	Fortryllet skov
MAP_DEFENSE_WAVE	Skibs Forsvar
MAP_DEFENSE_WAVE_PORT	Havn
MAP_DESERT	Yongbi-ørken
MAP_DEVILCATACOMB	Djævelens katakomb
MAP_DEVILTOWER1	Dæmon tårn
MAP_DUEL	Træningskamp område
MAP_E	Koloni
MAP_EMPIREWAR01	Slots-kamp
MAP_EMPIREWAR02	Slots-kamp
MAP_EMPIREWAR03	Slots-kamp
MAP_FLAME	Doyyumhwan
MAP_GUILD_01	Jungrang
MAP_GUILD_02	Waryong
MAP_GUILD_03	Imha
MAP_GUILD_PVE	Drage Kongens Palads
MAP_HOLYPLACE_DESERT	Ørkenland Nationskrig
MAP_HOLYPLACE_FLAME	Ildland Nationskrig
MAP_HOLYPLACE_ICE	Island Nationskrig
MAP_MILGYO	Hwang Tempel
MAP_MILGYO_A	
MAP_MINIBOSS_01	Blåt Fangehul  Lvl 40-80
MAP_MINIBOSS_02	Rødt Fangehul  Lvl 81+
MAP_MISTS_OF_ISLAND	Tågens Ø
MAP_MONKEY_DUNGEON	Hasun Dong
MAP_MONKEY_DUNGEON2	Jungsun Dong
MAP_MONKEY_DUNGEON3	Sangsun Dong
MAP_MONKEY_DUNGEON_11	Hasun Dong
MAP_MONKEY_DUNGEON_12	Hasun Dong
MAP_MONKEY_DUNGEON_13	Hasun Dong
MAP_MT_THUNDER	Tordenbjergene
MAP_MT_TH_DUNGEON_01	Ochao Tempel
MAP_NUSLUCK	Kæmpernes land
MAP_NUSLUCK01	Kæmpernes land
MAP_N_DESERT_01	Yongbi-Ørken
MAP_N_DESERT_02	
MAP_N_FLAME_01	Ildland
MAP_N_FLAME_02	
MAP_N_FLAME_DRAGON	Meleys Grotte
MAP_N_FLAME_DUNGEON_01	Rød Drageborg
MAP_N_SNOWM_01	Bjerget Sohan
MAP_N_SNOWM_02	
MAP_N_SNOW_DUNGEON_01	Nemeres vagttårn
MAP_N_THREEWAY	Seungryong Dalen
MAP_OXEVENT	OX turnering
MAP_PATHWAY_DESERT_01	Ørkenland Nationskrig
MAP_PATHWAY_DESERT_02	Ørkenland Nationskrig
MAP_PATHWAY_DESERT_03	Ørkenland Nationskrig
MAP_PATHWAY_FLAME_01	Ildland Nationskrig
MAP_PATHWAY_FLAME_02	Ildland Nationskrig
MAP_PATHWAY_FLAME_03	Ildland Nationskrig
MAP_PATHWAY_ICE_01	Island Nationskrig
MAP_PATHWAY_ICE_02	Legeplads
MAP_PATHWAY_ICE_03	Island Nationskrig
MAP_SKELTOWER	Gumsan-Tårn
MAP_SKIPIA_DUNGEON_01	Forbandelsens grotte
MAP_SKIPIA_DUNGEON_011	
MAP_SKIPIA_DUNGEON_012	
MAP_SKIPIA_DUNGEON_013	
MAP_SKIPIA_DUNGEON_02	Forbandelsens grotte 2
MAP_SKIPIA_DUNGEON_021	
MAP_SKIPIA_DUNGEON_022	
MAP_SKIPIA_DUNGEON_023	
MAP_SKIPIA_DUNGEON_BOSS	Dragens tempel
MAP_SKIPIA_DUNGEON_BOSS_1	Edderkoppe grotte 1
MAP_SKIPIA_DUNGEON_BOSS_2	Edderkoppe grotte 2
MAP_SKIPIA_DUNGEON_BOSS_3	Edderkoppe grotte 3
MAP_SNOW	Bjerget Sohan
MAP_SPIDER	Kuahlo Dong
MAP_SPIDERDUNGEON	Edderkoppe grotte 1
MAP_SPIDERDUNGEON_02	Edderkoppe-grotte 2
MAP_SPIDERDUNGEON_02_1	Edderkoppe grotte 2
MAP_SPIDERDUNGEON_03	Edderkoppe grotte 3
MAP_SUNGZI	Nationskrig
MAP_SUNGZI_DESERT_01	Ørkenland Nationskrig
MAP_SUNGZI_DESERT_HILL_01	Ørkenland Nationskrig
MAP_SUNGZI_DESERT_HILL_02	Ørkenland Nationskrig
MAP_SUNGZI_DESERT_HILL_03	Ørkenland Nationskrig
MAP_SUNGZI_FLAME_HILL_01	Ildland Nationskrig
MAP_SUNGZI_FLAME_HILL_02	Ildland Nationskrig
MAP_SUNGZI_FLAME_HILL_03	Ildland Nationskrig
MAP_SUNGZI_SNOW	Island Nationskrig
MAP_SUNGZI_SNOW_PASS01	Island Nationskrig
MAP_SUNGZI_SNOW_PASS02	Island Nationskrig
MAP_SUNGZI_SNOW_PASS03	Island Nationskrig
MAP_T1	Ordenskrigs område
MAP_T2	Ordenskrigs område
MAP_T3	Ordenskrigs område
MAP_T4	Ordenskrigs område
MAP_TEMPLE	Hwang-Tempel
MAP_THUNDER	Tordenbjergene
MAP_TREE	Lungsam
MAP_TRENT	Åndeskov
MAP_TRENT02	Rød skov
MAP_TRENT02_A	Rød skov
MAP_TRENT_A	
MAP_WEDDING_01	Bryllups kort
MAP_WL	Slangeområde
MAP_WL_01	Slangeområde
MC_ACCUMULATION_COUNT	Indsamlede Monster Kort: %d
MC_ALTER_TEXT	Mission level: %d
MC_CARD_FALL_SHORT	Ikke nok registrerede kort.
MC_CARD_SHUFFLE	Vil du blande kortene?
MC_INIT_ITEM_FALL_SHORT	Du skal bruge %d Nulstillings Billet(ter).
MC_MISSION_FAIL_MSG	Ingen aktiv mission eller begrænsning nået.
MC_MISSION_INIT	Ønsker du at nulstille missionen til level 1?
MC_MISSION_NO_CLEAR	Du skal gennemføre missionen først.
MC_MOTION_BUTTON_OVER_MSG	Denne mulighed aktiveres først ved 2 stjerner.
MC_POLY_BUTTON_OVER_MSG	Denne mulighed aktiveres først ved 3 stjerner.
MC_POLY_FAIL	Du kan ikke transformere lige nu.
MC_POLY_QUESTION	Ønsker du at transformere om til dette monster?
MC_PROMOTION_MAX	Kan ikke forfremmes yderligere.
MC_PROMOTION_QUESTION	Vil du øge level?
MC_QUESTION_BUTTON_DESC1	Kan kun blive nulstillet 6 gange indenfor 24 timer.
MC_QUESTION_BUTTON_DESC2	Hver efterfølgende nulstilling kræver flere Nulstillings Billetter.
MC_QUESTION_BUTTON_DESC3	Klik her for at vise den tilbageværende nedkølings tid.
MC_REWARD_FAIL	Der er ikke nok plads i dit inventar.
MC_REWARD_MISSION	Vil du tage imod dit Monster Kort nu?
MC_SHUFFLE_NO_ITEM	Du har ikke en Omblandings Billet.
MC_TIME	Klargørings-tid: %s
MC_TRADE_QUESTION	%d kort vil blive trukket fra. Vil du fortsætte?
MC_USE_ITEM_FAIL	Disse kort kan ikke tilføjes.
MC_USE_ITEM_QUESTION	Vil du tilføje dette Monster Kort?
MC_WARP_BUTTON_OVER_MSG	Denne mulighed aktiveres først ved 4 stjerner.
MC_WARP_FAIL	Du kan ikke teleportere yderligere.
MC_WARP_LIMIT_LEVEL	Dit nuværende level er ikke højt nok til at teleportere.
MC_WARP_QUESTION	Vil du teleportere til dette monsters område?
MD_POPUP_MSG_1	Du kan kun komme ind fra Zodiac Templet.
MD_POPUP_MSG_2	Zodiac Vagterne skal lige komme sig.\nGiv dem noget tid.
MD_SYSTEM_MSG_1	Du er ikke en zombie. Du kan ikke kæmpe når du er død.
MEDAL_OF_HONOR	Tapperheds Medalje
MEDAL_OF_HONOR_SYSTEM_PICK	Genstand modtaget: Tapperheds Medalje x %d
MESSENGER_ADD_BLOCK_FRIEND	Tilføj
MESSENGER_ADD_FRIEND	Tilføj ven
MESSENGER_BLOCK	Blokeret
MESSENGER_DO_YOU_ACCEPT_ADD_FRIEND_1	%s har accepteret dig som ven.
MESSENGER_DO_YOU_ACCEPT_ADD_FRIEND_2	Accepter?
MESSENGER_DO_YOU_DELETE	Slet?
MESSENGER_DO_YOU_DELETE_PHONE_NUMBER	Vil du slette mobilnr.?
MESSENGER_DO_YOU_MOVE	Vil du fortsætte?
MESSENGER_EMPTY_LIST	Tom
MESSENGER_FAMILY	Familie
MESSENGER_FRIEND	Venner
MESSENGER_GUILD	Orden
MESSENGER_INPUT_MOBILE_AUTHORITY_DESCRIPTION	Indtast bekræftigelses-koden der blev sendt til dit mobilnr.
MESSENGER_INPUT_MOBILE_AUTHORITY_TITLE	Indtast bekræftigelses-kode
MESSENGER_INPUT_MOBILE_PHONE_NUMBER_1	Indtast mobilnr. for SMS-tilsending.
MESSENGER_INPUT_MOBILE_PHONE_NUMBER_2	Vil du indtaste dette nr.?
MESSENGER_INPUT_MOBILE_PHONE_NUMBER_TITLE	Angiv mobilnr.
MESSENGER_SEND_MOBILE_MESSAGE_TITLE	Afsend meddelelse.
METIN_TEST	
MINIGAMEUI_CALENDAR	Event Kalender
MINIGAME_FISH_EVENT_ADD_ACCEPT	Ønsker du at tilføje dette?
MINIGAME_FISH_EVENT_DROP_ACCEPT	Ønsker du virkelig at droppe denne genstand?
MINIGAME_FISH_EVENT_REWARD_MSG	Du har modtaget %s.
MINIGAME_FISH_EVENT_USE_ACCEPT	Ønsker du at bruge dette?
MINIMAP	Åben Minimap
MINIMAP_CANNOT_SEE	Minikort kan ikke vises.
MINIMAP_CAN_NOT_SHOW_AREAMAP	Kortet kan ikke vises.
MINIMAP_DEC_SCALE	Minimer
MINIMAP_INC_SCALE	Maximer
MINIMAP_OBSERVER_COUNT	%d tilskuer
MINIMAP_OPEN_INGAMEEVENT	Events
MINIMAP_SHOW_AREAMAP	Åben stort kort
MINI_GAME_BNW_DONATE_QUESTION1	Ønsker du at donere?
MINI_GAME_BNW_DONATE_QUESTION2	En donation koster 15 Seer Mønter.
MINI_GAME_BNW_FONT	Arial:15
MINI_GAME_BNW_GAME_GIVEUP_MSG1	Ønsker du virkelig at forlade spillet?
MINI_GAME_BNW_GAME_GIVEUP_MSG2	Husk at du kan optjene belønninger, hvis du vinder.
MINI_GAME_BNW_GAME_RESULT_DRAW	Uafgjort! Du har optjent %d Seer Mønt(er).
MINI_GAME_BNW_GAME_RESULT_LOSE	Besejret! Du har optjent %d Seer Mønt(er).
MINI_GAME_BNW_GAME_RESULT_SCORE	Score: %d
MINI_GAME_BNW_GAME_RESULT_WIN	Sejr! Du har optjent %d Seer Mønt(er).
MINI_GAME_BNW_NOT_ENOUGH_INVEN	Der er ikke nok plads i dit inventar.
MINI_GAME_BNW_NOT_ENOUGH_ITEM	Du skal bruge et Tarot Sæt for at spille.
MINI_GAME_BNW_NOT_ENOUGH_YANG	Du har ikke nok Yang til at starte spillet.
MINI_GAME_BNW_RESULT_DRAW1	Dit nummer er den samme.
MINI_GAME_BNW_RESULT_DRAW2	Uafgjort!
MINI_GAME_BNW_RESULT_LOSE1	Dit nummer er mindre.
MINI_GAME_BNW_RESULT_LOSE2	Besejret!
MINI_GAME_BNW_RESULT_WIN1	Dit nummer er større.
MINI_GAME_BNW_RESULT_WIN2	Sejr!
MINI_GAME_BNW_START_QUESTION	Du skal bruge et Tarot Sæt og 30.000 Yang for at spille. Ønsker du at deltage i Seernes Duel?
MINI_GAME_CATCHKING_CHALLENGE_TOOLTIP1	Hvis du satser flere %s, vil du blive belønnet med det samme antal kister.
MINI_GAME_CATCHKING_CHALLENGE_TOOLTIP2	Højeste satsning: %d Konge Dæk.
MINI_GAME_CATCHKING_HELP_MSG1	Sikke en skam! Dit korts værdi er lavere. \nDu optjener ikke nogen point. Vælg et nyt kort fra dit dæk.
MINI_GAME_CATCHKING_HELP_MSG2	Flot arbejde! Kortene har den samme værdi.\nDin tur er slut. Vælg et nyt kort fra dit dæk.
MINI_GAME_CATCHKING_HELP_MSG3	Fortsæt! Dit korts værdi er højere.\nVend et andet kort.
MINI_GAME_CATCHKING_HELP_MSG4	Der var et [5] inden for rækkevidde af det kort du afslørede.\nDesværre optjener du ikke nogen point. Vælg din Konge [K] nu.
MINI_GAME_CATCHKING_POPUP_CATCH_FAIL	Kongen slap væk! Spillet er slut. \nHvis du har optjent mindst 10 point, kan du nu indløse din præmie.
MINI_GAME_CATCHKING_POPUP_REWARD_FAIL	Du kan ikke indløse nogen præmie.
MINI_GAME_CATCHKING_SEARCH_NUMBER5	Der er en [5] i nærheden.
MINI_GAME_CATCHKING_START_QUESTION	Du skal betale følgende for et spil: %d Yang og %s: %d lots\nVil du gerne spille nu?
MINI_GAME_CATCHKING_TOOLTIP_CARD1	Kan fange følgende kort: [1]
MINI_GAME_CATCHKING_TOOLTIP_CARD2	Kan fange følgende kort: [1], [2]
MINI_GAME_CATCHKING_TOOLTIP_CARD3	Kan fange følgende kort: [1], [2], [3]
MINI_GAME_CATCHKING_TOOLTIP_CARD4	Kan fange følgende kort: [1], [2], [3], [4]
MINI_GAME_CATCHKING_TOOLTIP_CARD5	Kan fange følgende kort: [1], [2], [3], [4], [5]\nHvis et andet [5] er nabo til det kort som du afsløre,\nvil din tur ende og du vil ikke modtage nogen point.
MINI_GAME_CATCHKING_TOOLTIP_CARD6	Kan fange følgende kort: [K]
MINI_GAME_CATCHKING_TOOLTIP_SCORE1	%s: 550 eller mere
MINI_GAME_CATCHKING_TOOLTIP_SCORE2	%s: 400 til 549
MINI_GAME_CATCHKING_TOOLTIP_SCORE3	%s: 10 til 399
MINI_GAME_CATCHKING_TOOLTIP_SCORE4	Du optjener 10 bonus point hvis du afsløre alle kortene i træk.
MINI_GAME_GIVEUP_QUESTION	Ønsker du virkelig at forlade spillet? Du vil ikke modtage nogen belønning.
MINI_GAME_NOTICE_1	Klik på 'Kast' for at bestemme start spilleren.
MINI_GAME_NOTICE_10	Ha! Du slog computeren ud!
MINI_GAME_NOTICE_11	Uheldigt! Computeren har slået dig ud.
MINI_GAME_NOTICE_12	Du havde Yut eller Mo og kan kaste igen.
MINI_GAME_NOTICE_13	Spillet er slut. Modtag din belønning.
MINI_GAME_NOTICE_2	Kast Yut Pinde.
MINI_GAME_NOTICE_3	Computeren kaster Yut Pinde for at bestemme start spilleren.
MINI_GAME_NOTICE_4	Det blev uafgjort eller computeren havde det lavest talte kast. Computeren vil begynde.
MINI_GAME_NOTICE_5	Du havde det lavest talte kast og vil begynde.
MINI_GAME_NOTICE_6	Dit kast: %s. Bevæg dig frem %d plads(er).
MINI_GAME_NOTICE_7	Dit kast: %s. Du skal bevæge dig 1 plads tilbage.
MINI_GAME_NOTICE_8	Kast: %s
MINI_GAME_NOTICE_9	Det er computerens tur.
MINI_GAME_RUMI_DISCARD_QUESTION	Vil du virkelig afskaffe dette kort?
MINI_GAME_RUMI_EXIT_QUESTION	Ønsker du at afslutte spillet og hente din præmie?\nDin score og resterende kort vil herefter blive nulstillet!
MINI_GAME_RUMI_START_QUESTION	Du skal betale et gebyr på %d Yang for at kunne spille. Du skal også bruge %d Kortsæt.\nVil du starte spillet?
MINI_GAME_YUTNORI_COM_WIN	Du vinder nogen, du taber nogen.
MINI_GAME_YUTNORI_PC_WIN	Til sejreren går byttet!
MINI_GAME_YUTNORI_PC_WIN_SCORE	Score: %d
MINI_GAME_YUTNORI_RETHROW_BUTTON	Kast
MINI_GAME_YUTNORI_RETHROW_POPUP	Heldig djævel! Det er din tur igen.
MINI_GAME_YUTNORI_SCORE_FONT	Tahoma:24b
MINI_GAME_YUTNORI_START_QUESTION	Du har brug for %d Yang og %d Yut Nori Bræt for at starte et spil Yut Nori. \n Spil nu?
MINUTE	min
MISTS_ISLAND_BUFF_MSG_01	Energi +2
MISTS_ISLAND_BUFF_MSG_02	Genstandens Smidnings Sats +10%
MISTS_ISLAND_BUFF_MSG_03	Styrke, Intelligens, Vitalitet, Smidighed +3
MISTS_ISLAND_BUFF_MSG_04	Yang Smidnings Sats +10%
MISTS_ISLAND_BUFF_MSG_05	Kostume Bonusser +3%
MISTS_ISLAND_INFO_01	Din level er for lavt.
MISTS_ISLAND_INFO_02	Ikke nok Yang.
MISTS_ISLAND_INFO_03	Ingen kampe finder sted i øjeblikket.
MISTS_ISLAND_MSG_01	%s er blevet ødelagt af %s!
MISTS_ISLAND_MSG_02	%s har fanget %s!
MISTS_ISLAND_MSG_03	%s har optaget %s!
MISTS_ISLAND_MSG_04	%s angriber %s!
MISTS_ISLAND_MSG_05	%s har opgraderet %s til level %d med succes!
MISTS_ISLAND_MSG_06	%s er kommet frem på slagmarken!
MISTS_ISLAND_QUESTION_01	Ønsker du at forlade Kampen om de Fem Helligdomme?
MISTS_ISLAND_QUESTION_02	Ønsker du at teleportere dig til den senest angrebene helligdom? \n Koster: %s Yang
MISTS_ISLAND_TOOLTIP_01	[%s]
MISTS_ISLAND_TOOLTIP_02	Besætter Riget: %s
MISTS_ISLAND_TOOLTIP_03	Forbedrings Level: +%d
MISTS_ISLAND_TOOLTIP_04	Besættelses Buff: %s
MISTS_ISLAND_TOOLTIP_05	Erobre Helligdommene
MISTS_ISLAND_TOOLTIP_06	1. For at kunne fange en helligdom, skal den først ødelægges.
MISTS_ISLAND_TOOLTIP_07	2. Det rige som har flest kombattanter i nærheden efter 1 minut, vil fange helligdommen.
MISTS_ISLAND_TOOLTIP_08	3. Efter 3 minutter, vil helligdommen komme frem igen i de rigets farver som har fanget den.
MISTS_ISLAND_TOOLTIP_09	4. Jo længere en helligdom har været under kontrol af det samme rige, jo svære vil den være at ødelægge.
MONETARY_UNIT0	Yang
MONETARY_UNIT1	titusind
MONETARY_UNIT2	hundrede millioner
MONEY_INPUT_DIALOG_SELLPRICE	Salgspris:
MOVE_CHANNEL_99	CH0
MOVE_CHANNEL_CANCEL	Annuller
MOVE_CHANNEL_NOTICE	Du er forbundet til kanal %d.
MOVE_CHANNEL_NOT_MOVE	Du kan ikke skifte din kanal.
MOVE_CHANNEL_SELECT	OK
MOVE_CHANNEL_TITLE	Kanaler
MOVE_ITEM_FAILURE_PRIVATE_SHOP	Du kan ikke flytte genstande mens du har en privat butik åben.
MUSIC_EMPTY_MUSIC_LIST	Ingen baggrundsmusik.
MUSIC_METIN2_DEFAULT_THEMA	Metin2-Standardmusik
MUSIC_NOT_SELECT_MUSIC	Du har ikke valgt nogen musikfil.
NEEFD_REST	Du bliver nød til at hvile dig.
NOT_YET_SUPPORT	Bliver ikke understøttet.
OPEN_THE_SPECIAL_ACTION_KIT	%s tilføjet til følelser.
OPTION_PVPMODE_CANNOT_SET_GUILD_MODE	Du kan ikke aktivere Ordens-mode, hvis du ikke er medlem i en Orden.
OPTION_PVPMODE_NOT_SUPPORT	Du kan ikke bruge denne PvP-konfiguration.
OPTION_PVPMODE_PROTECT	Du skal mindst have opnået Level %d for at ændre PvP-konfigurationen.
PARTY_ANSWER_TIMEOVER	Invitationen blev afvist.
PARTY_BONUS_ATTACKER	Angrebsværdi: +%d	SA
PARTY_BONUS_BERSERKER	Angrebshastighed: +%d	SA
PARTY_BONUS_BUFFER	Færdighedslængde: +%d	SA
PARTY_BONUS_DEFENDER	Forsvar: +%d	SA
PARTY_BONUS_EXP	Bonus-erfaring: %d%%	SA
PARTY_BONUS_SKILL_MASTER	Max. MP: +%d	SA
PARTY_BONUS_TANKER	Max HP: +%d	SA
PARTY_BREAK_UP	Fjern gruppe
PARTY_DO_YOU_ACCEPT	 vil være med i gruppen.
PARTY_DO_YOU_JOIN	 har inviteret dig til gruppen. Accepter?
PARTY_EXP_DISTRIBUTION_MODE	EXP-fordeling
PARTY_EXP_DISTRIBUTION_MODE_LEVEL	Level-fordeling
PARTY_EXP_DISTRIBUTION_MODE_LEVEL_TOOLTIP	Højere level får mere EXP.
PARTY_EXP_DISTRIBUTION_MODE_PARITY	Jævn fordeling
PARTY_EXP_DISTRIBUTION_MODE_PARITY_TOOLTIP	Alle gruppemedlemmer får samme EXP.
PARTY_HEAL_ALL_MEMBER	Gendan alt
PARTY_INCREASE_AREA_150	Gruppens rækkevidde blev øget med en faktor 1,5.	SNA
PARTY_INCREASE_AREA_200	Gruppens rækkevidde blev øget med en faktor 2.	SNA
PARTY_LEAVE	Forlad gruppen.
PARTY_LONGTIME_BONUS_EXP	Bonus-EXP for langt gruppespil: +%d%%	SA
PARTY_MATCH_CANCEL	Gruppe søgningen for %s er blevet annulleret.
PARTY_MATCH_FAIL_FULL_MEMBER	Din gruppe kan ikke acceptere flere medlemmer.
PARTY_MATCH_FAIL_IMPOSSIBLE_MAP	Du kan ikke registrere dig til denne fangehul.
PARTY_MATCH_FAIL_LEVEL	Din level er for lavt.
PARTY_MATCH_FAIL_MEMBER_NOT_CONDITION	Medlemmet %s opfylder ikke de nødvendige krav.
PARTY_MATCH_FAIL_NONE_MAP_INDEX	Vælg venligst et fangehul først.
PARTY_MATCH_FAIL_NOT_LEADER	Kun gruppe lederen kan registrer.
PARTY_MATCH_FAIL_NO_ITEM	Du har ikke nok %s.
PARTY_MATCH_SEARCHING	Søg
PARTY_MATCH_START	Du har registreret din gruppe til følgende fangehul: %s!
PARTY_MEMBER_OFFLINE	[Offline]
PARTY_RECALL_MEMBER	Kald gruppemedlemmer.
PARTY_REGEN_BONUS	Bonus for HP- og MP-regeneration: +%d%%	SA
PARTY_REQUEST_DENIED	Du har afvist gruppe-invitationen.
PARTY_RK_CATEGORY_CZ_CHICKEN	You Vagt Rangliste
PARTY_RK_CATEGORY_CZ_COW	Chou Vagt Rangliste
PARTY_RK_CATEGORY_CZ_DOG	Xu Vagt Rangliste
PARTY_RK_CATEGORY_CZ_DRAGON	Chen Vagt Rangliste
PARTY_RK_CATEGORY_CZ_HORSE	Wu Vagt Rangliste
PARTY_RK_CATEGORY_CZ_MONKEY	Shen Vagt Rangliste
PARTY_RK_CATEGORY_CZ_MOUSE	Zi Vagt Rangliste
PARTY_RK_CATEGORY_CZ_PIG	Hai Vagt Rangliste
PARTY_RK_CATEGORY_CZ_RABBIT	Mao Vagt Rangliste
PARTY_RK_CATEGORY_CZ_SHEEP	Wei Vagt Rangliste
PARTY_RK_CATEGORY_CZ_SNAKE	Si Vagt Rangliste
PARTY_RK_CATEGORY_CZ_TIGER	Yin Vagt Rangliste
PARTY_SET_ATTACKER	Definer som angriber.
PARTY_SET_BERSERKER	Definer som Berserker.
PARTY_SET_BUFFER	Definer som Blocker.
PARTY_SET_DEFENDER	Definer som forsvar.
PARTY_SET_NORMAL	Fjern indstillingerne.
PARTY_SET_SKILL_MASTER	Definer som færdighedsmester.
PARTY_SET_TANKER	Indstil til nærkamp.
PARTY_SKILL_ATTACKER	Basis-angrebsværdi angriber +%.0f	
PARTY_SKILL_BERSERKER	Angrebshastighed Berserker +%.0f
PARTY_SKILL_BUFFER	Færdighedslængde blokering +%.0f
PARTY_SKILL_DEFENDER	Forsvar forsvarer +%.0f
PARTY_SKILL_HP_REGEN	HP-regeneration +%.0f%%
PARTY_SKILL_PARTY_AREA	Grupperækkevidde +%d%%
PARTY_SKILL_SKILL_MASTER	Max. MP færdighedsmester +%.0f
PARTY_SKILL_SP_REGEN	MP-regeneration +%.0f%%
PARTY_SKILL_TANKER	Max. HP nærkamp +%.0f
PARTY_SKILL_WARP	Kan påkalde gruppemedlemmer.
PASSWORD_TITLE	Gem kodeord
PET_ATTR_CHANGE_DIALOG_TEXT	Kunne du tænke dig at ændre dit kæledyrs egenskaber nu?\n'Fortryl Kæledyr' genstanden vil blive brugt i denne proces.\nProcessen kan mislykkes.
PET_ATTR_CHANGE_USE	Denne handling kan ikke udføres mens kæledyrets egenskaber bliver ændret.
PET_ATTR_DETERMINE_TYPE1	Kæledyr Type 1: klodset. Ikke særlig stærk.\nEfter noget tid kan du forbedre dens færdigheder.
PET_ATTR_DETERMINE_TYPE2	Kæledyr Type 2: nysgerrig. Ikke særlig stærk.\nEn loyal ledsager hvis færdigheder vil forbedre sig med tiden.
PET_ATTR_DETERMINE_TYPE3	Kæledyr Type 3: åndrig. Gennemsnitlig styrke.\nEfter noget tid kan du forbedre dens færdigheder.
PET_ATTR_DETERMINE_TYPE4	Kæledyr Type 4: modig. Gennemsnitlig styrke.\nEn loyal ledsager hvis færdigheder vil forbedre sig med tiden.
PET_ATTR_DETERMINE_TYPE5	Kæledyr Type 5: dristig. Stærk.\nEfter noget tid kan du forbedre dens færdigheder endnu mere.
PET_ATTR_DETERMINE_TYPE6	Kæledyr Type 6: legendarisk. Stærk.\nEn loyal ledsager hvis færdigheder vil forbedre sig endnu mere med tiden.
PET_ATTR_DETERMINE_TYPE7	Kæledyr Type 7: mytisk. Meget stærk.\nDen vil nå dens fulde potentiale efter noget tid.
PET_ATTR_DETERMINE_TYPE8	Kæledyr Type 8: prismatisk. Ekstrem stærk.\nEn loyal ledsager som du altid kan stole på.
PET_BAG_DESC	%s
PET_CANNOT_FEED_CUBEOPEN	Du kan ikke fodre dit kæledyr mens forædlings vinduet er åbent.
PET_CAN_NOT_ATTRCHANGE_BECUASE_LIFE_TIME_END	Du kan ikke ændre egenskaberne på en død kæledyr.
PET_CAN_NOT_EGG_ITEM_USE	Du kan ikke åbne din Inkubator mens du handler, eller mens du har dit lagerrum eller en privat butik åben.
PET_CAN_NOT_FEED_SPLIT_ITEM	Du kan ikke placere nogle delte genstande i dette vindue.
PET_CAN_NOT_FEED_TYPE	Du kan ikke fodre dit kæledyr med dette. Prøv venligst med noget andet.
PET_CAN_NOT_OPEN_EVOL_BUTTON	Dit kæledyr skal være level %d for at kunne træne og fremme det til næste stadie af udviklingen.
PET_CAN_NOT_OPEN_EVOL_BUTTON_EXP_LACK	Dit kæledyr skal have 100% erfaring for at kunne træne og fremme det til næste stadie af udviklingen.
PET_CAN_NOT_OPEN_EVOL_BUTTON_LEVEL_MAX	Dit kæledyr har allerede opnået det højeste stadie inden for udviklingen.
PET_CAN_NOT_OPEN_SHOP_BECAUSE_SUMMON	Du kan ikke åbne en privat butik når du har tilkaldt dit kæledyr.
PET_CAN_NOT_OPEN_SPECIAL_EVOL_BUTTON	Dit kæledyr skal være %d dage gammel for at kunne træne og fremme det til næste stadie af udviklingen.
PET_CAN_NOT_SUMMON_BECAUSE_LIFE_TIME_END	Du kan ikke kalde på dit kæledyr, fordi varigheden er udløbet.
PET_CAN_NOT_USE_BAG	Du kan ikke benytte Transportkassen, fordi dit kæledyr allerede er udløbet.
PET_EMPTY_SKILL_SLOT_USE_ITEM	Kæledyret har ikke nogen færdigheder at nulstille.
PET_HATCHING_ACCEPT	Ønsker du at tilkalde dit kæledyr '%s'?
PET_HATCHING_MONEY	Pris: %s
PET_HATCHING_WINDOW_OPEN_CAN_NOT_USE	Du kan ikke udføre andre handlinger mens Inkubatoren er åben.
PET_INFORMATION_STAGE1	Ung
PET_INFORMATION_STAGE2	Vild
PET_INFORMATION_STAGE3	Tapper
PET_INFORMATION_STAGE4	Heroisk
PET_INFO_EXP	Nuværende erfaring:
PET_INFO_ITEM_EXP	Nuværende genstand EXP
PET_INFO_NEXT_EXP	Tilbageværende erfaring:
PET_INFO_NEXT_ITEM_EXP	Resterende genstand EXP
PET_MSG_NOT_ENOUGH_MONEY	Du har ikke nok Yang.
PET_NAME_CHANGE_ACCEPT	Vil du skifte dit kæledyrs navn til %s?
PET_NAME_MIN	Det indtastede navn er for kort.
PET_REVIVE_FAIL_EMPTY_PET_SLOT	Der er ingen kæledyr at genoplive.
PET_REVIVE_FAIL_NOT_ENOUGHT_MATERIAL	Du har ikke nok materialer.
PET_REVIVE_UI_MATERIAL_COUNT	%d/%d
PET_SKILL_DELETE_QUESTION_DLG_MSG	Færdigheder er nu tilgængelige.
PET_SKILL_DELETE_QUESTION_DLG_MSG1	Nulstilling af dit kæledyrs færdighed(er) kan ikke fortrydes.
PET_SKILL_DELETE_QUESTION_DLG_MSG2	Ønsker du at fortsætte?
PET_SKILL_LEARN_FAIL_CONDITIONS	Dit kæledyr er ikke gammelt nok eller har ikke den nødvendige level. Kun heroiske kæledyr kan lære færdigheder.
PET_SKILL_LEARN_QUESTION_DLG_MSG	Ønsker du at starte helte træning med '%s'?
PET_SKILL_TOOLTIP_COOLTIME	Klargørings-tid: %s sekunder
PET_SKILL_TOOLTIP_DURATION	Varighed: %d sekunder
PET_SKILL_TOOLTIP_FEATHER	Kæledyret har en %d%% chance for at aktivere Fjervandring i %.1f sekunder.\n Angrib %d - %d	SAAAA
PET_SKILL_TOOLTIP_HEAL	Når din HP falder til under 20%%, har du \n en %d%% chance for t øge din HP med %d.	SAA
PET_SKILL_TOOLTIP_INVINVIBILITY	Din karakter har en %d%% chance for at blive usynlig\n når din HP falder til under 10%%. \n Effekt varighed: %.1f sekunder.	SAA
PET_SKILL_TOOLTIP_REMOVAL	Der er en %d%% chance for med det samme at fjerne \n alle effekter såsom langsom, gift eller blødning, hvis din\n karakter er påvirket.	SAN
PET_SKILL_UPGRADE_QUESTION_DLG_MSG1	Øg helte træning til næste stadie?
PET_SKILL_UPGRADE_QUESTION_DLG_MSG2	Pris: %s
PET_TOOLTIP_COSTUME_BONUS	
PET_TOOLTIP_DEF	Forsvar
PET_TOOLTIP_HP	HP
PET_TOOLTIP_LEVEL	Level
PET_TOOLTIP_LIFETIME_OVER	Udløbet
PET_TOOLTIP_SKILL_BONUS_VALUE	i helte træning
PET_TOOLTIP_SKILL_CUR_LEVEL	Level: %d
PET_TOOLTIP_SKILL_NEXT_LEVEL	Næste level: %d (maks. %d)
PET_TOOLTIP_SP	MP
PET_TOOLTIP_TRADABLE	Omsættelig
PET_TOOLTUP_SKILL	%s (Stadie %d)
PICK_ITEM_TITLE	Genstandsnr.
PICK_MONEY_TITLE	Bidrag
PRIVATESHOPSEARCH_ABLITY_POTION	Dug
PRIVATESHOPSEARCH_ACCESSORY_SOCKET	Fint tøj
PRIVATESHOPSEARCH_ARMOR	Udstyr
PRIVATESHOPSEARCH_ARROW	Pile
PRIVATESHOPSEARCH_BELL	Klokker
PRIVATESHOPSEARCH_BELT	Bælter
PRIVATESHOPSEARCH_BLEND	Eliksirer
PRIVATESHOPSEARCH_BLOOD_PEARL	Blodrød perle
PRIVATESHOPSEARCH_BLUE_PEARL	Blå perle
PRIVATESHOPSEARCH_BODY	Rustning
PRIVATESHOPSEARCH_BOW	Buer
PRIVATESHOPSEARCH_BUYTIME	Ønsker du at købe den valgte genstand?
PRIVATESHOPSEARCH_CLAW	Kløer
PRIVATESHOPSEARCH_CLEAR_POTION	Eliksirer
PRIVATESHOPSEARCH_COSTUME	Kostumer
PRIVATESHOPSEARCH_COSTUMEBODY	Kostume
PRIVATESHOPSEARCH_COSTUMEHAIR	Frisure
PRIVATESHOPSEARCH_COSTUME_ACCE	Skulderbånd
PRIVATESHOPSEARCH_COSTUME_MOUNT	Ganger
PRIVATESHOPSEARCH_CRYSTAL	Krystal
PRIVATESHOPSEARCH_DAGGER	Knive
PRIVATESHOPSEARCH_DEAD	Død
PRIVATESHOPSEARCH_DETACHMENT	Sten-håndbog
PRIVATESHOPSEARCH_DIAMOND	Diamant
PRIVATESHOPSEARCH_DS	Drage stens alkymist
PRIVATESHOPSEARCH_DS_BLACK	Onyks
PRIVATESHOPSEARCH_DS_BLUE	Safir
PRIVATESHOPSEARCH_DS_GREEN	Jade
PRIVATESHOPSEARCH_DS_RED	Rubin
PRIVATESHOPSEARCH_DS_WHITE	Diamant
PRIVATESHOPSEARCH_DS_YELLOW	Granat
PRIVATESHOPSEARCH_EAR	Øreringe
PRIVATESHOPSEARCH_FAN	Vifter
PRIVATESHOPSEARCH_FISH	Fisk
PRIVATESHOPSEARCH_FOOTS	Sko
PRIVATESHOPSEARCH_GEM	Ædelsten
PRIVATESHOPSEARCH_GIFTBOX	Gaveæsker
PRIVATESHOPSEARCH_HEAD	Hjelme
PRIVATESHOPSEARCH_LIVE	I live
PRIVATESHOPSEARCH_MATERIAL	Materialer
PRIVATESHOPSEARCH_METIN	Åndesten
PRIVATESHOPSEARCH_NECK	Halskæder
PRIVATESHOPSEARCH_NEED_ITEM_BUY	Du kan ikke købe nogen genstande uden det rigtige bundt.
PRIVATESHOPSEARCH_NEED_ITEM_FIND	Du kan ikke søge efter nogen genstande uden det rigtige bundt.
PRIVATESHOPSEARCH_NODELAY_POTION	HP genstande
PRIVATESHOPSEARCH_ORE	Malm
PRIVATESHOPSEARCH_PET	Kæledyrs system
PRIVATESHOPSEARCH_PETAGG	Kæledyrs æg
PRIVATESHOPSEARCH_PETSKILLBOOK	Kæledyrs færdighedsbog
PRIVATESHOPSEARCH_PICK	Spidshakker
PRIVATESHOPSEARCH_POTION	Eliksirer
PRIVATESHOPSEARCH_QUEST	Mission
PRIVATESHOPSEARCH_QUIVER	Kogger
PRIVATESHOPSEARCH_RESOURCE	Genstand forbedring
PRIVATESHOPSEARCH_ROD	Medestænger
PRIVATESHOPSEARCH_SELECTITEM	Genstand valgt
PRIVATESHOPSEARCH_SHIELD	Skjold
PRIVATESHOPSEARCH_SKILLBOOK	Færdighedsbøger
PRIVATESHOPSEARCH_SKILLFORGET	Glemsomhedens Bog
PRIVATESHOPSEARCH_SPECIAL	Forskelligt
PRIVATESHOPSEARCH_STONE	Energi fragmenter
PRIVATESHOPSEARCH_SWORD	En-håndssværd
PRIVATESHOPSEARCH_TREASUREBOX	Kister
PRIVATESHOPSEARCH_TUNING	Dokumenter
PRIVATESHOPSEARCH_TWOSWORD	Tohåndssværd
PRIVATESHOPSEARCH_UNIQUE	Enestående
PRIVATESHOPSEARCH_USEITEM	Forbrugsartikler
PRIVATESHOPSEARCH_USESPECIAL	Forskelligt
PRIVATESHOPSEARCH_WEAPON	Våben
PRIVATESHOPSEARCH_WHITE_PEARL	Hvid perle
PRIVATESHOPSEARCH_WRIST	Armbånd
PRIVATE_SHOP_CANNOT_SELL_ITEM	Du kan ikke sælge denne genstand i private butikker.
PRIVATE_SHOP_CLOSE_QUESTION	Vil du lukke din private butik?
PRIVATE_SHOP_INPUT_NAME_DIALOG_TITLE	Butikkens navn.
PRIVATE_SHOP_INPUT_PRICE_DIALOG_TITLE	Pris
PVP_LEVEL0	Ridderlig
PVP_LEVEL1	Ædel
PVP_LEVEL2	God
PVP_LEVEL3	Venlig
PVP_LEVEL4	Neutral
PVP_LEVEL5	Aggresiv
PVP_LEVEL6	Bedragerrisk
PVP_LEVEL7	Ond
PVP_LEVEL8	Grusom
PVP_MODE_GUILD	PvP - Ordensmode blev aktiveret
PVP_MODE_KILL	PvP - fri blev aktiveret
PVP_MODE_NORMAL	PvP - fred blev aktiveret
PVP_MODE_PROTECT	PvP - beskyttelse blev aktiveret
PVP_MODE_REVENGE	PvP - fjendtlig blev aktiveret
PVP_OPTION_KILL	Fri
PVP_OPTION_NORMAL	Fred
PVP_OPTION_PROTECT	Beskyttelse
PVP_OPTION_REVENGE	Fjendtlig
PVP_TOURNAMENT_DO_NOT_AUTO	Du kan ikke bruge 'angrib automatisk' under PvP turneringen.
QUEST_APPEND	Ny opgave blev modtaget.
QUEST_HOUR	Time(r)
QUEST_MIN	Min.
QUEST_SEC	Sek.
QUEST_TIMEOVER	Tiden er gået
QUEST_UNLIMITED_TIME	Ingen tidsbegrænsning.
QUEST_ZEROSEC	0 Sek.
QUICKSLOT_REGISTER_DISABLE_ITEM	Denne genstand kan ikke aktiveres via hurtigmenuen.
RANKING	Rang
RANKING_BOARD_MEMBER	Medlem
RECEIVE_MESSAGE	%s har sendt dig en meddelelse.
REFINE_COST	Forbedringsomkostninger: %d Yang
REFINE_DESTROY_WARNING	Denne genstand kan gå i stykker ved forædling.
REFINE_DESTROY_WARNING_WITH_BONUS_PERCENT_1	Ønsker du virkelig at opgradere denne genstand?
REFINE_DESTROY_WARNING_WITH_BONUS_PERCENT_2	Hvis du fejler, så vil genstanden blive ødelagt. Ønsker du at fortsætte?
REFINE_DOWN_GRADE_WARNING	Det kan ske at genstanden mister en level.
REFINE_DO_YOU_SEPARATE_METIN	Vil du fjerne alle ånde-stenene?
REFINE_ELEMENT_CHANGE_TEXT	%s har nu %s elementet!
REFINE_ELEMENT_DOWNGRADE_TEXT	Den elementære fortryllelse er blevet nedgraderet.
REFINE_ELEMENT_EXIST	Genstanden har allerede et andet element.
REFINE_ELEMENT_GRADE_MAX	Den højeste elementære fortryllelses level er allerede blevet opnået.
REFINE_ELEMENT_NOT_ENOUGHT_GRADE	Den elementære fortryllelse er kun tilgængelig for +7 våben eller højere.
REFINE_ELEMENT_NOT_ENOUGHT_YANG	Ikke nok Yang.
REFINE_ELEMENT_NOT_EXSIT	Kan ikke bruges med denne genstand.
REFINE_ELEMENT_TEXT_DARK	Mørke +%d
REFINE_ELEMENT_TEXT_EARTH	Jord +%d
REFINE_ELEMENT_TEXT_ELECT	Lyn +%d
REFINE_ELEMENT_TEXT_FIRE	Ild +%d
REFINE_ELEMENT_TEXT_ICE	Is +%d
REFINE_ELEMENT_TEXT_WIND	Vind +%d
REFINE_ELEMENT_UPGRADE_FAIL_TEXT	Elementære fortryllelse mislykkedes.
REFINE_ELEMENT_UPGRADE_SUCCESS_TEXT	Elementære fortryllelse var succesfuldt!
REFINE_FAILURE	Åh nej, det virkede ikke! Vi har fejlet.
REFINE_FAILURE_CAN_NOT_ATTACH	%s kan ikke tilføjes til denne genstand.
REFINE_FAILURE_DEL_ITEM	Forædlingen mislykkedes. Genstanden blev ødelagt.
REFINE_FAILURE_EQUIP_ITEM	Du kan ikke forbedre den udvalgte genstand, da den er i brug.
REFINE_FAILURE_GRADE_DOWN	Forædlingen mislykkedes. Genstandens karakter er blevet reduceret.
REFINE_FAILURE_KEEP_GRADE	Forædlingen mislykkedes. Heldigvis, er genstanden forblevet uskadt.
REFINE_FAILURE_METIN_INSEPARABLE_ITEM	Der kan ikke fjernes en ånde-sten.
REFINE_FAILURE_NEED_BETTER_SCROLL	Du har brug for et detaljeret forbedrings-dokument.
REFINE_FAILURE_NO_GOLD_SOCKET	Der findes ingen guld-indfatning for at tilføje %s .
REFINE_FAILURE_NO_MORE_SOCKET	Du kan ikke tilføje yderligere indfatninger.
REFINE_FAILURE_NO_SOCKET0	Der findes ingen indfatning for at tilføje %s.
REFINE_FAILURE_SOCKET_DISABLE_ITEM	På denne genstand der der ikke tilføjes en indfatning.
REFINE_FAILURE_UPGRADE_DISABLE_ITEM	Denne genstand kan ikke blive forbedret.
REFINE_SUCCESS	Succesfuld forbedringen!
REFINE_SUCCESS_PROBALITY	Forbedrings-sandsynlighed: %d%%
REFINE_WARNING2	Ønsker du at fortsætte?
RESTART_POPUP_GIVEUP_MIST_ISLAND	Du er blevet dræbt i Kampen om de Fem Helligdomme. Du vil nu vende tilbage til landsbyen.
REVIVE_QUESTION	Ønsker du at genoplive %s? Antal Genoplivelses Prismer: %d
REVIVE_SELF_QUESTION	Ønsker du at genoplive dig selv? Antal Genoplivelses Prismer: %d
ROULETTE_REWARD_TEXT	Indsaml Genstand
SAFEBOX_ERROR	Du har indtastet et forkert kodeord.
SAFEBOX_NEED_CHANGE_PASSWORD	Dit kodeord er udløbet.\nVælg venligst et nyt et.
SAFEBOX_SELL_DISABLE_SAFEITEM	Du kan ikke sælge gemte genstande.
SAFEBOX_UNAVILABLE_PASSWORD_01	Du kan ikke bruge dette kodeord.
SAFEBOX_UNAVILABLE_PASSWORD_02	Dit kodeord burde mindst bestå af %d karakterer.
SAFEBOX_UNAVILABLE_PASSWORD_03	Du har indtastet dit nuværende kodeord. Vælg venligst et nyt et.
SAFEBOX_UNAVILABLE_PASSWORD_04	Dit kodeord må ikke indeholde %d identiske eller fortløbende tal.
SAFEBOX_UNAVILABLE_PASSWORD_05	Ingen specialtegn er tilladt. Tilladte tegn: a-z, A-Z, 0-9
SAFEBOX_WRONG_PASSWORD	Kodeorderne skal være identiske.
SCREENSHOT_SAVE1	er gemt i
SCREENSHOT_SAVE2	Screenshot-mappen
SCREENSHOT_SAVE_FAILURE	Der opstod en fejl. Screenshottet blev ikke gemt.
SECOND	Sek
SECOND_CONFIRM_PET_FEED_QUESTION_1	Din genstand har %d eller flere bonusser.
SECOND_CONFIRM_PET_FEED_QUESTION_2	Er du sikker på at du gerne vil fodre den til dit kæledyr?
SECOND_CONFIRM_SELL_ITEM_QUESTION_1	Din genstand har %d eller flere bonusser.
SECOND_CONFIRM_SELL_ITEM_QUESTION_2	Er du sikker på at du gerne vil sælge den?
SELECT_ATTR_NOTICE	Du kan ikke åbne en privat butik mens du bruger Fortrylle genstand+.
SELECT_ATTR_NOT_OPEN	Du kan ikke bruge Fortrylle genstand+, mens du har en privat butik åben.
SELECT_ATTR_NOT_SELECT	Beslut om du ønsker at beholde bonusserne, eller udskifte dem.
SELECT_CAN_NOT_DELETE	Du kan ikke slette denne karakter.
SELECT_CAN_NOT_DELETE_ATTR67	Du kan ikke slette din karakter\nmens en bonus bliver tilføjet.
SELECT_CAN_NOT_DELETE_GUILD_MEMBER	Du kan ikke slette din karakter mens de er et medlem af en orden.
SELECT_CAN_NOT_DELETE_HAVE_SEALED_ITEM	Du kan ikke slette din karakter fordi de ejer sjælbundene genstande.
SELECT_CAN_NOT_DELETE_LAST_CHAR_SAFEBOX	Du kan ikke slette din eneste karakter fordi der stadig er genstande i dit lager.
SELECT_CAN_NOT_DELETE_LIMITE_LEVEL	Du kan kun slette din karakter op til level 69.
SELECT_CAN_NOT_DELETE_MARRIAGE	Du kan ikke slette gifte karakterer.
SELECT_CAN_NOT_DELETE_PRIVATE_CODE_ERROR	Sletnings koden var ugyldig.
SELECT_CAN_NOT_DELETE_REMAIN_TIME	Du kan ikke slette denne karakter direkte efter den er blevet skabt. Ventetid: %s
SELECT_CHANGED_NAME	Du har skiftet navn på karakteren.
SELECT_CHANGE_FAILURE_ALREADY_EXIST_NAME	Dette navn er allerede i brug.
SELECT_CHANGE_FAILURE_STRANGE_INDEX	Prøv igen.
SELECT_CHANGE_FAILURE_STRANGE_NAME	Dette er et forkert karakternavn.
SELECT_CHANGE_NAME_TITLE	Skift karakternavn
SELECT_DELEING	Karakteren bliver slettet
SELECT_DELETED	Sletning succesfuld.
SELECT_DO_YOU_DELETE_REALLY	Ønsker du at fortsætte?
SELECT_EMPTY_SLOT	Dette er et tomt felt.
SELECT_GM_NAME	GM
SELECT_INPUT_CHANGING_NAME	Angiv et nyt karakternavn.
SELECT_NOT_JOIN_GUILD	Ingen Orden
SERVER_NOTIFY_CLOSED	Lukket server: kun kontoer med VIP status eller dem der blev lavet før serverens lukning kan komme ind.
SERVER_STATUS_CLOSE	LUKKET
SERVER_STATUS_NEW	NY
SERVER_STATUS_SPECIAL	SPECIAL
SHOP_BUY_INFO	Vælg den genstand du vil købe i butik-vinduet.
SHOP_CANNOT_SELL_EQUIPMENT	Du kan ikke sælge genstanden, da den er i brug.
SHOP_CANNOT_SELL_ITEM	Denne genstand kan ikke sælges.
SHOP_ERROR_UNKNOWN	Ukendt load-fejl: %s
SHOP_EXCEED_LIMIT_TODAY	Du har allerede overskredet din daglige grænse for brug af point.
SHOP_INVALID_POS	Denne genstand er ikke egnet til det.
SHOP_INVENTORY_FULL	Dit inventar er fyldt.
SHOP_LIMITED_DATA_LOADING	Data indlæses. Prøv venligst igen senere.
SHOP_LIMITED_ITEM_REMAIN_COUNT	Resterende genstande: %d
SHOP_LIMITED_PURCHASE_OVER	Udsolgt
SHOP_LIMIT_TODAY	Daglige grænse: %d / %d
SHOP_MY_BATTLE_POINT	Kamp point: %d
SHOP_MY_MEDAL_OF_HONOR	Tapperheds Medalje: %d
SHOP_NOT_ENOUGH_10TH_COIN	Du har ikke nok Jubilæums Mønter.
SHOP_NOT_ENOUGH_BATTLE_POINT	Du har ikke nok kamp point.
SHOP_NOT_ENOUGH_BNW	Du har ikke nok Seer Mønter.
SHOP_NOT_ENOUGH_GUILD_LEVEL	Ordens level er for lavt.
SHOP_NOT_ENOUGH_MEDAL_OF_HONOR	Ikke nok Tapperheds Medaljer.
SHOP_NOT_ENOUGH_MONEY	Ikke nok Won eller Yang
SHOP_NOT_ENOUGH_MONEY_EX	Du har ikke Yang nok.
SHOP_SELL_INFO	Vælg i dit inventarvindue, hvilken genstand du ønsker at sælge.
SHOP_SOLDOUT	Udsolgt
SHOT_ERROR_UNKNOWN	Ukendt langdistance angrebsfejl: %s
SKILL_BLEEDING	Blødning
SKILL_BOHO	Reflektere
SKILL_CANNOT_LEVEL_UP_ANYMORE_BY_BOOK	Du har brug for erfaringspoint for at lære denne færdighed.
SKILL_CANNOT_LEVEL_UP_ANYMORE_BY_STAT	Du har brug for en bog for at lære denne færdighed.
SKILL_CHEONGEUN	Stærk krop
SKILL_CRITICAL	Kritisk slag
SKILL_ENCHANT_POISON	Brug gift
SKILL_EUNHYEONG	Usynligt
SKILL_FAINT	Besvime
SKILL_FIND_TRAP	Søg fælde
SKILL_FIRE	Forbrænding
SKILL_FISHMIND	Fiske kugle bliver brugt
SKILL_GAMJI	Vælge
SKILL_GEOMGYEONG	Sværd-aura
SKILL_GICHEON	Dragehjælp
SKILL_GIGONG	Chi-Rotation
SKILL_GONGPO	Frygt
SKILL_GRADE_NAME_GRAND_MASTER	%s Stormester
SKILL_GRADE_NAME_MASTER	%s Mester
SKILL_GRADE_NAME_PERFECT_MASTER	%s perfekt Mester
SKILL_GROUP_ASSASSIN_1	Klinge
SKILL_GROUP_ASSASSIN_2	Bue
SKILL_GROUP_HORSE	Riddekunst
SKILL_GROUP_SHAMAN_1	Drage
SKILL_GROUP_SHAMAN_2	Helbredelse
SKILL_GROUP_SURA_1	Våben
SKILL_GROUP_SURA_2	Magi
SKILL_GROUP_WARRIOR_1	Krop
SKILL_GROUP_WARRIOR_2	Mental
SKILL_GWIGEOM	Fortryllet klinge
SKILL_GYEONGGONG	Dunlet gang
SKILL_HEUKSIN	Mørk beskyttelse
SKILL_HOSIN	Velsignelse
SKILL_INC_ATKSPD	Angrebshastighed øges
SKILL_INC_MOVSPD	Bevægelseshastighed øges
SKILL_JEOJU	Forbandelse
SKILL_JEONGEOP	Helbrede
SKILL_JEONGWI	Bersærk
SKILL_JEONSINBANGEO	Fuld forsvar
SKILL_JEONSINGONGGYEOK	Fuld angreb
SKILL_JEUNGRYEOK	Angreb +
SKILL_JEUNGSOK	Hastighed +
SKILL_JUMAGAP	Fortryllet rustning
SKILL_KWAESOK	Hastighed
SKILL_MUYEONG	Ild-ånden
SKILL_NEED_EMPTY_BOTTLE	Jeg har ingen tom flaske.
SKILL_NEED_POISON_BOTTLE	Jeg har ingen giftflaske.
SKILL_ONLY_FOR_GUILD_WAR	Denne færdighed kan kun bruges i Ordens-kampe.
SKILL_PABEOP	Fjern magi
SKILL_POWERFUL_STRIKE	Bedøvelses-angreb
SKILL_SEOMGWANG	Lynbombe
SKILL_SLEEP	Sove
SKILL_SLOW	Langsom
SKILL_STUN	Bedøve
SKILL_SUHO	Vagt
SKILL_SUMMON_DESCRIPTION	Sandsynlighed for besværgelser: %d%%
SKILL_TOOLTIP_INT	Intelligens
SKILL_TOOLTIP_LEVEL	Level
SKILL_TOXICDIE	Forgiftning
SKILL_TOXICPOWER	Giftangreb bliver forbedret
SKILL_TUSOK	ånde-stød
SOUL_ITEM_TOOLTIP_APPLY	Effekt aktiveret
SOUL_ITEM_TOOLTIP_BLUE1	Spilletid: %d/%d min. 
SOUL_ITEM_TOOLTIP_BLUE2	Færdigheds skade forøges med x%.1f når man når spilletiden
SOUL_ITEM_TOOLTIP_COMMON	Ikke til: PvP, Transformation
SOUL_ITEM_TOOLTIP_RED1	Spilletid: %d/%d min. 
SOUL_ITEM_TOOLTIP_RED2	Angrebs skade forøges med x%.1f når man når spilletiden
SOUL_ITEM_TOOLTIP_REMAIN_COUNT	Resterende angreb: %d
SOUL_ITEM_TOOLTIP_REMOVE_TIME	Sjælen udløber om
SOUL_ITEM_TOOLTIP_UNAPPLIED	Effekten er ikke aktiveret.
SOUL_REFINE_FAILURE	Forædlingen mislykkedes.
SOUL_REFINE_SUCCESS	Forædlingen er fuldført!
STAT_MINUS_CON	Vitalitets-tilpasning(Tilbagestående chance: %d)
STAT_MINUS_DEX	Smidighed-tilpasning (Sandsynlighed: %d)
STAT_MINUS_INT	Intelligens-tilpasning (Sandsynlighed: %d)
STAT_MINUS_STR	Styrke-tilpasning (Sandsynlighed: %d)
STAT_TOOLTIP_CON	HP og forsvar bliver forbedret
STAT_TOOLTIP_DEX	Nøjagtighed og flugt bliver forbedret
STAT_TOOLTIP_INT	MP, magisk angreb og forsvar bliver forbedret.
STAT_TOOLTIP_STR	Angrebsværdi og skade bliver forbedret
SYMBOLLIST_TITLE	Tilmeld Ordensflag
TARGET_BUTTON_ACCEPT_FIGHT	Accepter
TARGET_BUTTON_AVENGE	Hævn
TARGET_BUTTON_BLOCK	Bloker
TARGET_BUTTON_BLOCK_REMOVE	Fjern blokering
TARGET_BUTTON_BUILDING_DESTROY	Ødelægge
TARGET_BUTTON_DISMOUNT	Stå af hesten
TARGET_BUTTON_EMOTION_ALLOW	Emotioner
TARGET_BUTTON_EXCHANGE	Handel
TARGET_BUTTON_EXCLUDE	Udelukke
TARGET_BUTTON_EXIT_OBSERVER	Afslut tilskuersyn
TARGET_BUTTON_FIGHT	Duel
TARGET_BUTTON_FRIEND	Ven
TARGET_BUTTON_INVITE_GUILD	Ordens invitation
TARGET_BUTTON_INVITE_PARTY	Gruppe invitation
TARGET_BUTTON_LEAVE_PARTY	Forlad gruppe
TARGET_BUTTON_REQUEST_ENTER_PARTY	Join gruppen
TARGET_BUTTON_REVIVE	Genopliv
TARGET_BUTTON_VIEW_EQUIPMENT	Udrystning
TARGET_BUTTON_WHISPER	Hviske
TARGET_LEVEL_BOSS	Boss
TARGET_LEVEL_KING	Level 5.
TARGET_LEVEL_KNIGHT	Level 3.
TARGET_LEVEL_PAWN	Level 1.
TARGET_LEVEL_S_KNIGHT	Level 4.
TARGET_LEVEL_S_PAWN	Level 2.
TARGET_TOOLTIP_ATTACK_COUNT	Samlede Angrebspoint: %d
TASKBAR_ATTACK	Angribe
TASKBAR_AUTO	Angrib automatisk
TASKBAR_CAMERA	Kamera
TASKBAR_EXP	Erfaring
TASKBAR_HP	HP
TASKBAR_MOVE	Bevæge
TASKBAR_SKILL	Færdighed
TASKBAR_SP	MP
TASKBAR_ST	OP
TENTH_COIN	Jubilæums Mønter
TENTH_EVENT_ASK_EXCHANGE	Du kræver %d Jubilæums Flag. Ønsker du at fortsætte?
THING_COUNT	alle
TOOLTIP_AFFECT_ATT_GRADE_DOWN	Reducer skade	SNA
TOOLTIP_AFFECT_CONFUSION	Du er blevet bevidstløs.
TOOLTIP_AFFECT_CRITICAL_GRADE_DOWN	Reducer kritisk slag chance	SNA
TOOLTIP_AFFECT_CZ_UNLIMIT_ENTER	Vogterens Mærke	SNA
TOOLTIP_AFFECT_DEFENSEWAVE_LASER	Hydro strålen kunne ikke stoppes.
TOOLTIP_AFFECT_DEF_GRADE_DOWN	Reducer forsvar	SNA
TOOLTIP_AFFECT_ELECTRIC_SHOCK	Lyn
TOOLTIP_AFFECT_FISHING_GOLD_TUNA	Gylden Tun Bonus	SNA
TOOLTIP_AFFECT_FISHING_MOVE_SPEED_DOWN	Vådt Tøj\nBevægelseshastighed -50	SNA
TOOLTIP_AFFECT_LATE_SUMMER_EVENT_BUFF	Sjæle (%d/20)	SA
TOOLTIP_AFFECT_LATE_SUMMER_EVENT_PRIMIUM_BUFF	Sjældne Sjæle (%d/150)	SA
TOOLTIP_AFFECT_MI_BUFF	Besættelses Buff %s
TOOLTIP_AFFECT_MOUNT_FALL	Fald fra ganger	SNA
TOOLTIP_AFFECT_POLYMORPH	Transformer	SNA
TOOLTIP_AFFECT_RCAST_SPEED	Forøg nedkøling	SNA
TOOLTIP_AFFECT_RED_DRAGONLAIR_BUFF	Modstand imod Færdighedsskade +15% | Modstand imod normalt Angrebs Skade +15%
TOOLTIP_AFFECT_RESEARCHER_ELIXIR	Forskerens Eliksir	SNA
TOOLTIP_AFFECT_RHP_REGEN	Kan ikke regenerere	SNA
TOOLTIP_AFFECT_SAFEBOX_BUFF_01	Lager Bonus\n+3% EXP	SNA
TOOLTIP_AFFECT_SAFEBOX_BUFF_02	Lager Bonus\n+20 forsvar	SNA
TOOLTIP_AFFECT_SAFEBOX_BUFF_03	Lager Bonus\n+1% angrebspoint	SNA
TOOLTIP_AFFECT_SAFEBOX_BUFF_04	Lager Bonus\n+3% styrke imod monstre	SNA
TOOLTIP_ALIGNMENT_DAMAGE_BONUS	Skaden bliver øget ved lavere rang point.	SNA
TOOLTIP_ANTI_CRITICAL_PCT	Forsvar mod kritisk hit +%d%%	SA
TOOLTIP_ANTI_PENETRATE_PCT	Forsvar mod gennemborende angreb +%d%%	SA
TOOLTIP_ANTI_SELL	Kan ikke sælges i butikken.
TOOLTIP_APPLY_ACCEDRAIN_RATE	Absorberings satsen: %d%%	SA
TOOLTIP_APPLY_ATTBONUS_ANIMAL	Stærk mod dyr +%d%%	SA
TOOLTIP_APPLY_ATTBONUS_ASSASSIN	Stærk mod ninjas +%d%%	SA
TOOLTIP_APPLY_ATTBONUS_BELL	Klokkeforsvars Brud +%d%%	SA
TOOLTIP_APPLY_ATTBONUS_BOW	Pil Forsvars Brud +%d%%	SA
TOOLTIP_APPLY_ATTBONUS_CLAW	Klo Forsvars Brud +%d%%	SA
TOOLTIP_APPLY_ATTBONUS_CZ	Stærke imod Zodiac Monstre +%d%%	SA
TOOLTIP_APPLY_ATTBONUS_DAGGER	Dolk Forsvars Brud +%d%%	SA
TOOLTIP_APPLY_ATTBONUS_DESERT	Stærke imod Ørken Monstre +%d%%	SA
TOOLTIP_APPLY_ATTBONUS_DEVIL	Stærk mod djævel +%d%%	SA
TOOLTIP_APPLY_ATTBONUS_FAN	Vifte Forsvars Brud +%d%%	SA
TOOLTIP_APPLY_ATTBONUS_HUMAN	Stærk mod halvmennesker +%d%%	SA
TOOLTIP_APPLY_ATTBONUS_INSECT	Stærke imod Insekter +%d%%	SA
TOOLTIP_APPLY_ATTBONUS_MILGYO	Stærk mod esoteriker +%d%%	SA
TOOLTIP_APPLY_ATTBONUS_MONSTER	Stærk mod monstre +%d%%	SA
TOOLTIP_APPLY_ATTBONUS_ORC	Stærk mod ork +%d%%	SA
TOOLTIP_APPLY_ATTBONUS_SHAMAN	Stærk mod shamaner +%d%%	SA
TOOLTIP_APPLY_ATTBONUS_SURA	Stærk mod sura +%d%%	SA
TOOLTIP_APPLY_ATTBONUS_SWORD	Sværd Forsvars Brud +%d%%	SA
TOOLTIP_APPLY_ATTBONUS_TWOHAND	To-hånds Forsvars Brud +%d%%	SA
TOOLTIP_APPLY_ATTBONUS_UNDEAD	Stærk mod ikke-døde +%d%%	SA
TOOLTIP_APPLY_ATTBONUS_WARRIOR	Stærk mod kriger +%d%%	SA
TOOLTIP_APPLY_ATTBONUS_WOLFMAN	Stærk imod Lycans + %d%%	SA
TOOLTIP_APPLY_BLEEDING_PCT	Blødnings angreb + %d%%	SA
TOOLTIP_APPLY_BLEEDING_REDUCE	Modstand imod blødnings angreb + %d%%	SA
TOOLTIP_APPLY_BLOCK	Sandsynlighed for at blokere fysisk angreb %d%%	SA
TOOLTIP_APPLY_COMBAT_SP_RECOVER	Gendan i kamp alle 5 Sek. MP %d	SA
TOOLTIP_APPLY_CRITICAL_PCT	Sandsynlighed for et kritisk slag +%d%%	SA
TOOLTIP_APPLY_DAMAGE_SP_RECOVER	%d%% sandsynlighed for at få MP tilbage efter et hit	SA
TOOLTIP_APPLY_DODGE	%d%% sandsynlighed at undvige pilangreb	SA
TOOLTIP_APPLY_ENCHANT_DARK	Mørkets Kraft +%d%%	SA
TOOLTIP_APPLY_ENCHANT_DARK2	Mørkets Kraft +%d%% - +%d%%
TOOLTIP_APPLY_ENCHANT_EARTH	Jordens Kraft +%d%%	SA
TOOLTIP_APPLY_ENCHANT_EARTH2	Jordens Kraft +%d%% - +%d%%
TOOLTIP_APPLY_ENCHANT_ELECT	Lynets Kraft +%d%%	SA
TOOLTIP_APPLY_ENCHANT_ELECT2	Lynets Kraft +%d%% - +%d%%
TOOLTIP_APPLY_ENCHANT_FIRE	Ildens Kraft +%d%%	SA
TOOLTIP_APPLY_ENCHANT_FIRE2	Ildens Kraft +%d%% - +%d%%
TOOLTIP_APPLY_ENCHANT_ICE	Isens Kraft +%d%%	SA
TOOLTIP_APPLY_ENCHANT_ICE2	Isens Kraft +%d%% - +%d%%
TOOLTIP_APPLY_ENCHANT_WIND	Vindens Kraft +%d%%	SA
TOOLTIP_APPLY_ENCHANT_WIND2	Vindens Kraft +%d%% - +%d%%
TOOLTIP_APPLY_EXP_DOUBLE_BONUS	%d%% sandsynlighed for erfarings-bonus	SA
TOOLTIP_APPLY_GOLD_DOUBLE_BONUS	%d%% sandsynlighed at få doppelt Yang	SA
TOOLTIP_APPLY_IMMUNE_FALL	Immun overfor væltning i kamp	SNA
TOOLTIP_APPLY_IMMUNE_SLOW	Forsvar mod sløvhed	SNA
TOOLTIP_APPLY_IMMUNE_STUN	Forsvar mod besvimelse	SNA
TOOLTIP_APPLY_ITEM_DROP_BONUS	%d%% sandsynlighed for at få doppelte genstande	SA
TOOLTIP_APPLY_KILL_HP_RECOVER	%d%% sandsynlighed for at gendanne HP	SA
TOOLTIP_APPLY_KILL_SP_RECOVER	%d%% sandsynlighed for at gendanne MP	SA
TOOLTIP_APPLY_MANA_BURN_PCT	%d%% sandsynlighed at overtage fjendens MP.	SA
TOOLTIP_APPLY_MAX_HP_PCT	Max HP +%d%%	SA
TOOLTIP_APPLY_MAX_SP_PCT	Max MP +%d%%	SA
TOOLTIP_APPLY_NOAFFECT	Ingen virkning
TOOLTIP_APPLY_NO_DEATH_PENALTY	Hvis din karakter dør mister du ingen erfaringspoint.	SNA
TOOLTIP_APPLY_NO_DEATH_PENALTY_PLUS	Drageguden tager dig under hans beskyttende vinger. Hvis du bliver genoplivet om bord, vil du ikke miste nogen erfaringspoint.	SNA
TOOLTIP_APPLY_PENETRATE_PCT	%d%% sandsynlighed for gennemborende slag	SA
TOOLTIP_APPLY_POISON_PCT	Sandsynlighed for Forgiftning %d%%	SA
TOOLTIP_APPLY_POISON_REDUCE	Giftmodstand %d%%	SA
TOOLTIP_APPLY_POTION_BONUS	Eliksir %d%% effektøgning	SA
TOOLTIP_APPLY_REFLECT_CURSE	%d%% sandsynlighed for at reflektere en forbandelse	SA
TOOLTIP_APPLY_REFLECT_MELEE	%d%% sandsynlighed for at reflektere fysisk angreb	SA
TOOLTIP_APPLY_RESIST_ASSASSIN	Forsvar mod ninjaangreb: %d%%	SA
TOOLTIP_APPLY_RESIST_BELL	Klokkeforsvar %d%%	SA
TOOLTIP_APPLY_RESIST_CLAW	Klo Forsvar +%d%%	SA
TOOLTIP_APPLY_RESIST_DAGGER	Dolkforsvar %d%%	SA
TOOLTIP_APPLY_RESIST_FAN	Vifteforsvar %d%%	SA
TOOLTIP_APPLY_RESIST_HUMAN	Modstand imod Halv Mennesker %d%%	SA
TOOLTIP_APPLY_RESIST_MOUNT_FALL	Falds Modstand +%d%%	SA
TOOLTIP_APPLY_RESIST_SHAMAN	Forsvar mod shamanangreb: %d%%	SA
TOOLTIP_APPLY_RESIST_SURA	Forsvar mod suraangreb: %d%%	SA
TOOLTIP_APPLY_RESIST_SWORD	Sværdforsvar %d%%	SA
TOOLTIP_APPLY_RESIST_TWOHAND	Tohåndssværdforsvar %d%%	SA
TOOLTIP_APPLY_RESIST_WARRIOR	Forsvar mod krigerangreb: %d%%	SA
TOOLTIP_APPLY_RESIST_WIND	Luftmodstand %d%%	SA
TOOLTIP_APPLY_RESIST_WOLFMAN	Forsvars chance mod Lycan angreb %d%%	SA
TOOLTIP_APPLY_SKILL_BOOK_BONUS	Sandsynlighed at lære ved læsning af bøger er øget med faktor 2½	SNA
TOOLTIP_APPLY_SKILL_BOOK_NO_DELAY	Hvis læsningen mislykkes kan du læse en anden bog med det samme.	SNA
TOOLTIP_APPLY_SLOW_PCT	Chance for at sløve modstanderen %d%%	SA
TOOLTIP_APPLY_STEAL_HP	%d%% af skaden vil blive absorberet af HP	SA
TOOLTIP_APPLY_STEAL_SP	%d%% af skaden vil blive absorberet af MP	SA
TOOLTIP_APPLY_STUN_PCT	Besvimelses sandsynlighed %d%%	SA
TOOLTIP_ARMOR	Rustning
TOOLTIP_ARROW	Pil
TOOLTIP_ASSASSIN	Ninja
TOOLTIP_ATTBONUS_STONE	+%d%% styrke imod Metin-sten	SA
TOOLTIP_ATT_GRADE	Angrebsværdi +%d	SA
TOOLTIP_ATT_SPEED	Angrebshastighed +%d%%	SA
TOOLTIP_ATT_SPEED_SLOW	Angrebshastighed reduceret	SNA
TOOLTIP_AUTO_POTION_HP	Sol Eliksir
TOOLTIP_AUTO_POTION_REST	Resterende: %.2f%%
TOOLTIP_AUTO_POTION_SP	Måne Eliksir
TOOLTIP_AUTO_POTION_USING	Aktiv
TOOLTIP_AUTO_SYSTEM_PRIMIUM	Auto-Jagt	SNA
TOOLTIP_BATTLE_POTION	Kamp Zone Kamp Eliksir	SNA
TOOLTIP_BOW_DISTANCE	Buerækkevidde +%dm	SA
TOOLTIP_BUYPRICE	Pris: %s
TOOLTIP_CAST_SPEED	Magihastighed +%d%%	SA
TOOLTIP_CON	Vitalitet +%d	SA
TOOLTIP_COSTUME_ATTR_BONUS	Kostume bonus %d%%	SA
TOOLTIP_DAMAGE_HP_RECOVERY	Absorberer %d%% skade som HP	SA
TOOLTIP_DAMAGE_SP_RECOVERY	Absorberer %d%% skade som MP	SA
TOOLTIP_DEF_GRADE	Forsvar +%d	SA
TOOLTIP_DEX	Smidighed +%d	SA
TOOLTIP_DRAGON_SOUL_DECK1	Himmel	SNA
TOOLTIP_DRAGON_SOUL_DECK2	Jord	SNA
TOOLTIP_DS_SET	DSS Satte Effekt	SNA
TOOLTIP_EAR	Ørering
TOOLTIP_ENERGY	Energi %d	SA
TOOLTIP_ETC	osv.
TOOLTIP_EXP_BONUS_EVENT	EXP +%d%%	SA
TOOLTIP_FIFTH_ATTRIBUTE_BONUS	5. bonus +%d%%	SA
TOOLTIP_FIRST_ATTRIBUTE_BONUS	1. bonus +%d%%	SA
TOOLTIP_FISHINGROD_EXP	Points: %d / %d
TOOLTIP_FISHINGROD_LEVEL	Level: %d
TOOLTIP_FISHINGROD_UPGRADE1	Giv til fiskeren
TOOLTIP_FISHINGROD_UPGRADE2	for at forbedre den
TOOLTIP_FISHINGROD_UPGRADE3	til en bedre fiskestang.
TOOLTIP_FISH_LEN	Længde: %.2fcm
TOOLTIP_FOURTH_ATTRIBUTE_BONUS	4. bonus +%d%%	SA
TOOLTIP_GUILD_SKILL_ACCEL	Acceleration +%d	SA
TOOLTIP_GUILD_SKILL_BLESS	Dragegudens velsignelse +%d	SA
TOOLTIP_GUILD_SKILL_BLOOD	Dragegudens blod +%d	SA
TOOLTIP_GUILD_SKILL_BUNNO	Dragegudens vrede +%d%%	SA
TOOLTIP_GUILD_SKILL_JUMUN	Magihjælp +%d%%	SA
TOOLTIP_GUILD_SKILL_SEONGHWI	Hellig rustning +%d	SA
TOOLTIP_HALLOWEEN_EVENT_BUFF	+20% EXP | +5% genstands fald | +10% styrke imod monstre	SNA
TOOLTIP_HELMET	Hjelm
TOOLTIP_HIT_BUFF_ENCHANT_DARK	Optjen Mørkets Kraft i %d sek. i kamp	SA
TOOLTIP_HIT_BUFF_ENCHANT_EARTH	Optjen Jordens Kraft i %d sek. i kamp	SA
TOOLTIP_HIT_BUFF_ENCHANT_ELEC	Optjen Lynets Kraft i %d sek. i kamp	SA
TOOLTIP_HIT_BUFF_ENCHANT_FIRE	Optjen Ildens Kraft i %d sek. i kamp	SA
TOOLTIP_HIT_BUFF_ENCHANT_ICE	Optjen Isens Kraft i %d sek. i kamp	SA
TOOLTIP_HIT_BUFF_ENCHANT_WIND	Optjen Vindens Kraft i %d sek. i kamp	SA
TOOLTIP_HIT_BUFF_RESIST_DARK	Optjen Mørkes Modstand i %d sek. i kamp	SA
TOOLTIP_HIT_BUFF_RESIST_EARTH	Optjen Jord Modstand i %d sek. i kamp	SA
TOOLTIP_HIT_BUFF_RESIST_ELEC	Optjen Lynmodstand i %d sek. i kamp	SA
TOOLTIP_HIT_BUFF_RESIST_FIRE	Optjen Ildmodstand i %d sek. i kamp	SA
TOOLTIP_HIT_BUFF_RESIST_ICE	Optjen Is Modstand i %d sek. i kamp	SA
TOOLTIP_HIT_BUFF_RESIST_WIND	Optjen Luft Modstand i %d sek. i kamp	SA
TOOLTIP_HP_REGEN	HP-regeneration +%d%%	SA
TOOLTIP_INT	Intelligens +%d	SA
TOOLTIP_ITEM_ATT_GRADE	Angrebsværdi %d
TOOLTIP_ITEM_ATT_POWER	Angrebsværdi %d - %d
TOOLTIP_ITEM_ATT_POWER_ONE_ARG	Angrebsværdi %d
TOOLTIP_ITEM_ATT_POWER_REFINE	Angrebsværdi %d - %d (+%d)
TOOLTIP_ITEM_ATT_SPEED	Angrebshastighed %s
TOOLTIP_ITEM_DEF_GRADE	Forsvar %d
TOOLTIP_ITEM_FAST	Hurtig
TOOLTIP_ITEM_LIMIT_CON	Maksimal Vitalitet: %d
TOOLTIP_ITEM_LIMIT_DEX	Smidigheds grænse: %d
TOOLTIP_ITEM_LIMIT_INT	Intelligens-grænse: %d
TOOLTIP_ITEM_LIMIT_LEVEL	Mindste lvl: %d
TOOLTIP_ITEM_LIMIT_STR	Styrke-grænse: %d
TOOLTIP_ITEM_MAGIC_ATT_POWER	Magisk angrebsværdi %d - %d
TOOLTIP_ITEM_MAGIC_ATT_POWER_ONE_ARG	Magisk angrebsværdi %d
TOOLTIP_ITEM_MAGIC_DEF_POWER	Magisk forsvar %d
TOOLTIP_ITEM_NORMAL	Normal
TOOLTIP_ITEM_SLOW	Langsom
TOOLTIP_ITEM_VERY_FAST	Meget hurtig
TOOLTIP_ITEM_VERY_SLOW	Meget langsom
TOOLTIP_ITEM_WEARABLE_JOB	[ Udrustning ]	
TOOLTIP_LOTTERY_STEP_NUMBER	%d
TOOLTIP_LOTTO_NUMBER	Lykkental: %d
TOOLTIP_MAGIC_ATTBONUS_PER	Magisk angreb +%d%%	SA
TOOLTIP_MAGIC_ATT_GRADE	Magisk angrebsværdi +%d	SA
TOOLTIP_MAGIC_DEF_GRADE	Magisk forsvar +%d	SA
TOOLTIP_MALL_ATTBONUS	Angrebsværdi +%d%%	SA
TOOLTIP_MALL_ATTBONUS_STATIC	Angrebsværdi	SNA
TOOLTIP_MALL_AUTOLOOT	Automatisk samles alt Yang.	SNA
TOOLTIP_MALL_DEFBONUS	Forsvar +%d%%	SA
TOOLTIP_MALL_DEFBONUS_STATIC	Forsvar 	SNA
TOOLTIP_MALL_EXPBONUS	EXP +%d%%	SA
TOOLTIP_MALL_EXPBONUS_P_STATIC	iCafe EXP-Bonus +%d%%	SA
TOOLTIP_MALL_EXPBONUS_STATIC	50% mere EXP	SNA
TOOLTIP_MALL_FISH_MIND	Sandsynligheden at fange en fisk er øget	SNA
TOOLTIP_MALL_GOLDBONUS	Sandsynlighed for Yang er øget med %d%%	SA
TOOLTIP_MALL_GOLDBONUS_STATIC	Dobbelt Yang sandsynlighed	SNA
TOOLTIP_MALL_ITEMBONUS	Sandsynligheden for genstande er øget med %d%%	SA
TOOLTIP_MALL_ITEMBONUS_P_STATIC	iCafe Chance for plyndring af genstande plus %.1f%%	SA
TOOLTIP_MALL_ITEMBONUS_STATIC	Genstands drop chancen bliver øget med 200%.	SNA
TOOLTIP_MALL_MARRIAGE_FAST	Kærlighedspoints gendannes hurtigere.	SNA
TOOLTIP_MALL_SAFEBOX	Du har øget lastrummet i din kiste.	SNA
TOOLTIP_MAX_HP	Max. HP +%d	SA
TOOLTIP_MAX_HP_PCT	Max. HP +%d%%	SA
TOOLTIP_MAX_SP	Max. MP +%d	SA
TOOLTIP_MAX_SP_PCT	Max. MP +%d%%	SA
TOOLTIP_MAX_STAMINA	Max. udholdenhed +%d	SA
TOOLTIP_MELEE_MAGIC_ATTBONUS_PER	Magisk/nærkamps angreb +%d%%	SA
TOOLTIP_MEMORIZED_POSITION	%s(%d, %d)
TOOLTIP_MEMORIZED_POSITION_ERROR	GPS-FEJL (%d, %d)
TOOLTIP_MORE_THEN_HP90_DAMAGE_REDUCE	Indkommende skade er reduceret med %d%% hvis du har +90%% HP	SA
TOOLTIP_MOV_SPEED	Bevægelseshastighed %d%%	SA
TOOLTIP_NECK	Halskæde
TOOLTIP_NEED_ALL_SP	Kræver MP: Max.
TOOLTIP_NEED_GSP	Kræver drageånd: %d
TOOLTIP_NEED_HP	Kræver HP: %d
TOOLTIP_NEED_HP_PER_SEC	HP / Sek.: %d
TOOLTIP_NEED_SKILL_POINT	Kræver færdighedspoints:
TOOLTIP_NEED_SP	Kræver MP: %d
TOOLTIP_NEED_SP_PER_SEC	MP / Sek.: %d
TOOLTIP_NEXT_SKILL_LEVEL_1	Næste Level: %d (Max. %d)
TOOLTIP_NEXT_SKILL_LEVEL_2	Næste Level: %d (Max. %d-%d)
TOOLTIP_NORMAL_DAMAGE_GUARD	%d%% chance for at blokere angrebs skade	SA
TOOLTIP_NORMAL_HIT_DAMAGE_BONUS	Gennemsnitlig skade %d%%	SA
TOOLTIP_NORMAL_HIT_DAMAGE_BONUS_BOSS_OR_MORE	+%d%% angrebs skade imod bosser	SA
TOOLTIP_NORMAL_HIT_DEFEND_BONUS	Gennemsnitlig skadesmodstand %d%%	SA
TOOLTIP_NORMAL_HIT_DEFEND_BONUS_BOSS_OR_MORE	-%d%% angrebs skade fra bosser	SA
TOOLTIP_PARTY_INFO_GRADE_UP1	Flere end %d gruppemedlemmer
TOOLTIP_PARTY_INFO_GRADE_UP2	Angrebslevel +%d
TOOLTIP_PARTY_INFO_GRADE_UP3	Forsvarslevel +%d
TOOLTIP_PARTY_INFO_HEAL_18_LEVEL	HP/MP fra alle gruppemedlemmer gendannes engang i 60 minutter.
TOOLTIP_PARTY_INFO_HEAL_40_LEVEL	HP/MP fra alle gruppemedlemmer gendannes engang i 30 minutter.
TOOLTIP_PARTY_INFO_RECALL_12_LEVEL	Du bliver nød til at vente tre minutter efter gruppemedlemmets død.
TOOLTIP_PARTY_INFO_RECALL_20_LEVEL	Du kan til enhver tid påkalde gruppemedlemmer fra samme server.
TOOLTIP_PARTY_INFO_SET_ATTACKER	Angrebslevel +(Antal af gruppemedlemmer/2) angriber %d kan vælges
TOOLTIP_PARTY_INFO_SET_TANKER	Forsvars level +(antallet af gruppemedlemmer) nærkæmpere 1 kan blive valgt.
TOOLTIP_PARTY_SKILL_LEVEL	Level: %d
TOOLTIP_PARTY_TITLE_GRADE_UP	[Angreb/Forsvar blev forbedret]
TOOLTIP_PARTY_TITLE_HEAL	[Gendan]
TOOLTIP_PARTY_TITLE_INFO_BONUS_EXP	Flere end %d gruppemedlemmer får bonus-EXP %d%%.
TOOLTIP_PARTY_TITLE_MEMBER_BONUS_EXP	[Bonus-EXP]
TOOLTIP_PARTY_TITLE_RECALL	[Kald på]
TOOLTIP_PARTY_TITLE_SET_ATTACKER	[Definer angriber]
TOOLTIP_PARTY_TITLE_SET_TANKER	[Indstil til nærkamp]
TOOLTIP_PEPSI_EVENT	5% EXP bonus og 5% øget chance for plyndring af genstande.	SNA
TOOLTIP_PICK_EXP	Points: %d / %d
TOOLTIP_PICK_LEVEL	Level: %d
TOOLTIP_PICK_UPGRADE1	Giv til brændehuggeren
TOOLTIP_PICK_UPGRADE2	for at få en bedre
TOOLTIP_PICK_UPGRADE3	Spidshakke.
TOOLTIP_POTION_CURE	Fjern negative effekter.
TOOLTIP_POTION_MIN	Min.
TOOLTIP_POTION_PLUS_ATTACK_SPEED	Angrebshastighed +%d
TOOLTIP_POTION_PLUS_ATTBONUS_MONSTER	ANG BONUS MONSTER: +%d%%
TOOLTIP_POTION_PLUS_ATT_POINT	ANG: +%d
TOOLTIP_POTION_PLUS_ATT_POINT_PER	ANG: +%d%%
TOOLTIP_POTION_PLUS_DEF_POINT	FOR: +%d
TOOLTIP_POTION_PLUS_DEX_POINT	DEX: +%d
TOOLTIP_POTION_PLUS_EXP_BONUS	EXP: +%d%%
TOOLTIP_POTION_PLUS_HIT_DEFEND_POINT	SKADE MODSTAND: +%d%%
TOOLTIP_POTION_PLUS_HP_PERCENT	HP +%d%%
TOOLTIP_POTION_PLUS_HP_POINT	HP +%d
TOOLTIP_POTION_PLUS_MOVING_SPEED	Bevægelseshastighed +%d
TOOLTIP_POTION_PLUS_RESIST_DARK	MØRKE MODSTAND: +%d%%
TOOLTIP_POTION_PLUS_RESIST_EARTH	JORD MODSTAND: +%d%%
TOOLTIP_POTION_PLUS_RESIST_ICE	IS MODSTAND: +%d%%
TOOLTIP_POTION_PLUS_RESIST_MAGIC	MAGISK MODSTAND: +%d%%
TOOLTIP_POTION_PLUS_SP_PERCENT	MP +%d%%
TOOLTIP_POTION_PLUS_SP_POINT	MP +%d
TOOLTIP_POTION_PLUS_STR_POINT	STR: +%d
TOOLTIP_POTION_SEC	Sek.
TOOLTIP_POTION_TIME	Længde:
TOOLTIP_PVP_TOURNAMENT_ENTER	Tilmeld dig PvP Turneringen
TOOLTIP_PVP_TOURNAMENT_EXPBONUS	PvP Turnerings EXP +%d%%	SA
TOOLTIP_REQUIREMENT_21_LEVEL	Du skal have opnået level 21.
TOOLTIP_REQUIREMENT_41_LEVEL	Du skal have opnået level 41.
TOOLTIP_REQUIREMENT_LEVEL	Du skal have opnået Level %d.
TOOLTIP_REQUIREMENT_SKILL_LEVEL	Kræver %s Level %d
TOOLTIP_REQUIREMENT_STAT_LEVEL	Kræver %s %d
TOOLTIP_RESIST_BOW	Pil Forsvar %d%%	SA
TOOLTIP_RESIST_DARK	Forsvar mod mørke +%d%%	SA
TOOLTIP_RESIST_EARTH	Forsvar mod Jorden +%d%%	SA
TOOLTIP_RESIST_ELEC	Lynmodstand %d%%	SA
TOOLTIP_RESIST_FIRE	Ildmodstand %d%%	SA
TOOLTIP_RESIST_ICE	Forsvar mod is +%d%%	SA
TOOLTIP_RESIST_MAGIC	Magimodstand %d%%	SA
TOOLTIP_RESIST_MAGIC_REDUCTION	Magisk gennemtrængning for %d%%	SA
TOOLTIP_REST_USABLE_COUNT	Til overs: %d
TOOLTIP_SEALED	Sjælebundet
TOOLTIP_SEASON_PVE_BUFF	Øger PvE skaden med 80% i 10 min.	SNA
TOOLTIP_SEASON_RANKING_BUFF	Øger rang point med 20% i 10 min.	SNA
TOOLTIP_SECOND_ATTRIBUTE_BONUS	2. bonus +%d%%	SA
TOOLTIP_SELLPRICE	Pris: %s
TOOLTIP_SET_ITEM	Sæt-Bonus	SNA
TOOLTIP_SHAMAN	Shaman
TOOLTIP_SHIELD	Skjold
TOOLTIP_SHOES	Sko
TOOLTIP_SKILL	Færdighed	SNA
TOOLTIP_SKILLBOOK_NAME	Færdighedsbog
TOOLTIP_SKILL_AFFECT_ATT_GRADE	Angrebsværdi: +
TOOLTIP_SKILL_AFFECT_ATT_POWER	Angrebsværdi:
TOOLTIP_SKILL_AFFECT_ATT_SPEED	Angrebshastighed: +
TOOLTIP_SKILL_AFFECT_DEF_GRADE	Forsvar:
TOOLTIP_SKILL_AFFECT_DODGE	Fjendtlig Angrebsværdi: -
TOOLTIP_SKILL_AFFECT_HEAL	HP gendannelse:
TOOLTIP_SKILL_AFFECT_MOV_SPEED	Bevægelseshastighed: +
TOOLTIP_SKILL_AFFECT_REFLECT_MELEE	Sandsynligheden for at reflektere fysisk skade:
TOOLTIP_SKILL_AFFECT_RESIST_NORMAL	Modstand mod fysisk skade:
TOOLTIP_SKILL_COOL_TIME	Opladningstid: 
TOOLTIP_SKILL_DAMAGE_AMSEOP	Bagholdsangrebs Skade +%d%%	SA
TOOLTIP_SKILL_DAMAGE_BIPABU	Flyvende Talismans Skade +%d%%	SA
TOOLTIP_SKILL_DAMAGE_BONUS	Færdighedsskade %d%%	SA
TOOLTIP_SKILL_DAMAGE_BONUS_BOSS_OR_MORE	+%d%% færdigheds skade imod bosser	SA
TOOLTIP_SKILL_DAMAGE_BYEURAK	Lynbesværgelses Skade +%d%%	SA
TOOLTIP_SKILL_DAMAGE_CHAIN	Lynklos Skade +%d%%	SA
TOOLTIP_SKILL_DAMAGE_CHARYUN	Rullende Dolks Skade +%d%%	SA
TOOLTIP_SKILL_DAMAGE_CHAYEOL	Riv Skade +%d%%	SA
TOOLTIP_SKILL_DAMAGE_GEOMPUNG	Sværdstøds Skade +%d%%	SA
TOOLTIP_SKILL_DAMAGE_GIGONGCHAM	Åndeslags (K) Skade +%d%%	SA
TOOLTIP_SKILL_DAMAGE_GIGUNG	Gift Pils Skade +%d%%	SA
TOOLTIP_SKILL_DAMAGE_GONGDAB	Ulve Springs Skade +%d%%	SA
TOOLTIP_SKILL_DAMAGE_GUNGSIN	Hurtigt Angrebs Skade +%d%%	SA
TOOLTIP_SKILL_DAMAGE_GYOKSAN	Støds Skade +%d%%	SA
TOOLTIP_SKILL_DAMAGE_HWAJO	Ildpils Skade +%d%%	SA
TOOLTIP_SKILL_DAMAGE_HWAYEOMPOK	Ild Støds Skade +%d%%	SA
TOOLTIP_SKILL_DAMAGE_KWANKYEOK	Pil Regns Skade +%d%%	SA
TOOLTIP_SKILL_DAMAGE_MAHWAN	Mørk Stens Skade +%d%%	SA
TOOLTIP_SKILL_DAMAGE_MARYUNG	Mørkt Støds Skade +%d%%	SA
TOOLTIP_SKILL_DAMAGE_NOEJEON	Lynkasts Skade +%d%%	SA
TOOLTIP_SKILL_DAMAGE_PABEOB	Magi fjerners Skade +%d%%	SA
TOOLTIP_SKILL_DAMAGE_PAERYONG	Dragens Brøls Skade +%d%%	SA
TOOLTIP_SKILL_DAMAGE_PALBANG	Sværd-hvirvel Skade +%d%%	SA
TOOLTIP_SKILL_DAMAGE_PASWAE	Ulvekløers Skade +%d%%	SA
TOOLTIP_SKILL_DAMAGE_SALPOONG	Ulvens Åndes Skade +%d%%	SA
TOOLTIP_SKILL_DAMAGE_SAMYEON	Tre-Vejs Snits Skade +%d%%	SA
TOOLTIP_SKILL_DAMAGE_SANGONG	Giftskys Skade +%d%%	SA
TOOLTIP_SKILL_DAMAGE_SWAERYUNG	Fingerangrebs Skade +%d%%	SA
TOOLTIP_SKILL_DAMAGE_TANHWAN	Susens Skade +%d%%	SA
TOOLTIP_SKILL_DAMAGE_YEONSA	Gentagende Skuds Skade +%d%%	SA
TOOLTIP_SKILL_DAMAGE_YONGBI	Skydende Drages Skade +%d%%	SA
TOOLTIP_SKILL_DAMAGE_YONGKWON	Drage Hvirvels Skade +%d%%	SA
TOOLTIP_SKILL_DEFEND_BONUS	Modstand mod færdighedsskade %d%%	SA
TOOLTIP_SKILL_DEFEND_BONUS_BOSS_OR_MORE	-%d%% færdigheds skade fra bosser	SA
TOOLTIP_SKILL_DURATION	Varighed: %d sek.
TOOLTIP_SKILL_DURATION_INCREASE_EUNHYUNG	Camouflerings Varighed +%d sek.	SA
TOOLTIP_SKILL_DURATION_INCREASE_GEOMKYUNG	Sværdens Auras Varighed +%d sek.	SA
TOOLTIP_SKILL_DURATION_INCREASE_GYEONGGONG	Fjervandrings Varighed +%d sek.	SA
TOOLTIP_SKILL_DURATION_INCREASE_JEOKRANG	Højrød Ulve Sjæls Varighed +%d sek.	SA
TOOLTIP_SKILL_FORGET_BOOK_NAME	Forglemmelses bog
TOOLTIP_SKILL_LEVEL	Level: %d
TOOLTIP_SKILL_LEVEL_MASTER	Level: %d (mester)
TOOLTIP_SKILL_LEVEL_WITH_MAX	Level: %d (Max. %d)
TOOLTIP_SOCKET_EMPTY	Tom
TOOLTIP_SOCKET_REFINABLE_ITEM	[Genstand med indfatning]
TOOLTIP_SP_REGEN	MP-Regeneration +%d%%	SA
TOOLTIP_STR	Styrke +%d	SA
TOOLTIP_SURA	Sura
TOOLTIP_THIRD_ATTRIBUTE_BONUS	3. bonus +%d%%	SA
TOOLTIP_TIME_CHARGER_FIX	Opladning af tid %d sek.	SA
TOOLTIP_TIME_CHARGER_PER	Opladning af tid %d sek.	SA
TOOLTIP_UNIQUE	Enestående
TOOLTIP_UNSEAL_LEFT_TIME	Fjerner sjælebinding om: %dH %dM
TOOLTIP_USE_SKILL_AMSEOP_HP_ABSORB	Absorberer %d%% HP med Bagholdsangreb	SA
TOOLTIP_USE_SKILL_BIPABU_NEXT_COOLTIME_DECREASE_10PER	Flyvende Talismans Nedkøling: -%d sek. med 10%% chance	SA
TOOLTIP_USE_SKILL_BIPABU_NEXT_COOLTIME_DECREASE_20PER	Flyvende Talismans Nedkøling: -%d sek. med 20%% chance	SA
TOOLTIP_USE_SKILL_BYEURAK_HP_ABSORB	Absorber op til %d%% HP med Lynbesværgelse	SA
TOOLTIP_USE_SKILL_CHAIN_HP_ABSORB	Absorberer %d%% HP med Lynklo	SA
TOOLTIP_USE_SKILL_CHARYUN_STUN	%d%% lammelses chance med Rullende Dolk	SA
TOOLTIP_USE_SKILL_CHAYEOL_CRITICAL_PCT	Øget sandsynlighed for kritiske angreb i %d sek. med Riv	SA
TOOLTIP_USE_SKILL_CHAYEOL_HP_ABSORB	Absorberer %d%% HP med Riv	SA
TOOLTIP_USE_SKILL_CHEONGRANG_CASTING_SPEED	Øget tryllehastighed i %d sek. med Indigo Ulve Sjæl	SA
TOOLTIP_USE_SKILL_CHEONGRANG_MOV_SPEED	Øget bevægelseshastighed i %d sek. med Indigo Ulve Sjæl	SA
TOOLTIP_USE_SKILL_CHUNKEON_CASTING_SPEED	Øget tryllehastighed i %d sek. med Stærk Krop	SA
TOOLTIP_USE_SKILL_GEOMPUNG_NEXT_COOLTIME_DECREASE_10PER	Sværdstøds Nedkøling: -%d sek. med 10%% chance	SA
TOOLTIP_USE_SKILL_GEOMPUNG_NEXT_COOLTIME_DECREASE_20PER	Sværdstøds Nedkøling: -%d sek. med 20%% chance	SA
TOOLTIP_USE_SKILL_GICHEON_ATT_GRADE_BONUS	Angrebs bonus i %d sek. med Dragens Hjælp	SA
TOOLTIP_USE_SKILL_GIGONGCHAM_STUN	%d%% lammelses chance med Åndeslag (K)	SA
TOOLTIP_USE_SKILL_GIGUNG_ATT_GRADE_BONUS	Angrebs bonus i %d sek. med Gift Pil	SA
TOOLTIP_USE_SKILL_GIHYEOL_ATT_GRADE_BONUS	Angrebs bonus i %d sek. med Livskraft	SA
TOOLTIP_USE_SKILL_GONGDAB_KNOCKBACK	%d%% tilbageslags chance med Ulve Spring	SA
TOOLTIP_USE_SKILL_GONGDAB_STUN	%d%% lammelses chance med Ulve Spring	SA
TOOLTIP_USE_SKILL_GUNGSIN_NEXT_COOLTIME_DECREASE_10PER	Hurtigt Angrebs Nedkøling: -%d sek. med 10%% chance	SA
TOOLTIP_USE_SKILL_GUNGSIN_NEXT_COOLTIME_DECREASE_20PER	Hurtigt Angrebs Nedkøling: -%d sek. med 20%% chance	SA
TOOLTIP_USE_SKILL_GWIGEOM_DEF_BONUS	Forsvars bonus i %d sek. med Fortryllede Klinge	SA
TOOLTIP_USE_SKILL_GYOKSAN_KNOCKBACK	%d%% tilbageslags chance med Voldsomme stød	SA
TOOLTIP_USE_SKILL_HOSIN_DEF_BONUS	Forsvars bonus i %d sek. med Velsignelse	SA
TOOLTIP_USE_SKILL_HWAYEOMPOK_KNOCKBACK	%d%% tilbageslags chance med Ild Stød	SA
TOOLTIP_USE_SKILL_JEOKRANG_DEF_BONUS	Forsvars bonus i %d sek. med Højrød Ulve Sjæl	SA
TOOLTIP_USE_SKILL_JEONGEOP_ATT_GRADE_BONUS	Angrebs bonus i %d sek. med Helbred	SA
TOOLTIP_USE_SKILL_JEUNGRYEOK_DEF_BONUS	Forsvars bonus i %d sek. med Angreb Op	SA
TOOLTIP_USE_SKILL_KWANKYEOK_KNOCKBACK	%d%% tilbageslags chance med Pil Regn	SA
TOOLTIP_USE_SKILL_KWANKYEOK_NEXT_COOLTIME_DECREASE_10PER	Pil Regns Nedkøling: -%d sek. med 10%% chance	SA
TOOLTIP_USE_SKILL_KWANKYEOK_NEXT_COOLTIME_DECREASE_20PER	Pil Regns Nedkøling: -%d sek. med 20%% chance	SA
TOOLTIP_USE_SKILL_MAHWAN_STUN	%d%% lammelses chance med Mørk Sten	SA
TOOLTIP_USE_SKILL_MANASHILED_CASTING_SPEED	Øget tryllehastighed i %d sek. med Mørk Beskyttelse	SA
TOOLTIP_USE_SKILL_MARYUNG_NEXT_COOLTIME_DECREASE_10PER	Mørkt Støds Nedkøling: -%d sek. med 10%% chance	SA
TOOLTIP_USE_SKILL_MARYUNG_NEXT_COOLTIME_DECREASE_20PER	Mørkt Støds Nedkøling: -%d sek. med 20%% chance	SA
TOOLTIP_USE_SKILL_MUYEONG_ATT_GRADE_BONUS	Angrebs bonus i %d sek. med Ild Ånden	SA
TOOLTIP_USE_SKILL_NOEGEOM_ATT_GRADE_BONUS	Angrebs bonus i %d sek. med Sværd Kuglen	SA
TOOLTIP_USE_SKILL_NOEJEON_NEXT_COOLTIME_DECREASE_10PER	Lynkasts Nedkøling: -%d sek. med 10%% chance	SA
TOOLTIP_USE_SKILL_NOEJEON_NEXT_COOLTIME_DECREASE_20PER	Lynkasts Nedkøling: -%d sek. med 20%% chance	SA
TOOLTIP_USE_SKILL_PABEOB_STUN	%d%% lammelses chance med Magi fjerner	SA
TOOLTIP_USE_SKILL_PAERYONG_HP_ABSORB	Absorberer %d%% HP med Dragens Brøl	SA
TOOLTIP_USE_SKILL_PALBANG_HP_ABSORB	Absorberer %d%% HP med Sværd-hvirvel	SA
TOOLTIP_USE_SKILL_PASWAE_NEXT_COOLTIME_DECREASE_10PER	Ulvekløers Nedkøling: -%d sek. med 10%% chance	SA
TOOLTIP_USE_SKILL_PASWAE_NEXT_COOLTIME_DECREASE_20PER	Ulvekløers Nedkøling: -%d sek. med 20%% chance	SA
TOOLTIP_USE_SKILL_PASWAE_SP_ABSORB	Absorberer %d%% MP med Ulvekløer	SA
TOOLTIP_USE_SKILL_SALPOONG_NEXT_COOLTIME_DECREASE_10PER	Ulvens Ånde Nedkøling: -%d sek. med 10%% chance	SA
TOOLTIP_USE_SKILL_SALPOONG_NEXT_COOLTIME_DECREASE_20PER	Ulvens Ånde Nedkøling: -%d sek. med 20%% chance	SA
TOOLTIP_USE_SKILL_SAMYEON_NEXT_COOLTIME_DECREASE_10PER	Tre-Vejs Snits Nedkøling: -%d sek. med 10%% chance	SA
TOOLTIP_USE_SKILL_SAMYEON_NEXT_COOLTIME_DECREASE_20PER	Tre-Vejs Snits Nedkøling: -%d sek. med 20%% chance	SA
TOOLTIP_USE_SKILL_SAMYEON_STUN	%d%% lammelses chance med Tre-Vejs Snit	SA
TOOLTIP_USE_SKILL_SANGONG_ATT_GRADE_BONUS	Angrebs bonus i %d sek. med Giftsky	SA
TOOLTIP_USE_SKILL_SEOMJEON_KNOCKBACK	%d%% tilbageslags chance med Lumsk Gift	SA
TOOLTIP_USE_SKILL_SWAERYUNG_KNOCKBACK	%d%% tilbageslags chance med Fingerangreb	SA
TOOLTIP_USE_SKILL_TERROR_ATT_GRADE_BONUS	Angrebs bonus i %d sek. med Frygt	SA
TOOLTIP_USE_SKILL_TUSOK_HP_ABSORB	Absorberer %d%% HP med Åndeslag (L)	SA
TOOLTIP_USE_SKILL_YEONSA_HP_ABSORB	Absorberer %d%% HP med Gentagende Skud	SA
TOOLTIP_USE_SKILL_YONGBI_HP_ABSORB	Absorberer %d%% HP med Skydende Drage	SA
TOOLTIP_USE_SKILL_YONGKWON_NEXT_COOLTIME_DECREASE_10PER	Drage Hvirvels Nedkøling: -%d sek. med 10%% chance	SA
TOOLTIP_USE_SKILL_YONGKWON_NEXT_COOLTIME_DECREASE_20PER	Drage Hvirvels Nedkøling: -%d sek. med 20%% chance	SA
TOOLTIP_WARRIOR	Kriger
TOOLTIP_WEAPON	Våben
TOOLTIP_WOLFMAN	Lycan
TOOLTIP_WRISTLET	Armbånd
UI_ACCEPT	Accepter
UI_BOLD_FONT	Tahoma:12b
UI_CANCEL	Afbryd
UI_CLOSE	Luk
UI_DEF_FONT	Tahoma:12
UI_DEF_FONT_LARGE	Tahoma:14
UI_DEF_FONT_SMALL	Tahoma:9
UI_DENY	Afvise
UI_ITEM	Genstand
UI_LEFT_TIME	Tid til overs: %d Sek.
UI_NEXT	Fortsæt
UI_NEXTPAGE	Næste
UI_NOCONTENTS	Intet indhold
UI_NONAME	Intet navn
UI_OK	OK
UI_POS_UNKNOWN	Ukendt position
UI_PREVPAGE	tilbage
UI_UNKNOWN	Ukendt
UNLIMIT_ENTER_CZ_QUESTION	Du kan gå ind i Zodiac Templet i %d min. Ønsker du at bruge det?
UPDATE_TIME	Dato
UPLOAD_MARK_CHECK_NEED_RECONNECT	Upload skal genstartes
UPLOAD_MARK_UPLOAD_NEED_RECONNECT	Upload skal genstartes
USE_ITEM_BUTTON_01	Vend Tilbage Nu
USE_ITEM_BUTTON_02	Træd ind
USE_ITEM_FAILURE_PRIVATE_SHOP	Du kan ikke bruge den genstand mens du har åbnet for en privat butik.
USE_ITEM_POPUP_01	Kampen om de Fem Helligdomme er slut. \n Næste kamp:
USE_ITEM_QUESTION_01	Ønsker du at deltage i Kampen om de Fem Helligdomme?
USE_ITEM_QUESTION_02	Ønsker du at vende tilbage til den lokation hvor du døde?\nDette koster %s Yang.
USE_ITEM_QUESTION_03	Du vil blive teleporteret til en tilfældig lokation. Ønsker du at gå ind?
USE_SKILL_ERROR_UNKNOWN	Ukendt færdighedsfejl: %s
