ACCEPT	OK
ACCE_ABSORB	Bonus absorbering
ACCE_COMBINE	Kombination
ACCE_MAIN	Bånd 1
ACCE_RESULT	Resultat
ACCE_SERVE	Bånd 2
ATTACH_METIN_INFO	Vil du bruge Åndestenen?
ATTACH_METIN_TITLE	Brug Åndestenen
ATTENDANCE_TITLE	Høstmand Boss Event
ATTR_67_ADD	Tilføj Bonus
ATTR_67_ADD_TITLE	Tilføj Bonus
ATTR_67_MATERIAL_SLOT_TITLE	Krafts Skår
ATTR_67_REGIST_SLOT_TITLE	Mål Genstand
ATTR_67_SUPPORT_SLOT_TITLE	Tilsætningsstof
AURA_MAIN	Aura Outfit
AURA_SUB	Materiale
AUTO_AUTO_ATTACK	Angrib
AUTO_AUTO_POSITION	Eliksirer
AUTO_AUTO_RANGE	Fokus
AUTO_AUTO_SKILL	Færdigheder
AUTO_CLEAR	Ryd
AUTO_END	Stop
AUTO_OFF	Af
AUTO_ON	På
AUTO_POSITION_SETTING	Eliksirer
AUTO_SAVE	Gem
AUTO_SETTING	Indstillinger
AUTO_SKILL_SETTING	Færdigheder
AUTO_START	Start
AUTO_TITLE	Auto-Jagt
BANNER_ATTENDANCE_BUTTON	Høstmand Boss Event
BANNER_BLACK_AND_WHITE_BUTTON	Seernes Duel
BANNER_CATCHKING_BUTTON	Fang Kongen
BANNER_EASTER_BUTTON	PÅSKE
BANNER_FISH_BUTTON	FISKE PUSLESPIL
BANNER_FLOWER_BUTTON	BLOMSTER KRAFT
BANNER_FOOTBALL_BUTTON	FODBOLD
BANNER_HALLOWEEN_BUTTON	HALLOWEEN
BANNER_LUCKY_EVENT	MONSTER BASH
BANNER_MINIBOSS_BUTTON	Zodiac Dommedag
BANNER_MINI_GAME_FINDM	TRE-MONSTER MEMO
BANNER_MONSTERBACK_BUTTON	Indløs Angrebspoint
BANNER_MYSTERY_BOX_BUTTON	PLYNDRINGS EVENT I
BANNER_MYSTERY_BOX_BUTTON_2	PLYNDRINGS EVENT II
BANNER_NEW_XMAS_BUTTON	JUL
BANNER_OKEY_BUTTON	Okey Event
BANNER_OLYMPIC_BUTTON	HELTE EVENT
BANNER_RAMADAN_BUTTON	RAMADAN
BANNER_ROULETTE_BUTTON	Blods Ritualet
BANNER_SOUL_BUTTON	SJÆLE EVENT
BANNER_SUMMER_BUTTON	SOMMER EVENT
BANNER_VALENTINE_BUTTON	VALENTINS DAG
BANNER_YUTNORI_BUTTON	Yut Nori
BATTLE_FIELD_INFO	Kamp Zone
BATTLE_FIELD_OPERATION_TIME	Kamp Zoner kan betrædes mellem %s:00 og %s:00.
BATTLE_FIELD_OPERATION_TIME_ALL	Lige nu åben for tilgang.
BATTLE_FIELD_OPERATION_TIME_END	Kamp Zonen er stadig åben i %s timer.
BATTLE_FIELD_OPERATION_TIME_NA	Lige nu lukket for tilgang.
BATTLE_FIELD_OPERATION_TIME_OPEN	Åben for tilgang om %s timer i %s timer.
BATTLE_FILED_RANK	Rang
BATTLE_FILED_RANK_EMPIRE	Rige
BATTLE_FILED_RANK_NAME	Navn
BATTLE_FILED_RANK_POINT	Point
BNW_GAME_UI_COM	Modstander
BNW_RANK_UI_COUNT	Donationer
BNW_RANK_UI_NAME	Navn
BNW_RANK_UI_RANK	Rang
CANCEL	Afbryd
CHANGE_ATTR_SELECT	Ændre Bonus
CHANGE_PASSWORD_CONFIRM	Bekræft Nyt Kodeord
CHANGE_PASSWORD_NEW	Nyt kodeord
CHANGE_PASSWORD_OLD	Gammelt kodeord
CHANGE_PASSWORD_TITLE	Skift kodeord
CHARACTER_ACTION	Aktioner
CHARACTER_EMOTICON	Emotioner
CHARACTER_MAIN	Karakter
CHARACTER_MUTUAL_ACTION	Interaktive aktioner
CHARACTER_NORMAL_ACTION	Normale aktioner
CHARACTER_QUEST	Missioner
CHARACTER_SKILL	Færdigheder
CHARACTER_SPECTIAL_ACTION	Specielle Handlinger
CHAT_FILTER	Chat filter
CHAT_FILTER_DICE	Terning
CLOSE	Luk
COMB_APPEARANCE	Mål
COMB_ATTRIBUTE	Kilde
COMB_MAIN	Mål
COMB_MATERIAL	Kilde
COMB_SKILLBOOK_TILE	Byt bøger
COMB_TITLE	
COSTUME_TITLE	Kostumer
COSTUME_WINDOW_TITLE	Kostumer
CREATE_ATT_GRADE	STR
CREATE_CREATE	Opret
CREATE_DEX_GRADE	DEX
CREATE_HP	VIT
CREATE_LAST_POINT	Points
CREATE_MAN	Mand
CREATE_NAME	Navn
CREATE_NEXT	Fortsæt
CREATE_PREV	Tilbage
CREATE_SEX	Køn
CREATE_SHAPE	Udseende
CREATE_SP	INT
CREATE_STAT_RESET	Tilbage
CREATE_WOMAN	Kvinde
CUBE_INFO_TITLE	Forfinelses håndbog
CUBE_RENEWAL_BELT_IMPROVE	Forøg Chancen
CUBE_RENEWAL_TITLE	Forædling
CUBE_REQUIRE_MATERIAL	Nødvendige materialer
CUBE_REQUIRE_MATERIAL_OR	eller
CUBE_TITLE	Krydderikiste
CURRENT_POINT	Nuværende point: %s
CZ_REWARD_WINDOW_TITLE	Zodiac Tempel
DO_CHANGE_ATTR	Anvend
DO_REFINE	Forædle
DRAGONSOUL_ACTIVATE	Aktiver
DRAGONSOUL_CHANGE_ATTR_WINDOW_TITLE	Bonus Ændring til Mytiske Dragesten
DRAGONSOUL_PAGE_BUTTON_1	Uslebet
DRAGONSOUL_PAGE_BUTTON_2	Slebet
DRAGONSOUL_PAGE_BUTTON_3	Sjælden
DRAGONSOUL_PAGE_BUTTON_4	Antik
DRAGONSOUL_PAGE_BUTTON_5	Mystisk
DRAGONSOUL_PAGE_BUTTON_6	Mytisk
DRAGONSOUL_REFINE_WINDOW_TITLE	Forfinelses vindue
DRAGONSOUL_TAP_TITLE_1	Drage diamant
DRAGONSOUL_TAP_TITLE_2	Drage rubin
DRAGONSOUL_TAP_TITLE_3	Drage jade
DRAGONSOUL_TAP_TITLE_4	Drage safir
DRAGONSOUL_TAP_TITLE_5	Drage granat
DRAGONSOUL_TAP_TITLE_6	Drage onyks
DRAGONSOUL_TITLE	Drage stens alkymist
DUTCHAUCTION_BUTTON	Få!
DUTCHAUCTION_TITLE	Lyn Auktion
EMPIRE_A	Shinsoo
EMPIRE_ALL	Alle
EMPIRE_B	Chunjo
EMPIRE_C	Jinno
EMPIRE_EXIT	Exit
EMPIRE_NEXT	Fortsæt
EMPIRE_PREV	Tilbage
EMPIRE_SELECT	Vælg
END_TIME	Aktivt event
ENTER_BATTLE_FIELD	Betræd
EVENT_ALARM_TITLE	Event Oversigt
EVENT_NAME_TITLE	Navn
EVENT_REWARD_TITLE	Belønning
EXCHANGE_ACCEPT	OK
EXCHANGE_TITLE	Handle
EXIT_BATTLE_FIELD	Ønsker du virkelig at forlade Kamp Zonen?
EXIT_BATTLE_FIELD_ON_DEAD	Ønsker du at forlade Kamp Zonen med %d point?
EXPIRED_TIME	Eventet er afsluttet.
FISHING_RENEWAL_TITLE	Fiskning
FRAGMENT_COMB_TITLE	Kombiner Færdighedsbøger
GAMEOPTION_TITLE	Spilindstillinger
GAME_EXIT_OBSERVER	Afslut tilskuermode
GAME_GUILD_WAR_JOIN	Tilslut dig Ordenskrigen
GAME_HELP	Hjælp
GAME_QUEST	Opgaver
GAME_SKILL_UP	Opgrader færdigheder
GAME_STAT_UP	Opgrader status
GEMSHOP_LEFTTIME	Resterende tid
GEMSHOP_TITLA	GAYA MARKED
GRADE	Klasse
GRADE_SELECT	Klasse
GRAPHICONOFF_DROP_ITEM_APPLY	Anvend
GRAPHICONOFF_DROP_ITEM_LEVEL	Genstands Fald
GRAPHICONOFF_DROP_ITEM_LEVEL1	1
GRAPHICONOFF_DROP_ITEM_LEVEL1_TOOLTIP	Vis effekt & navn
GRAPHICONOFF_DROP_ITEM_LEVEL2	2
GRAPHICONOFF_DROP_ITEM_LEVEL2_TOOLTIP	Skjul effekt
GRAPHICONOFF_DROP_ITEM_LEVEL3	3
GRAPHICONOFF_DROP_ITEM_LEVEL3_TOOLTIP	Skjul effekt & navn
GRAPHICONOFF_DROP_ITEM_LEVEL4	4
GRAPHICONOFF_DROP_ITEM_LEVEL4_TOOLTIP	Skjul genstande & hold over for at vise navn
GRAPHICONOFF_DROP_ITEM_LEVEL5	5
GRAPHICONOFF_DROP_ITEM_LEVEL5_TOOLTIP	Skjul genstande & navn
GRAPHICONOFF_EFFECT_APPLY	Anvend
GRAPHICONOFF_EFFECT_LEVEL	Effekter
GRAPHICONOFF_EFFECT_LEVEL1	1
GRAPHICONOFF_EFFECT_LEVEL1_TOOLTIP	Vis alle
GRAPHICONOFF_EFFECT_LEVEL2	2
GRAPHICONOFF_EFFECT_LEVEL2_TOOLTIP	Kun dine og monstres effekter
GRAPHICONOFF_EFFECT_LEVEL3	3
GRAPHICONOFF_EFFECT_LEVEL3_TOOLTIP	Kun dine og andre spillers effekter
GRAPHICONOFF_EFFECT_LEVEL4	4
GRAPHICONOFF_EFFECT_LEVEL4_TOOLTIP	Kun dine
GRAPHICONOFF_EFFECT_LEVEL5	5
GRAPHICONOFF_EFFECT_LEVEL5_TOOLTIP	Skjul alle
GRAPHICONOFF_NPC_NAME_STATUS	NPC Navne
GRAPHICONOFF_NPC_NAME_STATUS_OFF	Fra
GRAPHICONOFF_NPC_NAME_STATUS_OFF_TOOLTIP	Skjul NPC navne
GRAPHICONOFF_NPC_NAME_STATUS_ON	Til
GRAPHICONOFF_NPC_NAME_STATUS_ON_TOOLTIP	Vis NPC navne
GRAPHICONOFF_PET_STATUS	Kæledyr
GRAPHICONOFF_PET_STATUS_OFF	Fra
GRAPHICONOFF_PET_STATUS_OFF_TOOLTIP	Skjul kæledyr
GRAPHICONOFF_PET_STATUS_ON	Til
GRAPHICONOFF_PET_STATUS_ON_TOOLTIP	Vis kæledyr
GRAPHICONOFF_PRIVATE_SHOP_APPLY	Anvend
GRAPHICONOFF_PRIVATE_SHOP_LEVEL	Private Butikker
GRAPHICONOFF_PRIVATE_SHOP_LEVEL1	1
GRAPHICONOFF_PRIVATE_SHOP_LEVEL1_TOOLTIP	Vis alle
GRAPHICONOFF_PRIVATE_SHOP_LEVEL2	2
GRAPHICONOFF_PRIVATE_SHOP_LEVEL2_TOOLTIP	Vis alle i stor radius
GRAPHICONOFF_PRIVATE_SHOP_LEVEL3	3
GRAPHICONOFF_PRIVATE_SHOP_LEVEL3_TOOLTIP	Vis alle i mellem radius
GRAPHICONOFF_PRIVATE_SHOP_LEVEL4	4
GRAPHICONOFF_PRIVATE_SHOP_LEVEL4_TOOLTIP	Vis alle i lille radius
GRAPHICONOFF_PRIVATE_SHOP_LEVEL5	5
GRAPHICONOFF_PRIVATE_SHOP_LEVEL5_TOOLTIP	Vis alle i umiddelbar nærhed
GUILDWINDOW_BASE_BUFF	Ordens Bonus
GUILD_ATTENDANCE_LOCA1	Første Deltagelse: 1x Tapperheds Medalje
GUILD_ATTENDANCE_LOCA2	10 eller mere: 1x Tapperheds Medalje
GUILD_ATTENDANCE_LOCA3	20 eller mere: 2x Tapperheds Medalje
GUILD_ATTENDANCE_LOCA4	30 eller mere: 4x Tapperheds Medalje
GUILD_ATTENDANCE_LOCA5	40 eller mere: 6x Tapperheds Medalje
GUILD_ATTENDANCE_LOCA6	50 eller mere: 8x Tapperheds Medalje
GUILD_ATTENDANCE_LOCA7	60 eller mere: 10x Tapperheds Medalje
GUILD_ATTENDANCE_LOCA8	70 eller mere: 12x Tapperheds Medalje
GUILD_ATTENDANCE_LOCA9	Start tid: dagligt kl. 05:00
GUILD_ATTENDANCE_TITLE	Deltagelses Belønning
GUILD_BANKINFO_CLOSE	Luk
GUILD_BANKINFO_NAME	Medlem
GUILD_BANKINFO_TITLE	Ordens Lagerhus Historik
GUILD_BANKINFO_TYPE	Genstand/Valuta
GUILD_BANKINFO_USETYPE	Handling
GUILD_BANK_CLOSE	Luk
GUILD_BANK_INFO	Butikside:
GUILD_BANK_NUMBER	Bank nummer
GUILD_BASEINFO_BANK	Ordens Lagerhus
GUILD_BASEINFO_BANKLASTOUT	Sidst fjernet
GUILD_BASEINFO_BUILDING	Ordens Bygning
GUILD_BASEINFO_DEAL	Sælg Ordens Område
GUILD_BASEINFO_FACTORY	Ordens Smed
GUILD_BASEINFO_GOLDMANAGE	Overførsel
GUILD_BASEINFO_GUILDLAND	Ordens Område
GUILD_BASEINFO_LANDABANDON	Fjern Ordens Området
GUILD_BASEINFO_LANDSCAPE	Andet
GUILD_BASEINFO_LOCALE	Placering
GUILD_BASEINFO_MONEY	Balance
GUILD_BASEINFO_MONEYBANKINFO	Ordens Bank Informationer
GUILD_BASEINFO_MONEYIN	Indbetal
GUILD_BASEINFO_MONEYLASTOUT	Sidste Udtræk
GUILD_BASEINFO_MONEYOUT	Udbetal
GUILD_BASEINFO_POWER	Alter af Styrke
GUILD_BASEINFO_SMEITER	Ordens Alkymist
GUILD_BASEINFO_TITLE	Område Informationer
GUILD_BASEINFO_VOTE	Stem
GUILD_BASENAME	Basisnavn
GUILD_BOARD_ID	Navn
GUILD_BOARD_REFRESH	Genindlæs
GUILD_BOARD_TEXT	Besked
GUILD_BUILDING_CATEGORY_TITLE	Bygnings enheder
GUILD_BUILDING_CHANGE	Skift
GUILD_BUILDING_CHANGE_DELETE	Slet
GUILD_BUILDING_CHANGE_FIX	Ordens Rekonstruktion
GUILD_BUILDING_CHANGE_LIST	Liste af Ordens Områder
GUILD_BUILDING_DIRECTION	Retning
GUILD_BUILDING_FIX	Rekonstruktion
GUILD_BUILDING_GRADE	Rang
GUILD_BUILDING_INFO	Bygnings- og omkostningsinformationer
GUILD_BUILDING_LIST_TITLE	Bygningsliste
GUILD_BUILDING_LOG	Stamme
GUILD_BUILDING_NAME	Bygningsnavn
GUILD_BUILDING_OPERATE	Benyt
GUILD_BUILDING_PLY	Krydsfiner
GUILD_BUILDING_POSITION	Position
GUILD_BUILDING_PREVIEW	Preview
GUILD_BUILDING_PRICE	Pris
GUILD_BUILDING_REFRESH	Genindlæs
GUILD_BUILDING_STONE	Sten
GUILD_BUILDING_TITLE	Ordens-husplanlægning
GUILD_CRYSTAL	Krystal
GUILD_DEPOSIT	Betal
GUILD_DONATE_BUTTON_OVER_TEXT	Tilfældig genstand
GUILD_DONATE_COUNT	Tilgængelige donationer: %d/%d
GUILD_DONATE_GET_MEDAL_OF_HONOR	%d
GUILD_DONATE_GUILD_EXP	Ordens EXP
GUILD_DONATE_HIGH_MATERIAL	Stor Donation
GUILD_DONATE_MEDAL_OF_HONOR	Tapperheds Medalje
GUILD_DONATE_MIDDLE_MATERIAL	Mellem Donation
GUILD_DONATE_MY_MEDAL_OF_HONOR	Min Tapperheds Medalje
GUILD_DONATE_NORMAL_MATERIAL	120.000 Yang
GUILD_DONATE_TAB_HIGH	Stor Donation
GUILD_DONATE_TAB_MIDDLE	Mellem Donation
GUILD_DONATE_TAB_NORMAL	Lille Donation
GUILD_DONATE_TITLE	Donations EXP
GUILD_DRAGONLAIR_RANKING	Rangliste
GUILD_DRAGONLAIR_RANKING_COUNT	Rang
GUILD_DRAGONLAIR_RANKING_MEMBER	Medlem
GUILD_DRAGONLAIR_RANKING_NAME	Orden
GUILD_DRAGONLAIR_RANKING_TIME	Tid
GUILD_DROP_RESOURCE1	her
GUILD_DROP_RESOURCE2	Drop ressource
GUILD_GEM	Ædelsten
GUILD_GRADE_CHANGE_GRADE_NAME	Nyt rangnavn
GUILD_GRADE_NUM	Nr.
GUILD_GRADE_PERMISSION_BANK	Kan bruge ordens banken og lagerhuset
GUILD_GRADE_PERMISSION_DELETE	Fjern fra Orden
GUILD_GRADE_PERMISSION_JOIN	Kan acceptere spillere til Ordenen
GUILD_GRADE_PERMISSION_NOTICE	Kan sende Ordens beskeder
GUILD_GRADE_PERMISSION_SKILL	Ordensfærdigheder
GUILD_GRADE_PERMISSION_WAR	Kan vælge medlemmer som krigsdeltagere
GUILD_GRADE_RANK	Rang
GUILD_GRADE_WRITE	Skriv
GUILD_INFO	Ordensinformationer
GUILD_INFO_CUR_EXP	Erfaring
GUILD_INFO_DECALRE_WAR	Erklær krig
GUILD_INFO_ENEMY_GUILD	Fjendtlige Ordner
GUILD_INFO_ENEMY_GUILD_EMPTY	Ingen
GUILD_INFO_LEVEL	Ordenslevel
GUILD_INFO_MARK	Ordenssymbol
GUILD_INFO_MASTER	Leder
GUILD_INFO_MASTER_VALUE	Leder
GUILD_INFO_MEMBER_AVG_LEVEL	Gennemsnitlig level
GUILD_INFO_MEMBER_NUM	Antal medlemmer
GUILD_INFO_NAME	Ordensnavn
GUILD_INFO_NAME_VALUE	Det er et Ordensnavn
GUILD_INFO_OFFER_EXP	Investér
GUILD_INFO_REST_EXP	Nødvendig erfaring
GUILD_INFO_UPLOAD_MARK	Upload Ordenssymbol
GUILD_INFO_UPLOAD_SYMBOL	Upload flag
GUILD_LANDDEAL_VOTE	Sælg Ordens Område
GUILD_LANDDEAL_VOTE_DEALGOLD	Pris i Yang:
GUILD_LANDDEAL_VOTE_DEALGUILDNAME	Ordensnavn:
GUILD_MARK	Ordenssymbol
GUILD_MASTER_CHANGE_TITLEBAR	Opgiv Ordens Lederskab
GUILD_MEMBER_JOB	Klasse
GUILD_MEMBER_KNIGHT	Krigsdeltager
GUILD_MEMBER_LEVEL	Level
GUILD_MEMBER_NAME	Navn
GUILD_MEMBER_OUT_TITLEBAR	Fjern Medlem
GUILD_MEMBER_PACE_ATTENDANCE	Deltagelse ({0}/{1})
GUILD_MEMBER_RANK	Rang
GUILD_MEMBER_SPECIFIC_GRAVITY	Invest.
GUILD_MEMBER_VOTE_CHECK	Tjek stemmer
GUILD_METIN_STONE	Metin-sten
GUILD_MINENAL	Mineral
GUILD_MONEY	Yang
GUILD_NAME	Orden
GUILD_RESOURCE_INFO	Ressourceinformationer
GUILD_SKILLPAGE_LADDER	Rangpoint
GUILD_SKILLPAGE_RANK	Rang
GUILD_SKILL_ACTIVE	Aktiv
GUILD_SKIlL_HEAL_GSP	Oplad
GUILD_SKILL_PASSIVE	Passiv
GUILD_SKILL_POWER	Energi
GUILD_SKILL_STATE	Ordens færdigheder
GUILD_SYMBOL	Ordensflag
GUILD_WAR_ACCEPT	Accepter Ordenskrigserklæring
GUILD_WAR_ALLSCORE	Alle Krige
GUILD_WAR_BATTLE_TYPE	Kampart
GUILD_WAR_CTF	Flag
GUILD_WAR_DECLARE	Erklær Ordenskrig
GUILD_WAR_ENEMY	Fjende
GUILD_WAR_GAINSCORE	Point
GUILD_WAR_GAINSCORE_FIFTY	50
GUILD_WAR_GAINSCORE_HUNDRED	100
GUILD_WAR_GAINSCORE_THIRTY	30
GUILD_WAR_GAMETIME	Krigstid
GUILD_WAR_GAMETIME_SIXTY	60 min.
GUILD_WAR_GAMETIME_TEN	10 min.
GUILD_WAR_GAMETIME_THIRTY	30 min.
GUILD_WAR_JOINMEMBER	Medlemmer
GUILD_WAR_JOINMEMBER_COUNT	Medlemmer
GUILD_WAR_JOINMEMBER_FIFTEEN	15
GUILD_WAR_JOINMEMBER_FIVE	5
GUILD_WAR_JOINMEMBER_TEN	10
GUILD_WAR_NORMAL	Kamp egn
GUILD_WAR_REPORT	Krigs Rapport
GUILD_WAR_REPORTLIST	Oversigt (Kampe: K, Vundet: V, Tabt: T, Uafgjort: U)
GUILD_WAR_SCORE	Krigs Rapport
GUILD_WAR_SKILL	Ordensfærdigheder
GUILD_WAR_TYPE_DEFENSE	Skjold Kamp
GUILD_WAR_TYPE_DIE	Arena Kamp
GUILD_WAR_TYPE_FLAG	Fang Flaget
GUILD_WAR_TYPE_NORMAL	Kampfelt
GUILD_WAR_TYPE_TIGER	Udslettelse
GUILD_WAR_TYPE_TIME	Tids Angreb
GUILD_WAR_WARP	Arena
GUILD_WAR_WIN	Runder
GUILD_WAR_WIN_FIVE	5
GUILD_WAR_WIN_ONE	1
GUILD_WAR_WIN_THREE	3
GUILD_WATER	Vand
GUILD_WATER_STONE	Vand-sten
GUILD_WITHDRAW	Tag
HELP_ATTACK	Aktiverer et enkelt angreb på museklik.
HELP_ATTACK_KEY	Angrib: venstre muse-tast eller mellemrum
HELP_AUTO_ATTACK	Aktiverer automatiske angreb per museklik.
HELP_CAMERA	Kamera visning
HELP_CHANGE_PK_MODE	Skift angrebs type: skift indstilling på venstre muse-tast
HELP_CHARACTER_BUTTON1	(Karakter-vindue, inventar-vindue,
HELP_CHARACTER_BUTTON2	venneliste og indstillinger)
HELP_CHAT	Tal med specifikke grupper, start din besked med følgende: !(råb), #(gruppechat), %(ordenschat).
HELP_CLICK_OTHER_PLAYER	Højreklik på en anden spiller for at handle, starte en gruppe, eller udfordre dem til en duel.
HELP_CONTROL_CAMERA_BY_MIDDLEBUTTON	Standard kamerasyn: midterste musetast
HELP_CONTROL_CAMERA_BY_RIGHTBUTTON	Alternativt kamerasyn: tildel venstre eller højre musetast
HELP_EMOTINO	Giv udtryk for dine følelser med taste kombinationerne <Ctrl> + <1~9>.
HELP_EXP	Erfaring
HELP_FURY	Ingame Itemshop
HELP_GUILD_WINDOW	Åben Ordens-vinduet: Alt + G
HELP_HELP	Vis hjælp: H
HELP_HELP_KEY	Hjælpeskærmen er vist med standard indstillinger anvendt.
HELP_HP	Livspoint (HP)
HELP_KEYSETTING	Du kan skifte dine tastebindinger i spille indstillingerne.
HELP_MESSENGER_WINDOW	Vis vennelisten: Alt + M
HELP_MINIMAP	Viser minikortet.
HELP_MINIMAP_QUEST	Missioner vises som blinkende ikoner på minikortet og det store kort.
HELP_MOUSE_LEFT	Funktion af den venstre musetast
HELP_MOUSE_RIGHT	Funktion af den højre musetast
HELP_MOVE_KEY	Styring: W, A, S, D eller pile-tasterne
HELP_OFF_QUESTSCROLL	Vis/skjul missionsrullerne med <Ctrl> + Q.
HELP_OPEN_CHARACTER	Åben karaktervinduet: C
HELP_OPEN_CHAT	Åben chat vinduet: Enter
HELP_OPEN_INVENTORY	Åben inventar vinduet: I
HELP_OPEN_LOG	Åben Chat-log: L
HELP_OPEN_MINIMAP	Åben mini-map: Shift + M
HELP_OPEN_QUEST	Åben opgave vinduet: N
HELP_OPEN_SKILL	Åben færdigheds vinduet: V
HELP_OPEN_WHISPER	Åben hviske vinduet: Shift + Enter
HELP_OPEN_ZONEMAP	Åben stort kort: M
HELP_PICK_ITEM	Opsaml genstande: `eller Z eller venstre muse-tast
HELP_QUICKSLOT	Hurtigmenu
HELP_SCREEN_CAPTURE	Gem Screenshot: Prt Scr(bliver gemt i "Metin2_DK\screenshot")
HELP_SERVER	Viser serveren og kanalen.
HELP_SHOW_ALL_NAME	Vis navne: Alt
HELP_SKILL	Her kan du bruge en færdighed med den højre musetast.
HELP_SP	Manapoint (MP)
HELP_SYSTEM_BUTTON	System knapper
INVENTORY_PAGE_BUTTON_TOOLTIP_1	1. inventar
INVENTORY_PAGE_BUTTON_TOOLTIP_2	2. inventar
INVENTORY_PAGE_BUTTON_TOOLTIP_3	3. inventar
INVENTORY_PAGE_BUTTON_TOOLTIP_4	4. inventar
INVENTORY_TITLE	Inventar
ITEM_MALL	Itemshop
KEYCHANGE_ACTION_WINDOW	Handlinger
KEYCHANGE_ATTACK	Angrib
KEYCHANGE_AUTORUN	Auto. Løb
KEYCHANGE_AUTO_WINDOW	Auto-Jagt
KEYCHANGE_BASEACTION	Standard Taster
KEYCHANGE_CAM_DOWN1	Kamera (ned)
KEYCHANGE_CAM_DOWN2	Kamera (ned)
KEYCHANGE_CAM_LEFT1	Kamera (venstre)
KEYCHANGE_CAM_LEFT2	Kamera (venstre)
KEYCHANGE_CAM_RIGHT1	Kamera (højre)
KEYCHANGE_CAM_RIGHT2	Kamera (højre)
KEYCHANGE_CAM_UP1	Kamera (op)
KEYCHANGE_CAM_UP2	Kamera (op)
KEYCHANGE_CAM_ZOOM_IN1	Kamera (zoom ind)
KEYCHANGE_CAM_ZOOM_IN2	Kamera (zoom ind)
KEYCHANGE_CAM_ZOOM_OUT1	Kamera (zoom ud)
KEYCHANGE_CAM_ZOOM_OUT2	Kamera (zoom ud)
KEYCHANGE_CANCLE	Annuller
KEYCHANGE_CHAT_WINDOW	Chat historik
KEYCHANGE_CLEAR	Standard
KEYCHANGE_DDS_WINDOW	DSS
KEYCHANGE_DOWN1	Tilbage
KEYCHANGE_DOWN2	Tilbage
KEYCHANGE_DSS1	DS [Himmel]
KEYCHANGE_DSS2	DS [Jord]
KEYCHANGE_EMOTION1	Følelse (Sorg)
KEYCHANGE_EMOTION2	Følelse (Yang)
KEYCHANGE_EMOTION3	Følelse (Musik)
KEYCHANGE_EMOTION4	Følelse (Hjerte)
KEYCHANGE_EMOTION5	Følelse (Hjerter)
KEYCHANGE_EMOTION6	Følelse (Bombe)
KEYCHANGE_EMOTION7	Følelse (Ide)
KEYCHANGE_EMOTION8	Følelse (Storm)
KEYCHANGE_EMOTION9	Følelse (Undskyld)
KEYCHANGE_GUILD_WINDOW	Orden
KEYCHANGE_HELP_WINDOW	Hjælp
KEYCHANGE_IMPOSSIBLE_CHANGE	[Ctrl], [Alt], [Shift] er ikke tilladt her!
KEYCHANGE_INGAMEEVENT	EVENT
KEYCHANGE_INTERFACE	Vindue
KEYCHANGE_INVENTORY_WINDOW	Inventar
KEYCHANGE_KEY_SETTING	Tastatur Indstillinger
KEYCHANGE_LEFT1	Venstre
KEYCHANGE_LEFT2	Venstre
KEYCHANGE_MESSENGER_WINDOW	Venner
KEYCHANGE_MINIMAP_MINER	Minikort (-)
KEYCHANGE_MINIMAP_PLUS	Minikort (+)
KEYCHANGE_MINIMAP_WINDOW	Stort kort
KEYCHANGE_MONSTER_CARD_WINDOW	Monster Kort
KEYCHANGE_NEXT_TARGET	Næste mål
KEYCHANGE_PARTY_MATCH_WINDOW	Gruppe Søgning
KEYCHANGE_PET_WINDOW	Kæledyr
KEYCHANGE_QUEST_SCROLL_ONOFF	Missionsruller
KEYCHANGE_QUEST_WINDOW	Missioner
KEYCHANGE_QUICKSLOT1	Niveau 1
KEYCHANGE_QUICKSLOT2	Niveau 2
KEYCHANGE_QUICKSLOT3	Niveau 3
KEYCHANGE_QUICKSLOT4	Niveau 4
KEYCHANGE_RIDE	Rid
KEYCHANGE_RIDE_BYE	Send hest væk
KEYCHANGE_RIDE_HORSE	Rid
KEYCHANGE_RIDE_PEED	Fodr hest
KEYCHANGE_RIGHT1	Højre
KEYCHANGE_RIGHT2	Højre
KEYCHANGE_ROOT1	Saml op
KEYCHANGE_ROOT2	Saml op
KEYCHANGE_SAVE	Gem
KEYCHANGE_SCREENSHOT	Skærmbillede
KEYCHANGE_SHOW_NAME	Vis navne
KEYCHANGE_SKILL_WINDOW	Færdigheder
KEYCHANGE_SLOT1	Slot 1
KEYCHANGE_SLOT2	Slot 2
KEYCHANGE_SLOT3	Slot 3
KEYCHANGE_SLOT4	Slot 4
KEYCHANGE_SLOT5	Slot 5
KEYCHANGE_SLOT6	Slot 6
KEYCHANGE_SLOT7	Slot 7
KEYCHANGE_SLOT8	Slot 8
KEYCHANGE_SLOT_KET	Hurtig Valg
KEYCHANGE_STATUS_WINDOW	Karakter
KEYCHANGE_UP1	Frem
KEYCHANGE_UP2	Frem
LANGUAGE_AE	Arabisk
LANGUAGE_CZ	Tjekkisk
LANGUAGE_DE	Tysk
LANGUAGE_DK	Dansk
LANGUAGE_EN	Engelsk
LANGUAGE_ES	Spansk
LANGUAGE_FR	Fransk
LANGUAGE_GR	Græsk
LANGUAGE_HU	Ungarsk
LANGUAGE_IT	Italiensk
LANGUAGE_NL	Hollandsk
LANGUAGE_PL	Polsk
LANGUAGE_PT	Portugisisk
LANGUAGE_RO	Rumænsk
LANGUAGE_RU	Russisk
LANGUAGE_TR	Tyrkisk
LOAD_ERROR	En data-fil er i stykker. Vær så venligt at geninstallere clienten. Tryk ESC.
LOGIN_CONNECT	Connect
LOGIN_CONNECTING	Du bliver forbundet med serveren.
LOGIN_DEFAULT_SERVERADDR	Servernavn, kanal 1
LOGIN_EXIT	Afslut
LOGIN_ID	Brugernavn
LOGIN_PASSWORD	Kodeord
LOGIN_REGION_TITLE	Vælg området for regningen
LOGIN_SELECT_BUTTON	Vælg
LOGIN_SELECT_EXIT	Afslut
LOGIN_SELECT_OK	OK
LOGIN_SELECT_TITLE	Vælg server
LUCKY_BOX_NOTICE_YANG	Yang gebyr for ny genstands lykke
LUCKY_BOX_RECV_BUTTON	Accepter Genstand
LUCKY_BOX_RECV_NAME	Indhold:
LUCKY_BOX_RETRY_BUTTON	Ny Genstands Lykke
LUCKY_BOX_TITLE_NAME	Lykkens Kiste
MAILBOX_POST_ALL_DELETE_BUTTON	Slet Alle
MAILBOX_POST_ALL_RECEIVE	Modtag Alle
MAILBOX_POST_READ_BLOCK	Bloker
MAILBOX_POST_READ_DELETE	Slet
MAILBOX_POST_READ_FROM	Fra
MAILBOX_POST_READ_MAIN_TITLE	Besked
MAILBOX_POST_READ_RECV	Modtag
MAILBOX_POST_READ_TITLE	Emne
MAILBOX_POST_SEND_TITLE	Besked
MAILBOX_POST_WRITE_BUTTON_TEXT	Send
MAILBOX_POST_WRITE_CLOSE_TEXT	Luk
MAILBOX_POST_WRITE_CONFIRM_TEXT	Tjek Modtager
MAILBOX_POST_WRITE_SEND_TEXT	Send
MAILBOX_POST_WRITE_TITLE	Emne
MAILBOX_POST_WRITE_TO	Til
MAILBOX_TITLE	Indbakke
MALL_PASSWORD_TITLE	Kodeord
MALL_TITLE	Itemshop Lager
MARKET_TITLE	Butik
MARKLIST_REFRESH	Aktualisér
MARKLIST_TITLE	Registrer Ordenssymbol
MC_EXCHANGE_BUTTON	Byt
MC_MISSION_INIT_BUTTON	Nulstil Mission Level
MC_MOTION_BUTTON	Bevægelse
MC_POLY_BUTTON	Transformer
MC_PROMOTION_BUTTON	Forfrem
MC_REQUEST_MISSION_BUTTON	Accepter Mission
MC_REWARD_CARD_BUTTON	Saml Monster Kort
MC_SHUFFLE_BUTTON	Ombland Missions Kort
MC_SUMMON_BUTTON	Tilkald
MC_TAB_BUTTON_CARD_MISSION	Kort Mission
MC_TAB_BUTTON_PARTY	Grotte Samling
MC_TAB_BUTTON_SOLO	Åben Verden Samling
MC_WARP_BUTTON	Teleporter
MESSAGE	Dette er en meddelelse
MESSENGER_ADD_FRIEND	Tilføj ven
MESSENGER_BLOCK_FRIEND	Bloker
MESSENGER_DELETE_FRIEND	Slet
MESSENGER_MOBILE	Send SMS
MESSENGER_OPEN_GUILD	Åben Ordensvinduet
MESSENGER_TITLE	Venner
MESSENGER_USE_GUILD_MOVE_SKILL	Brug Ordensbevægelses-færdigheder
MESSENGER_WHISPER	Hviske
MINIGAME_FISH_EVENT_USE_COUNT	Antal
MINIMIZE	Minimér
MINI_BOSS_DUNGEON_DESC_BTN	Event Regler
MINI_BOSS_DUNGEON_TITLE_NAME	Navn
MINI_BOSS_DUNGEON_TITLE_NUM	Rang
MINI_BOSS_DUNGEON_TITLE_POINT	Dommedags Point
MINI_BOSS_DUNGEON_TOOTIP_01	Fangehuls Oversigt
MINI_BOSS_DUNGEON_TOOTIP_02	Dommedag til Level 40-80
MINI_BOSS_DUNGEON_TOOTIP_03	Dommedag til Level 81+
MINI_BOSS_DUNGEON_TOOTIP_04	Træd ind
MINI_BOSS_DUNGEON_TOOTIP_05	Resterende Tid
MINI_BOSS_DUNGEON_TOOTIP_06	Mine Dommedags Point
MINI_BOSS_DUNGEON_TOOTIP_07	Resterende Dommedage
MINI_BOSS_DUNGEON_TOOTIP_08	Min Belønning
MINI_BOSS_TITLE	Zodiac Dommedag
MINI_GAME_BLACK_AND_WHITE_DONATE	Doner
MINI_GAME_BLACK_AND_WHITE_GAME_TITLE	Seernes Duel
MINI_GAME_BLACK_AND_WHITE_RANK_BUTTON	Rangliste
MINI_GAME_BLACK_AND_WHITE_REWARD_TRADE	Præmier
MINI_GAME_BLACK_AND_WHITE_START_BUTTON	Start
MINI_GAME_BLACK_AND_WHITE_WAITTING_TITLE	Seernes Duel
MINI_GAME_CATCHKING_CHALLENGE	Sats
MINI_GAME_CATCHKING_HELP_TEXT	Regler
MINI_GAME_CATCHKING_HIGH_SCORE	High Score
MINI_GAME_CATCHKING_MYNUMBER	Mit Kort
MINI_GAME_CATCHKING_POPUP_CONFIRM	Vis/skjul pop-up
MINI_GAME_CATCHKING_RETRY	Spil Igen
MINI_GAME_CATCHKING_REWARD	Din Belønning
MINI_GAME_CATCHKING_SCORE	Point
MINI_GAME_CATCHKING_SELECTION_NUMBER	Afsløret Kort
MINI_GAME_CATCHKING_START_TEXT	Start
MINI_GAME_CATCHKING_TITLE	Fang Kongen
MINI_GAME_FINDM_HINT_BTN	Hint:
MINI_GAME_FINDM_START_BTN	Start spillet
MINI_GAME_FINDM_TITLE	Tre-Monster Memo
MINI_GAME_FINDM_TRY_COUNT_TEXT	Forsøg
MINI_GAME_FINDM_UPGRADE_BAR1	Genstand
MINI_GAME_FINDM_UPGRADE_BAR2	Gebyr (Yang)
MINI_GAME_FINDM_UPGRADE_RECV	Modtag Genstand
MINI_GAME_FINDM_UPGRADE_RETRY	Forsøgs Opgradering
MINI_GAME_FINDM_UPGRADE_TITLE	Forbedr Belønning
MINI_GAME_FISH_HELP_TEXT	Hjælp
MINI_GAME_FISH_START_TEXT	Start
MINI_GAME_FISH_TITLE	Fiske Puslespil
MINI_GAME_RUMI_DISCARD_TEXT	Sikker Tilstand
MINI_GAME_RUMI_EXIT	Afslut
MINI_GAME_RUMI_LBUTTON_DESC	Venstreklik for at tilføje kort
MINI_GAME_RUMI_RBUTTON_DESC	Højreklik for at afskaf kort
MINI_GAME_RUMI_SCORE	Score
MINI_GAME_RUMI_START_TEXT	Start
MINI_GAME_RUMI_TITLE	Metin2 Okey Kortspil
MINI_GAME_YUTNORI_COM_TEXT	Computer
MINI_GAME_YUTNORI_PLAYER_TEXT	Spiller
MINI_GAME_YUTNORI_PROBABILITY	Chance
MINI_GAME_YUTNORI_PROB_DESC	Vælg et Yut score for at forøge dens chance for at blive kastet.
MINI_GAME_YUTNORI_REMAIN_COUNT	Bevægelser
MINI_GAME_YUTNORI_REWARD_TEXT	Belønning
MINI_GAME_YUTNORI_SCORE	Score
MINI_GAME_YUTNORI_START_TEXT	Start
MINI_GAME_YUTNORI_THROW	Kast
MINI_GAME_YUTNORI_TITLE	Yut Nori
MINI_GAME_YUTNORI_YUTSEM1	Do
MINI_GAME_YUTNORI_YUTSEM2	Gae
MINI_GAME_YUTNORI_YUTSEM3	Geol
MINI_GAME_YUTNORI_YUTSEM4	Yut
MINI_GAME_YUTNORI_YUTSEM5	Mo
MINI_GAME_YUTNORI_YUTSEM6	Tilbage Do
MISTS_ISLAND_EMPIRE_NAME	Rigets Navn
MISTS_ISLAND_EMPIRE_SCORE	Rigets Score
MISTS_ISLAND_END_TIME	Slut Tid
MISTS_ISLAND_EXIT	Forlad
MISTS_ISLAND_INFO_TEXT	Rang/Status info
MISTS_ISLAND_RANK	Rang
MISTS_ISLAND_SCORE	Score
MISTS_ISLAND_TITLE_RANK	Rang/Status Info
MISTS_ISLAND_TITLE_SCORE	Oversigt
MOUSEBUTTON_ATTACK	Angrib
MOUSEBUTTON_AUTO_ATTACK	Angrib automatisk
MOUSEBUTTON_CAMERA	Kamera
MOUSEBUTTON_SKILL	Færdigheder
MUSICLIST_TITLE	Musikvalg
MYSHOP_DECO_CANCEL	Luk
MYSHOP_DECO_DEFAULT	Standard
MYSHOP_DECO_NEXT	Næste
MYSHOP_DECO_OK	Bekræft
MYSHOP_DECO_PREV	Tilbage
MYSHOP_DECO_SELECT_MODEL	Vælg din butiks udseende.
MYSHOP_DECO_SELECT_TITLE	Vælg dit navns udseende.
NO	Nej
OK	OK
OPPOSITES	Afvis
OPTION_ALWAYS_SHOW_NAME	Navn
OPTION_ALWAYS_SHOW_NAME_OFF	begrænset
OPTION_ALWAYS_SHOW_NAME_ON	Altid
OPTION_BLOCK	Bloker
OPTION_BLOCK_EXCHANGE	Handel
OPTION_BLOCK_FRIEND	Venner
OPTION_BLOCK_GUILD	Orden
OPTION_BLOCK_PARTY	Gruppe
OPTION_BLOCK_PARTY_REQUEST	Ansøgning
OPTION_BLOCK_WHISPER	Hviske
OPTION_CAMERA_DISTANCE	Kamera
OPTION_CAMERA_DISTANCE_LONG	Fjern
OPTION_CAMERA_DISTANCE_SHORT	Nær
OPTION_DELETE_MOBILE_BUTTON	Slet mobilnr.
OPTION_EFFECT	Hit-info
OPTION_ENV_EFFECT	Omgivelser
OPTION_ENV_EFFECT_OFF	Off
OPTION_ENV_EFFECT_ON	On
OPTION_FOG	Tåge
OPTION_FOG_DENSE	Meget
OPTION_FOG_LIGHT	Lidt
OPTION_FOG_MIDDLE	Mellem
OPTION_FOG_OFF	Fra
OPTION_FOG_ON	Til
OPTION_INPUT_MOBILE_BUTTON	Angiv mobilnr.
OPTION_KEY_SETTING	Tastatur
OPTION_LANGUAGE_CHANGE	Anvend
OPTION_LANGUAGE_SELECT	Sprog
OPTION_MOBILE	Mobil
OPTION_MOB_INFO	Monster info
OPTION_MOB_INFO_AGGR	Aggressiv
OPTION_MOB_INFO_LEVEL	Level
OPTION_MUSIC	Musik
OPTION_MUSIC_CHANGE	Skift
OPTION_MUSIC_DEFAULT_THEMA	Metin2 Standardtitel
OPTION_NAME_COLOR	Farve navn
OPTION_NAME_COLOR_EMPIRE	Rigets farve
OPTION_NAME_COLOR_NORMAL	Normal
OPTION_NIGHT_MODE	Nat
OPTION_NIGHT_MODE_OFF	Off
OPTION_NIGHT_MODE_ON	On
OPTION_PVPMODE	PvP-Mode
OPTION_PVPMODE_FREE	Fri
OPTION_PVPMODE_FREE_TOOLTIP	Du må angribe alle spillere.
OPTION_PVPMODE_GUILD	Orden
OPTION_PVPMODE_GUILD_TOOLTIP	Du kan angribe alle spiller undtagen Ordensmedlemmer.
OPTION_PVPMODE_PEACE	Fred
OPTION_PVPMODE_PEACE_TOOLTIP	Du kan ikke angribe spillere fra dit eget rige.
OPTION_PVPMODE_REVENGE	Fjendtlig
OPTION_PVPMODE_REVENGE_TOOLTIP	Du kan kun angribe spillere der har et andet sindelag.
OPTION_SALESTEXT	Butiksnavn
OPTION_SALESTEXT_VIEW_OFF	hide
OPTION_SALESTEXT_VIEW_ON	vis
OPTION_SETTING	Åben
OPTION_SNOW_MODE	Snevejr
OPTION_SNOW_MODE_OFF	Off
OPTION_SNOW_MODE_ON	On
OPTION_SNOW_TEXTURE_MODE	Sne
OPTION_SNOW_TEXTURE_MODE_OFF	Off
OPTION_SNOW_TEXTURE_MODE_ON	On
OPTION_SOUND	Effekter
OPTION_TARGET_BOARD	Målmenu
OPTION_TARGET_BOARD_NO_VIEW	Luk
OPTION_TARGET_BOARD_VIEW	Vis
OPTION_TITLE	Indstillinger
OPTION_VIEW_CHAT	Chat
OPTION_VIEW_CHAT_OFF	hide
OPTION_VIEW_CHAT_ON	vis
PARTY_MATCH_TEXT_DUNGEON_NAME	Fangehul
PARTY_MATCH_TEXT_DUNGEON_SELECT	Vælg Fangehul
PARTY_MATCH_TEXT_ENTREE_LEVEL	Level: %d
PARTY_MATCH_TEXT_LEVEL_LIMIT	Level Krav
PARTY_MATCH_TEXT_REQUEST_MATCH	Søg
PARTY_MATCH_TEXT_REQUEST_MATCH_CANCEL	Annuller
PARTY_MATCH_TEXT_REQUIRED_ITEMS	Nødvendig Genstand
PARTY_MEMBER_INFO_NAME	Gruppemedlemmets navn
PASSWORD_DESC_1	Indtast dit kodeord
PASSWORD_DESC_2	for at åbne lageret.
PASSWORD_DESC_3	Allerede skiftet din adgangskode?
PASSWORD_DESC_4	Hvis ikke, vil din adgangskode være '000000'.
PASSWORD_DESC_5	Skift din adgangskode ved lagerforvalteren.
PASSWORD_TITLE	Gem-Kodeord
PET_AGE_TEXT	Kæledyrs Alder
PET_ATTR_CHANGE_ITEM_TEXT	Fortryl Kæledyr
PET_ATTR_CHANGE_TITLE	Skift Kæledyr Type
PET_ATTR_CONFIRMATION	Skift
PET_ATTR_DETERMINE_TITLE	Ny Kæledyr Type
PET_ATTR_OK	Luk
PET_CHANGE_TEXT	Kæledyr
PET_FEED_TITLE	Foder
PET_FFED_BUTTON_TEXT	Giv mad
PET_HATCHING_BUTTON	Udklæk
PET_HATCHING_NIK	Kæledyrs navn
PET_HATCHING_WINDOW_TITLE	Inkubator
PET_INFORMATION_ABILITIES	Bonusser
PET_INFORMATION_AGE	Alder
PET_INFORMATION_COSTUME_BONUS	Kostume bonus
PET_INFORMATION_DEFENCE	Forsvar
PET_INFORMATION_EVOL_BUTTON	Udvikle
PET_INFORMATION_EXP	Erfaring
PET_INFORMATION_EXP_BUTTON	Genstand EXP
PET_INFORMATION_HP	HP
PET_INFORMATION_LEVEL	Level
PET_INFORMATION_LIFE	Varighed
PET_INFORMATION_LIFETIME_BUTTON	Giv mad
PET_INFORMATION_LIFE_TIME	Timer
PET_INFORMATION_SKILL	Færdighed
PET_INFORMATION_SP	MP
PET_INFORMATION_TITLE	Kæledyr
PET_NAME_CHANGE_BUTTON	Skift
PET_NAME_CHANGE_WINDOW_TITLE	Skift Navn
PET_REVIVE_BUTTON	Genopliv
PET_REVIVE_CANCEL_BUTTON	Annuller
PET_REVIVE_MATERIAL_TITLE	Materiale
PET_REVIVE_REUSLT_TEXT	Resultat
PET_REVIVE_TARGET	Kæledyret der skal genoplives
PET_REVIVE_TITLE	Genopliv kæledyret
PICK_MONEY_TITLE	Dele
PRIVATESHOPSEARCH_BUY	Køb
PRIVATESHOPSEARCH_COUNT	Antal
PRIVATESHOPSEARCH_ITEMNAME	Navn
PRIVATESHOPSEARCH_ITEMTYPE	Genstande
PRIVATESHOPSEARCH_JOB	Klasse
PRIVATESHOPSEARCH_LEVEL	Level
PRIVATESHOPSEARCH_PRICE	Pris
PRIVATESHOPSEARCH_REFINE	Genstand level
PRIVATESHOPSEARCH_SEARCH	Søg
PRIVATESHOPSEARCH_SEARCH_BAR	Søg
PRIVATESHOPSEARCH_SELECT	Vælg
PRIVATESHOPSEARCH_SELLER	Sælger
PRIVATE_SHOP_CLOSE_BUTTON	Luk butik
PRIVATE_SHOP_NAME	Butikkens navn
PRIVATE_SHOP_TITLE	Åben privat butik
QUEST_UI_TEXT_COLLECTION	Biologens Missioner
QUEST_UI_TEXT_DAILY	Daglig Mission
QUEST_UI_TEXT_EVENT	Event Missioner
QUEST_UI_TEXT_LEVELUP	Jagt Mission
QUEST_UI_TEXT_MAIN	Hoved Missioner
QUEST_UI_TEXT_SCROLL	Missionsbog Missioner
QUEST_UI_TEXT_SUB	Side Missioner
QUEST_UI_TEXT_SYSTEM	Spil Missioner
REFINE_COST	Forbedringsomkostninger: 0 Yang
REFINE_ELEMENT_CHANGE_COST_TITLE	Pris
REFINE_ELEMENT_CHANGE_DARK	Mørke
REFINE_ELEMENT_CHANGE_EARTH	Jord
REFINE_ELEMENT_CHANGE_ELECT	Lyn
REFINE_ELEMENT_CHANGE_FIRE	Ild
REFINE_ELEMENT_CHANGE_ICE	Is
REFINE_ELEMENT_CHANGE_TITLE	Ændre Element
REFINE_ELEMENT_CHANGE_WIND	Vind
REFINE_ELEMENT_DOWNGRADE_TITLE	Nedgrader
REFINE_ELEMENT_UPGRADE_TITLE	Opgrader
REFINE_INFO	Sandsynligheden for forbedring: 100%
REFINE_MONEY	Forfinelses gebyr
REFINE_SELECT	Forfinelse
REFINE_TTILE	Forbedringer
REPORT_VIOLENT_WHISPER	
RESTART_GIVEUP	Opgiv
RESTART_HERE	Genstart her
RESTART_IMMEDIATE	Reinkarnation
RESTART_TOWN	Start i byen
ROULETTE_SPECIAL_TITLE	Belønninger (%s)
ROULETTE_SPIN_TEXT1	SPIND
ROULETTE_SPIN_TEXT2	50 Sjæle
ROULETTE_SPIN_TEXT3	250.000 Yang
ROULETTE_TITLE	Belønninger
SAFE_CHANGE_PASSWORD	Skift kodeord
SAFE_TITLE	Lagerrum
SELECT_ATTR_CHANGED	Ny
SELECT_ATTR_CURRENT	Nuværende
SELECT_ATTR_SELECT	Vælg
SELECT_ATTR_TITLE	Fortrylle genstand+
SELECT_ATT_GRADE	STR
SELECT_CREATE	Opret
SELECT_DELETE	Slet
SELECT_DEX_GRADE	DEX
SELECT_EMPIRE_NAME	Rigets navn
SELECT_EXIT	Afslut
SELECT_HP	VIT
SELECT_LEVEL	Level
SELECT_METIN_STONE_TITLE	Vælg Åndesten
SELECT_NAME	Navn
SELECT_NO_GUILD	Ingen Orden
SELECT_PLAYTIME	Spilletid
SELECT_SELECT	Start
SELECT_SP	INT
SELECT_TITLE	Vælg titel
SHOP_BUY	Køb
SHOP_SELL	Sælg
SHOP_TITLE	Butik
SKILL_SUPPORT_TITLE	Standard-færdigheder
STEP	Klarheds grad
STEP_SELECT	Klarheds grad
STRENGTH	Styrkelse
STRENGTH_SELECT	Level
STRUCTURE_VIEW_MODE	Dekoration
STRUCTURE_VIEW_TYPE_STRUCTURE	Skjul
SYSTEMOPTION_TITLE	Systemindstillinger
SYSTEM_CHANGE	Skift karakter
SYSTEM_EXIT	Afslut spil
SYSTEM_HELP	Hjælp
SYSTEM_LOGOUT	Log ud
SYSTEM_MALL	Itemshop
SYSTEM_MOVE_CHANNEL	Skift Kanal
SYSTEM_OPTION	Systemindstillinger
TASKBAR_CHARACTER	Karakter [C/V/B/N]
TASKBAR_CHAT	Chat-vindue [Enter]
TASKBAR_DISABLE	Deaktiveret
TASKBAR_DRAGON_SOUL	Drage stens Alkymist
TASKBAR_EXPAND	Udvid vindue
TASKBAR_INVENTORY	Inventar [I]
TASKBAR_MESSENGER	Venner [Alt+M]
TASKBAR_MONEY_EXPAND	Penge
TASKBAR_NEXT_QUICKSLOT	Næste hurtigmenu [Shift+tal, Alt]
TASKBAR_PET_INFO	Kæledyrs info
TASKBAR_PREV_QUICKSLOT	Forige hurtigmenu [Shift+tal]
TASKBAR_SYSTEM	Indstillinger [ESC]
TOTAL_RANKING	Samlede Rangliste
WARP_MI_LABEL	Til Angrebet Helligdom
WEEKLY_RANKING	Ugentlig Rangliste
WHISPER_BAN	Blokér
WHISPER_NAME	Hviske
WHISPER_REPORT	
WHISPER_SEND	Send
YES	Ja
ZONE_MAP	Stort kort
