ACCEPT	דזַ
ACCE_ABSORB	ַ׃םַָ ַבבַזַ
ACCE_COMBINE	דּׂ
ACCE_MAIN	זװַֽ 1
ACCE_RESULT	ַבהםֹּ
ACCE_SERVE	זװַֽ 2
ATTACH_METIN_INFO	וב ָׁ ם ַ׃־ַֿד ַבּֽׁ ַבװרָֽם¿
ATTACH_METIN_TITLE	ַ׃־ַֿד ַבּֽׁ ַבװרָֽם
ATTENDANCE_TITLE	ַַֽבםֹ ױםֿ ַבֳ׃םַֿ
ATTR_67_ADD	ֵײַֹ בַזֹ
ATTR_67_ADD_TITLE	ֵײַֹ בַזֹ
ATTR_67_MATERIAL_SLOT_TITLE	װםֹ
ATTR_67_REGIST_SLOT_TITLE	ַבָהֿ ַבד׃וֿ
ATTR_67_SUPPORT_SLOT_TITLE	ֵײַֹ
AURA_MAIN	דבַָ׃ ַבוַבֹ
AURA_SUB	דַֹֿ
AUTO_AUTO_ATTACK	וַּד
AUTO_AUTO_POSITION	ַּׁ
AUTO_AUTO_RANGE	ׁםׂ
AUTO_AUTO_SKILL	דוַַׁ
AUTO_CLEAR	ֵַׁ
AUTO_END	
AUTO_OFF	ֵםַ
AUTO_ON	װרצב
AUTO_POSITION_SETTING	ַּׁ
AUTO_SAVE	ֽ
AUTO_SETTING	־םַַׁ
AUTO_SKILL_SETTING	דוַַׁ
AUTO_START	ֳַָֿ
AUTO_TITLE	ױםֿ בֶַם
BANNER_ATTENDANCE_BUTTON	ַַֽבםֹ ױםֿ ַבֳ׃םַֿ
BANNER_BLACK_AND_WHITE_BUTTON	ד׃ַָֹ ַבַׁםה
BANNER_CATCHKING_BUTTON	ַבָײ בל ַבדב
BANNER_EASTER_BUTTON	ַַֽבםֹ ַבדֲַּ
BANNER_FISH_BUTTON	בׂ ַבױםֿ
BANNER_FLOWER_BUTTON	זֹ ַבֳׂוַׁ
BANNER_FOOTBALL_BUTTON	ֹׁ ַבֿד
BANNER_HALLOWEEN_BUTTON	וַבזםה
BANNER_LUCKY_EVENT	ױםֿ ַבזֽזװ
BANNER_MINIBOSS_BUTTON	ׂזֿםַ הוַםֹ ַבַבד
BANNER_MINI_GAME_FINDM	ַװ ַבזֽװ
BANNER_MONSTERBACK_BUTTON	ַ׃־ֿד הַ״ ַבֽםַֹ
BANNER_MYSTERY_BOX_BUTTON	ַַֽבםֹ ַבֶַׁ׃ I
BANNER_MYSTERY_BOX_BUTTON_2	ַַֽבםֹ ַבֶַׁ׃ II
BANNER_NEW_XMAS_BUTTON	ַבַד ַבּֿםֿ
BANNER_OKEY_BUTTON	ַַֽבםֹ-Okey
BANNER_OLYMPIC_BUTTON	ַַֽבםֹ ַבֳָ״ַב
BANNER_RAMADAN_BUTTON	ׁדײַה
BANNER_ROULETTE_BUTTON	״ז׃ ַבֿד
BANNER_SOUL_BUTTON	ַַֽבםֹ ַבׁזֽ
BANNER_SUMMER_BUTTON	ַַֽבםֹ ַבױם
BANNER_VALENTINE_BUTTON	ַבהַםה
BANNER_YUTNORI_BUTTON	םזהזׁם
BATTLE_FIELD_INFO	דה״ֹ ַבדֹׁ
BATTLE_FIELD_OPERATION_TIME	םַֽ ֿ־זב דה״ֹ ַבדֹׁ דה %s:00 זֽל ֵבל%s:00.
BATTLE_FIELD_OPERATION_TIME_ALL	ם׃דֽ ַָבֿ־זב ם ֳם ז.
BATTLE_FIELD_OPERATION_TIME_END	בַ ַׂב דה״ֹ ַבדֹׁ דזֹֽ בדֹֿ %s ׃.
BATTLE_FIELD_OPERATION_TIME_NA	ַבֿ־זב בם׃ דַֽנַ ם ַבז ַבַֽבם.
BATTLE_FIELD_OPERATION_TIME_OPEN	םדה ַבַהײדַד ָֿ %s ׃ בדֹֿ%s ׃.
BATTLE_FILED_RANK	ָֹׁ
BATTLE_FILED_RANK_EMPIRE	ֵדַָׁ״זׁםֹ
BATTLE_FILED_RANK_NAME	ַ׃ד
BATTLE_FILED_RANK_POINT	הַ״
BNW_GAME_UI_COM	־ױד
BNW_RANK_UI_COUNT	ֿֿ ַבַָׁ
BNW_RANK_UI_NAME	ַ׃ד
BNW_RANK_UI_RANK	ָֹׁ
CANCEL	ֵבֱַ
CHANGE_ATTR_SELECT	םםׁ ַבבַזֹ
CHANGE_PASSWORD_CONFIRM	ֳֿ ֵֿ־ַב בדֹ ַב׃ׁ
CHANGE_PASSWORD_NEW	בדֹ ׃ׁ ּֿםֹֿ
CHANGE_PASSWORD_OLD	בדֹ ׃ׁ ֿםדֹ
CHANGE_PASSWORD_TITLE	םםׁ בדֹ ַב׃ׁ
CHARACTER_ACTION	הװַ״ַ
CHARACTER_EMOTICON	ַ״ֹ
CHARACTER_MAIN	ַבװ־ױםֹ
CHARACTER_MUTUAL_ACTION	הװַ״ דַָֿב
CHARACTER_NORMAL_ACTION	הװַ״ ַֿם
CHARACTER_QUEST	ַבדודַ
CHARACTER_SKILL	דוַַׁ
CHARACTER_SPECTIAL_ACTION	הװַ״ ־ַױ
CHAT_FILTER	דױַֹ ַבֿֿׁװֹ
CHAT_FILTER_DICE	הֿׁ
CLOSE	ֵבַ
COMB_APPEARANCE	ַבדבם
COMB_ATTRIBUTE	ַבֳױבם
COMB_MAIN	ַבדבם
COMB_MATERIAL	ַבֳױבם
COMB_SKILLBOOK_TILE	ַ׃ַָֿב ַבָ
COMB_TITLE	
COSTUME_TITLE	ֳׂםֱַ
COSTUME_WINDOW_TITLE	ֳׂםֱַ
CREATE_ATT_GRADE	זֹ
CREATE_CREATE	ֵהװֱַ
CREATE_DEX_GRADE	דהַזֹׁ
CREATE_HP	ֽםזםֹ
CREATE_LAST_POINT	הַ״
CREATE_MAN	ּׁב
CREATE_NAME	ַ׃ד
CREATE_NEXT	ַבַבם
CREATE_PREV	ַב־ב
CREATE_SEX	ַבּה׃
CREATE_SHAPE	ַבװב
CREATE_SP	׀ֱַ
CREATE_STAT_RESET	ֵַֹֿ םםה ַבַֽבֹ
CREATE_WOMAN	ַדֳֹׁ
CUBE_INFO_TITLE	ַָ ַבױב
CUBE_RENEWAL_BELT_IMPROVE	ׁ ַבׁױֹ
CUBE_RENEWAL_TITLE	ױב
CUBE_REQUIRE_MATERIAL	ַבדזַֿ ַבד״בזָֹ
CUBE_REQUIRE_MATERIAL_OR	ֳז
CUBE_TITLE	הַ׀ֹ ַבױב
CURRENT_POINT	ֿֿ ַבהַ״ ַבַֽבםֹ: %s
CZ_REWARD_WINDOW_TITLE	דָֿ ׂזֿםַ
DO_CHANGE_ATTR	״ָר
DO_REFINE	ױב
DRAGONSOUL_ACTIVATE	םב
DRAGONSOUL_CHANGE_ATTR_WINDOW_TITLE	םםׁ בַזֹ ּֽׁ ַבהםה ַב־ַׁם
DRAGONSOUL_PAGE_BUTTON_1	־ַד
DRAGONSOUL_PAGE_BUTTON_2	דװֽז׀
DRAGONSOUL_PAGE_BUTTON_3	הַֿׁ
DRAGONSOUL_PAGE_BUTTON_4	ם
DRAGONSOUL_PAGE_BUTTON_5	ֳ׃״זׁם
DRAGONSOUL_PAGE_BUTTON_6	־ַׁם
DRAGONSOUL_REFINE_WINDOW_TITLE	הַ׀ֹ ַבױב
DRAGONSOUL_TAP_TITLE_1	דַ׃ הםה
DRAGONSOUL_TAP_TITLE_2	םַז הםה
DRAGONSOUL_TAP_TITLE_3	םװד הםה
DRAGONSOUL_TAP_TITLE_4	םַז הםה ֳׁׂ
DRAGONSOUL_TAP_TITLE_5	ם ַבהםה
DRAGONSOUL_TAP_TITLE_6	ּׂ הםה
DRAGONSOUL_TITLE	םדםֱַ ּֽׁ ַבהםה
DUTCHAUCTION_BUTTON	וםַר
DUTCHAUCTION_TITLE	ַבדַֿׂ ַב׃ׁם
EMPIRE_A	װםה׃ז
EMPIRE_ALL	ַבּדם
EMPIRE_B	װזהּז
EMPIRE_C	ּםהז
EMPIRE_EXIT	ֵהוֱַ
EMPIRE_NEXT	ַבַבם
EMPIRE_PREV	ַב׃ַָ
EMPIRE_SELECT	ַ־םַׁ
END_TIME	ַבַַֽבםֹ ַבַֽבםֹ
ENTER_BATTLE_FIELD	ַבֿ־זב
EVENT_ALARM_TITLE	הֹׁ ַדֹ
EVENT_NAME_TITLE	ַ׃ד
EVENT_REWARD_TITLE	דֳַֹ
EXCHANGE_ACCEPT	דזַ
EXCHANGE_TITLE	ַֹּׁ
EXIT_BATTLE_FIELD	וב ָׁ ֽנַ ם דַֹֿׁ דה״ֹ ַבדֹׁ¿
EXIT_BATTLE_FIELD_ON_DEAD	וב ָׁ ם דַֹֿׁ דה״ֹ ַבדֹׁ זֳה בֿם %d ה״ֹ/הַ״¿
EXPIRED_TIME	ֵהו ַבֵַֽבםֹ.
FISHING_RENEWAL_TITLE	ױםֿ ַב׃ד
FRAGMENT_COMB_TITLE	ֵֿדּ ץָ ַבדוַַׁ
GAMEOPTION_TITLE	־םַַׁ ַבבָֹ
GAME_EXIT_OBSERVER	ֵהוֱַ ֳ׃בזָ ַבדװַוֿ
GAME_GUILD_WAR_JOIN	ַהײד בָֽׁ ַבׁזַָ״
GAME_HELP	ד׃ַֹֿ
GAME_QUEST	ַבדודַ
GAME_SKILL_UP	ׂםַֹֿ ַבדוַֹׁ
GAME_STAT_UP	ׁ ַבד׃זל
GEMSHOP_LEFTTIME	ַבז ַבדָם
GEMSHOP_TITLA	דּׁ ַבַםַ
GRADE	״ָֹ
GRADE_SELECT	״ָֹ
GRAPHICONOFF_DROP_ITEM_APPLY	״ָר
GRAPHICONOFF_DROP_ITEM_LEVEL	ֵ׃ַ״ ַבָהזֿ
GRAPHICONOFF_DROP_ITEM_LEVEL1	1
GRAPHICONOFF_DROP_ITEM_LEVEL1_TOOLTIP	ֵײוַׁ ַבדִַֻׁ זַבֳ׃דֱַ
GRAPHICONOFF_DROP_ITEM_LEVEL2	2
GRAPHICONOFF_DROP_ITEM_LEVEL2_TOOLTIP	ֵ־ֱַ ַבֳֻםׁ
GRAPHICONOFF_DROP_ITEM_LEVEL3	3
GRAPHICONOFF_DROP_ITEM_LEVEL3_TOOLTIP	ֵ־ֱַ ַבדִַֻׁ זַבֳ׃דֱַ
GRAPHICONOFF_DROP_ITEM_LEVEL4	4
GRAPHICONOFF_DROP_ITEM_LEVEL4_TOOLTIP	ֵ־ֱַ ַבָהזֿ זֵוַׁ ַבַ׃ד הֿ ַבֽֿםֿ
GRAPHICONOFF_DROP_ITEM_LEVEL5	5
GRAPHICONOFF_DROP_ITEM_LEVEL5_TOOLTIP	בַ וׁ ַבָהזֿ זַבַ׃דֱַ
GRAPHICONOFF_EFFECT_APPLY	״ָר
GRAPHICONOFF_EFFECT_LEVEL	דִַֻׁ
GRAPHICONOFF_EFFECT_LEVEL1	1
GRAPHICONOFF_EFFECT_LEVEL1_TOOLTIP	ֵוַׁ ַבב
GRAPHICONOFF_EFFECT_LEVEL2	2
GRAPHICONOFF_EFFECT_LEVEL2_TOOLTIP	״ הֳֻםַׁ זַבזֽזװ
GRAPHICONOFF_EFFECT_LEVEL3	3
GRAPHICONOFF_EFFECT_LEVEL3_TOOLTIP	״ הֳֻםַׁ זַבבַָםה ַבֲ־ׁםה
GRAPHICONOFF_EFFECT_LEVEL4	4
GRAPHICONOFF_EFFECT_LEVEL4_TOOLTIP	״ ֳֻםַׁ
GRAPHICONOFF_EFFECT_LEVEL5	5
GRAPHICONOFF_EFFECT_LEVEL5_TOOLTIP	ֵ־ֱַ ַבב
GRAPHICONOFF_NPC_NAME_STATUS	ֵ׃ד בַָ ַבַֽ׃זָ
GRAPHICONOFF_NPC_NAME_STATUS_OFF	ֵםַ
GRAPHICONOFF_NPC_NAME_STATUS_OFF_TOOLTIP	ֵ־ֱַ ֵ׃ד בַָ ַבַֽ׃זָ
GRAPHICONOFF_NPC_NAME_STATUS_ON	װרצב
GRAPHICONOFF_NPC_NAME_STATUS_ON_TOOLTIP	ֵוַׁ ֵ׃ד בַָ ַבַֽ׃זָ
GRAPHICONOFF_PET_STATUS	ַׁ
GRAPHICONOFF_PET_STATUS_OFF	ֵםַ
GRAPHICONOFF_PET_STATUS_OFF_TOOLTIP	ֵ־ֱַ ַבׁם
GRAPHICONOFF_PET_STATUS_ON	װרצב
GRAPHICONOFF_PET_STATUS_ON_TOOLTIP	ֵוַׁ ַבׁם
GRAPHICONOFF_PRIVATE_SHOP_APPLY	״ָר
GRAPHICONOFF_PRIVATE_SHOP_LEVEL	דַּׁ ־ַױֹ
GRAPHICONOFF_PRIVATE_SHOP_LEVEL1	1
GRAPHICONOFF_PRIVATE_SHOP_LEVEL1_TOOLTIP	ֵוַׁ ַבב
GRAPHICONOFF_PRIVATE_SHOP_LEVEL2	2
GRAPHICONOFF_PRIVATE_SHOP_LEVEL2_TOOLTIP	ֵוַׁ ַבב ם דֽם״ ָםׁ
GRAPHICONOFF_PRIVATE_SHOP_LEVEL3	3
GRAPHICONOFF_PRIVATE_SHOP_LEVEL3_TOOLTIP	ֵוַׁ ַבב ם דֽם״ דז׃״
GRAPHICONOFF_PRIVATE_SHOP_LEVEL4	4
GRAPHICONOFF_PRIVATE_SHOP_LEVEL4_TOOLTIP	ֵוַׁ ַבב ם ַבדהַ״ ַבדַּזֹׁ
GRAPHICONOFF_PRIVATE_SHOP_LEVEL5	5
GRAPHICONOFF_PRIVATE_SHOP_LEVEL5_TOOLTIP	ֵוַׁ ַבב ם ַבדהַ״ ַבׁםָֹ
GUILDWINDOW_BASE_BUFF	בַזֹ ַבַָׁ״ֹ
GUILD_ATTENDANCE_LOCA1	ַבדװַֹׁ ַבֳזבל: x1 דםַֿבםֹ ַבװׁ
GUILD_ATTENDANCE_LOCA2	10 ֳז ֳֻׁ: x1 דםַֿבםֹ ַבװׁ
GUILD_ATTENDANCE_LOCA3	20 ֳז ֳֻׁ: x2 דםַֿבםֹ ַבװׁ
GUILD_ATTENDANCE_LOCA4	30 ֳז ֳֻׁ: x4 דםַֿבםֹ ַבװׁ
GUILD_ATTENDANCE_LOCA5	40 ֳז ֳֻׁ: x6 דםַֿבםֹ ַבװׁ
GUILD_ATTENDANCE_LOCA6	50 ֳז ֳֻׁ: x8 דםַֿבםֹ ַבװׁ
GUILD_ATTENDANCE_LOCA7	60 ֳז ֳֻׁ: x10 דםַֿבםֹ ַבװׁ
GUILD_ATTENDANCE_LOCA8	70 ֳז ֳֻׁ: x12 דםַֿבםֹ ַבװׁ
GUILD_ATTENDANCE_LOCA9	ַָֿםֹ ַבדװַֹׁ: םזדםנַ ַב׃ַֹ 5:00
GUILD_ATTENDANCE_TITLE	דֳַֹ ַבדװַֹׁ
GUILD_BANKINFO_CLOSE	ֳב
GUILD_BANKINFO_NAME	ײז
GUILD_BANKINFO_TITLE	׃ּב ד׃זֿ ַבַָׁ״ֹ
GUILD_BANKINFO_TYPE	ֳװםֱַ/דבֹ
GUILD_BANKINFO_USETYPE	דבםֹ
GUILD_BANK_CLOSE	ֳב
GUILD_BANK_INFO	ַבד׃זֿ:
GUILD_BANK_NUMBER	ׁד ַבָה
GUILD_BASEINFO_BANK	ד׃זֿ ַבַָׁ״ֹ
GUILD_BASEINFO_BANKLASTOUT	ֲ־ׁ ָהֿ ֳ־׀
GUILD_BASEINFO_BUILDING	ָהַםֹ ַבַָׁ״ֹ
GUILD_BASEINFO_DEAL	ָם ֳׁײ ַבַָׁ״ֹ
GUILD_BASEINFO_FACTORY	ַֽֿֿ ַבַָׁ״ֹ
GUILD_BASEINFO_GOLDMANAGE	ױֹ
GUILD_BASEINFO_GUILDLAND	ֳׁײ ַבַָׁ״ֹ
GUILD_BASEINFO_LANDABANDON	ֽבר ֳׁײ ַבַָׁ״ֹ
GUILD_BASEINFO_LANDSCAPE	םׁו
GUILD_BASEINFO_LOCALE	ַבדַה
GUILD_BASEINFO_MONEY	ׁױםֿ ַבֽ׃ַָ
GUILD_BASEINFO_MONEYBANKINFO	דבזדַ ה ָה ַבַָׁ״ֹ
GUILD_BASEINFO_MONEYIN	ֵםַֿ
GUILD_BASEINFO_MONEYLASTOUT	ֳ־ׁ ׃ָֽ
GUILD_BASEINFO_MONEYOUT	׃ָֽ
GUILD_BASEINFO_POWER	ד׀ָֽ ַבזֹ
GUILD_BASEINFO_SMEITER	םדםֶַם ַבַָׁ״ֹ
GUILD_BASEINFO_TITLE	דבזדַ ה ַבֳׁײ
GUILD_BASEINFO_VOTE	ַ׃״בַ
GUILD_BASENAME	ַ׃ד ַבַֹֿ
GUILD_BOARD_ID	ַ׃ד
GUILD_BOARD_REFRESH	ֽֿםֻ
GUILD_BOARD_TEXT	ׁ׃ַבֹ
GUILD_BUILDING_CATEGORY_TITLE	זַֽֿ ָהֱַ
GUILD_BUILDING_CHANGE	ָֿםב
GUILD_BUILDING_CHANGE_DELETE	ַֽ׀
GUILD_BUILDING_CHANGE_FIX	ּֿםֿ ַבַָׁ״ֹ
GUILD_BUILDING_CHANGE_LIST	בֶַֹֽ ֳָװםֱַ ַבׁזַָ״
GUILD_BUILDING_DIRECTION	ַבַַּו
GUILD_BUILDING_FIX	ּֿםֿ
GUILD_BUILDING_GRADE	ָֹׁ
GUILD_BUILDING_INFO	דבזדַ ה ַבדָהל זַב׃ׁ
GUILD_BUILDING_LIST_TITLE	בֶַֹֽ ַבדַָהם
GUILD_BUILDING_LOG	ּ׀
GUILD_BUILDING_NAME	ַ׃ד ַבדָהל
GUILD_BUILDING_OPERATE	װםב
GUILD_BUILDING_PLY	־װָ ֶַׁם
GUILD_BUILDING_POSITION	דז
GUILD_BUILDING_PREVIEW	הֹׁ ַדֹ
GUILD_BUILDING_PRICE	ַב׃ׁ
GUILD_BUILDING_REFRESH	ֽֿםֻ
GUILD_BUILDING_STONE	ּֽׁ
GUILD_BUILDING_TITLE	ָהֱַ דהׂב ַבַָׁ״ֹ
GUILD_CRYSTAL	ָבזׁ
GUILD_DEPOSIT	ֳַׁד
GUILD_DONATE_BUTTON_OVER_TEXT	װםֱ װזֶַם
GUILD_DONATE_COUNT	ַבַָׁ ַבדַֹֽ: %d/%d
GUILD_DONATE_GET_MEDAL_OF_HONOR	%d
GUILD_DONATE_GUILD_EXP	־ָֹׁ EXP בבַָׁ״ֹ
GUILD_DONATE_HIGH_MATERIAL	ָׁ ָםׁ
GUILD_DONATE_MEDAL_OF_HONOR	דםַֿבםֹ ַבװׁ
GUILD_DONATE_MIDDLE_MATERIAL	ָׁ דז׃״ֹ
GUILD_DONATE_MY_MEDAL_OF_HONOR	דםַֿבםֹ ַבװׁ ַב־ַױֹ ָם
GUILD_DONATE_NORMAL_MATERIAL	120.000 םַה
GUILD_DONATE_TAB_HIGH	ָׁ ָםׁ
GUILD_DONATE_TAB_MIDDLE	ָׁ דז׃״ֹ
GUILD_DONATE_TAB_NORMAL	ָׁ ױםׁ
GUILD_DONATE_TITLE	ַבָׁ ַָב־ָֹׁ EXP
GUILD_DRAGONLAIR_RANKING	בֶַֹֽ ַבדױֿרׁםה
GUILD_DRAGONLAIR_RANKING_COUNT	ַבָֹׁ
GUILD_DRAGONLAIR_RANKING_MEMBER	ַבֳײֱַ
GUILD_DRAGONLAIR_RANKING_NAME	ַָׁ״ֹ
GUILD_DRAGONLAIR_RANKING_TIME	ַבז
GUILD_DROP_RESOURCE1	והַ
GUILD_DROP_RESOURCE2	ֵ׃ַ״ ַבדזַֿׁ
GUILD_GEM	ּזוֹׁ
GUILD_GRADE_CHANGE_GRADE_NAME	ַ׃ד ּֿםֿ בבױהם
GUILD_GRADE_NUM	ׁד
GUILD_GRADE_PERMISSION_BANK	םדהו ַ׃־ַֿד ָה ַבַָׁ״ֹ זד׃זֿ ַבַָׁ״ֹ
GUILD_GRADE_PERMISSION_DELETE	ֵַָֿו ה ַבַָׁ״ֹ
GUILD_GRADE_PERMISSION_JOIN	םדהו ײד בַָםה ֲ־ׁםה ֵבל ַבַָׁ״ֹ
GUILD_GRADE_PERMISSION_NOTICE	םדהו ֵבױַ ַבד׀ַׁ ַב־ַױֹ ַָבַָׁ״ֹ
GUILD_GRADE_PERMISSION_SKILL	דוַַׁ ַבׁזַָ״
GUILD_GRADE_PERMISSION_WAR	םדהו ַ־םַׁ ַבֳײֱַ ַבד׃דזֽ בוד ַבדװַֹׁ ם ַבַב.
GUILD_GRADE_RANK	ַבָֹׁ
GUILD_GRADE_WRITE	ַָֹ
GUILD_INFO	דבזדַ ה ַבַָׁ״ֹ
GUILD_INFO_CUR_EXP	־ָֹׁ
GUILD_INFO_DECALRE_WAR	ֵבַה ָֽׁ
GUILD_INFO_ENEMY_GUILD	ַָׁ״ֹ דַֿםֹ
GUILD_INFO_ENEMY_GUILD_EMPTY	בַ װםֱ
GUILD_INFO_LEVEL	ד׃זל ַבַָׁ״ֹ
GUILD_INFO_MARK	בַדֹ ַבַָׁ״ֹ
GUILD_INFO_MASTER	ׂםד
GUILD_INFO_MASTER_VALUE	ׂםד
GUILD_INFO_MEMBER_AVG_LEVEL	ד׃זל דז׃״
GUILD_INFO_MEMBER_NUM	ֿֿ ַבֳײֱַ
GUILD_INFO_NAME	ַ׃ד ַבַָׁ״ֹ
GUILD_INFO_NAME_VALUE	ו׀ַ ַ׃ד ַָׁ״ֹ
GUILD_INFO_OFFER_EXP	ֵ׃ֻדַׁ
GUILD_INFO_REST_EXP	ַב־ָֹׁ ַבד״בזָֹ
GUILD_INFO_UPLOAD_MARK	ֽדםב בַדֹ
GUILD_INFO_UPLOAD_SYMBOL	ֽדםב בד
GUILD_LANDDEAL_VOTE	ָם ֳׁײ ַבַָׁ״ֹ
GUILD_LANDDEAL_VOTE_DEALGOLD	ַב׃ׁ ַָבםַה:
GUILD_LANDDEAL_VOTE_DEALGUILDNAME	ַ׃ד ַבַָׁ״ֹ:
GUILD_MARK	בַדֹ ַבַָׁ״ֹ
GUILD_MASTER_CHANGE_TITLEBAR	זם םַֹֿ ַבַָׁ״ֹ
GUILD_MEMBER_JOB	״ָֹ
GUILD_MEMBER_KNIGHT	דַב
GUILD_MEMBER_LEVEL	ד׃זל
GUILD_MEMBER_NAME	ַ׃ד
GUILD_MEMBER_OUT_TITLEBAR	ֽ׀ ײז
GUILD_MEMBER_PACE_ATTENDANCE	ַװַׁ ({0}/{1})
GUILD_MEMBER_RANK	ָֹׁ
GUILD_MEMBER_SPECIFIC_GRAVITY	ֵ׃ֻדַׁ
GUILD_MEMBER_VOTE_CHECK	דַֹּׁ ַבַ׃״בַַ
GUILD_METIN_STONE	ַבּֽׁ ַבװרָֽם
GUILD_MINENAL	דֿה
GUILD_MONEY	םַה
GUILD_NAME	ַָׁ״ֹ
GUILD_RESOURCE_INFO	דבזדַ ה ַבדױַֿׁ
GUILD_SKILLPAGE_LADDER	הַ״ ַבׁםָ
GUILD_SKILLPAGE_RANK	ָֹׁ
GUILD_SKILL_ACTIVE	רַב
GUILD_SKIlL_HEAL_GSP	װֽה הַ״ ַבֽםַֹ
GUILD_SKILL_PASSIVE	םׁ רַב
GUILD_SKILL_POWER	״ַֹ
GUILD_SKILL_STATE	דוַֹׁ ַבַָׁ״ֹ
GUILD_SYMBOL	בד ַבַָׁ״ֹ
GUILD_WAR_ACCEPT	זַ בל ֵבַה ָֽׁ
GUILD_WAR_ALLSCORE	ּדם ַבדַׁ
GUILD_WAR_BATTLE_TYPE	הז ַבדֹׁ
GUILD_WAR_CTF	בףד
GUILD_WAR_DECLARE	ֵבַה ָֽׁ ַבַָׁ״ֹ
GUILD_WAR_ENEMY	־ױד
GUILD_WAR_GAINSCORE	הַ״
GUILD_WAR_GAINSCORE_FIFTY	50
GUILD_WAR_GAINSCORE_HUNDRED	100
GUILD_WAR_GAINSCORE_THIRTY	30
GUILD_WAR_GAMETIME	דֹֿ ַבַב
GUILD_WAR_GAMETIME_SIXTY	60 ֿםֹ
GUILD_WAR_GAMETIME_TEN	10 ֶַֿ
GUILD_WAR_GAMETIME_THIRTY	30 ֿםֹ
GUILD_WAR_JOINMEMBER	ַבֳײֱַ
GUILD_WAR_JOINMEMBER_COUNT	ַבֳײֱַ
GUILD_WAR_JOINMEMBER_FIFTEEN	15
GUILD_WAR_JOINMEMBER_FIVE	5
GUILD_WAR_JOINMEMBER_TEN	10
GUILD_WAR_NORMAL	׃ַֹֽ ַבדֹׁ
GUILD_WAR_REPORT	ׁםׁ ַבָֽׁ
GUILD_WAR_REPORTLIST	ׁםׁ (דַׁ: ד. ÷ ַהױַַׁ: ַה. ÷ וֶַׂד: וׂ. ÷ ַֿבַ: .)
GUILD_WAR_SCORE	ׁםׁ ַבָֽׁ
GUILD_WAR_SKILL	דוַַׁ ַבׁזַָ״
GUILD_WAR_TYPE_DEFENSE	ַב ַבֿׁז
GUILD_WAR_TYPE_DIE	׃ַֹֽ ַבָֽׁ
GUILD_WAR_TYPE_FLAG	ַב ַבֳבַד
GUILD_WAR_TYPE_NORMAL	דםַֿה ַבַב
GUILD_WAR_TYPE_TIGER	דֹׁ ַבֵַָֹֿ
GUILD_WAR_TYPE_TIME	וּזד ׂדהם
GUILD_WAR_WARP	דםַֿה
GUILD_WAR_WIN	ּזבַ
GUILD_WAR_WIN_FIVE	5
GUILD_WAR_WIN_ONE	1
GUILD_WAR_WIN_THREE	3
GUILD_WATER	דֱַ
GUILD_WATER_STONE	ּֽׁ דֶַם
GUILD_WITHDRAW	ַ׃בַד
HELP_ATTACK	םץב ַבוּזד ַבדהֿׁ ָהֹׁ זֽםֹֿ.
HELP_ATTACK_KEY	ַבוּזד: ַײ״ בל ַבׁׂ ַבֳם׃ׁ בבֳֹׁ ֳז דַֽ ַבד׃ַֹ
HELP_AUTO_ATTACK	םב ַבוּזד ַברבֶַם ָהֹׁ זֽםֹֿ.
HELP_CAMERA	הֹׁ ַבַדםַׁ
HELP_CHANGE_PK_MODE	םםׁ ֳ׃בזָ ַבוּזד: ֿםב זםֹ ַבׁׂ ַבֳם׃ׁ בבֳֹׁ
HELP_CHARACTER_BUTTON1	(ֶַדֹ ַבװ־ױםֹ¡ ֶַדֹ ַבדדבַ¡
HELP_CHARACTER_BUTTON2	ֶַדֹ ַבֳױֱַֿ זַב־םַַׁ)
HELP_CHAT	ַָ דַ םבם ם ַָֿםֹ ׁ׃ַב בד־ַ״ָֹ דּדזֹ דה ַבֳױֱַֿ: !(בבֿֿׁװֹ)¡ #(בבֿֿׁװֹ ד דּדזֹ)¡ ֳז %(בבֿֿׁװֹ ד ַבַָׁ״ֹ).
HELP_CLICK_OTHER_PLAYER	םדה ָהׁ ׁׂ ַבֳֹׁ ַבֳםדה בל בַָ דה ַבבַרָםה ַבדַֹּׁ דו¡ ֳז זםה דּדזֹ דו¡ ֳז ״בָ ַבדַָֹׁׂ ײֿרו.
HELP_CONTROL_CAMERA_BY_MIDDLEBUTTON	הֹׁ ַבַדםַׁ: ַבׁׂ ַבֳז׃״
HELP_CONTROL_CAMERA_BY_RIGHTBUTTON	םםׁ הֹׁ ַבַדםַׁ: ַבׁׂ ַבֳםדה ֳז ַבֳם׃ׁ בבֳֹׁ
HELP_EMOTINO	בבָםׁ ה ַבדװַׁ ַ׃־ֿד ׁםָֹ דה ׁםַָ ַבדַםֽ <CTRL> + <1~9>.
HELP_EXP	־ָֹׁ
HELP_FURY	דּׁ ַבבָֹ
HELP_GUILD_WINDOW	ֽ הַ׀ֹ ַבַָׁ״ֹ: Alt + G
HELP_HELP	ׁײ ַבד׃ַֹֿ: H
HELP_HELP_KEY	םדֻב ַבׁײ ם ַבד׃ַֹֿ ַב־םַַׁ ַבַַׁײםֹ.
HELP_HP	הַ״ ַבֽםַֹ (HP)
HELP_KEYSETTING	םדה ֽֿםֿ ׁםַָ דַםֽ ־ַױֹ ָ ם ־םַַׁ ַבברָֹ.
HELP_MESSENGER_WINDOW	ֽ ֶַדֹ ַבֳױֱַֿ: Alt + M
HELP_MINIMAP	םׁײ ַב־ׁם״ֹ ַבױרםֹׁ.
HELP_MINIMAP_QUEST	׃וׁ ַבדוַד ם ַב־ׁם״ֹ ַבױםֹׁ זַבָםֹׁ ם װב ׁדזׂ בַדֹ.
HELP_MOUSE_LEFT	זםֹ ַבׁׂ ַבֳם׃ׁ בבדַז׃
HELP_MOUSE_RIGHT	זםֹ ַבׁׂ ַבֳםדה בבדַז׃
HELP_MOVE_KEY	ַבֽד ם ֹֽׁ ַבװ־ױםֹ: W¡ A¡ S¡ D ֳז ֳַׁׁׂ ַבֳ׃וד
HELP_OFF_QUESTSCROLL	ַײ״ <CTRL> + Q בֵוַׁ ֳז ֵ־ֱַ בֶַ ַבדוַד.
HELP_OPEN_CHARACTER	ֽ ֶַדֹ ַבװ־ױםֹ: C
HELP_OPEN_CHAT	ֽ הַ׀ֹ ַבֿֿׁװֹ: Enter
HELP_OPEN_INVENTORY	ֽ ֶַדֹ ַבדדבַ: I
HELP_OPEN_LOG	ֽ ׃ּב ַבֿֿׁװֹ (log): L
HELP_OPEN_MINIMAP	ֽ ַב־ׁם״ֹ ַבױםֹׁ: Schift + M
HELP_OPEN_QUEST	ֽ הַ׀ֹ ַבדוַד: N
HELP_OPEN_SKILL	ֽ הַ׀ֹ ַבדוַַׁ: V
HELP_OPEN_WHISPER	ֽ הַ׀ֹ ַבוד׃: Shift + Enter
HELP_OPEN_ZONEMAP	ֽ ַב־ׁם״ֹ ַבָםֹׁ: M
HELP_PICK_ITEM	ַבַ״ ַבֳװםֱַ דה בל ַבֳׁײ: בזֹֽ דַםֽ ַהּבםׂםֹ: ַבׁׂ ַבֳם׃ׁ בבֳֹׁ ֳז Z ֳז ` ÷ בזֹֽ דַםֽ ָׁםֹ: ַבׁׂ ַבֳם׃ׁ בבֳֹׁ ֳז ֶ ֳז ׀ ÷ בזֹֽ דַםֽ ׁה׃םֹ: ַבׁׂ ַבֳם׃ׁ בבֳֹׁ ֳז W ֳז ²
HELP_QUICKSLOT	־ַהַ ַבזױזב ַב׃ׁם
HELP_SCREEN_CAPTURE	ֽ ב״ֹ ַבװַװֹ: ַײ״ בל ׁׂ 'Print Screen' ֳז ’Print’ (׃ץֽ ַבב״ַ ם דב ּֿו ם ’’Metin2/screenshot’’)
HELP_SERVER	םׁײ ב ַב־ַֿד זַבהַֹ.
HELP_SHOW_ALL_NAME	ׁײ ַבֳ׃דֱַ: Alt
HELP_SKILL	םדה והַ בד ֵֽֿל ַבדוַַׁ ַָבהׁ בל ַבׁׂ ַבֳםדה בבֳֹׁ.
HELP_SP	הַ״ ַבֳ׃בזָ (MP)
HELP_SYSTEM_BUTTON	דַםֽ ַבהַד
INVENTORY_PAGE_BUTTON_TOOLTIP_1	1. ֶַדֹ ַבּֿׁ
INVENTORY_PAGE_BUTTON_TOOLTIP_2	2. ֶַדֹ ַבּֿׁ
INVENTORY_PAGE_BUTTON_TOOLTIP_3	3. ֶַדֹ ַבּֿׁ
INVENTORY_PAGE_BUTTON_TOOLTIP_4	4. ֶַדֹ ַבּֿׁ
INVENTORY_TITLE	ֶַדֹ ַבּֿׁ
ITEM_MALL	דּׁ ַבֳװםֱַ
KEYCHANGE_ACTION_WINDOW	ֱֵַַּׁ
KEYCHANGE_ATTACK	וּזד
KEYCHANGE_AUTORUN	דװל בֶַםַ
KEYCHANGE_AUTO_WINDOW	ױםֿ בֶַם
KEYCHANGE_BASEACTION	ַב־םַַׁ ַבַַׁײםֹ
KEYCHANGE_CAM_DOWN1	ַדםַׁ (ֳ׃ב)
KEYCHANGE_CAM_DOWN2	ַדםַׁ (ֳ׃ב)
KEYCHANGE_CAM_LEFT1	ַדםַׁ (ם׃ַׁ)
KEYCHANGE_CAM_LEFT2	ַדםַׁ (ם׃ַׁ)
KEYCHANGE_CAM_RIGHT1	ַדםַׁ (םדםה)
KEYCHANGE_CAM_RIGHT2	ַדםַׁ (םדםה)
KEYCHANGE_CAM_UP1	ַדםַׁ (ֳבל)
KEYCHANGE_CAM_UP2	ַדםַׁ (ֳבל)
KEYCHANGE_CAM_ZOOM_IN1	ַדםַׁ (ָםׁ +)
KEYCHANGE_CAM_ZOOM_IN2	ַדםַׁ (ָםׁ +)
KEYCHANGE_CAM_ZOOM_OUT1	ַדםַׁ (ױםׁ -)
KEYCHANGE_CAM_ZOOM_OUT2	ַדםַׁ (ױםׁ -)
KEYCHANGE_CANCLE	ֵבֱַ
KEYCHANGE_CHAT_WINDOW	׃צּברץ ַבֿֿׁװֹ
KEYCHANGE_CLEAR	ַֿם
KEYCHANGE_DDS_WINDOW	DSS
KEYCHANGE_DOWN1	ֵבל ַבזֱַׁ
KEYCHANGE_DOWN2	ֵבל ַבזֱַׁ
KEYCHANGE_DSS1	ֽ. [׃דֱַ]
KEYCHANGE_DSS2	ֽ. [ֳׁײ]
KEYCHANGE_EMOTION1	ׁדׂ ַבדװַׁ (ֽׂםה)
KEYCHANGE_EMOTION2	ׁדׂ ַבדװַׁ (םַה)
KEYCHANGE_EMOTION3	ׁדׂ ַבדװַׁ (דז׃םל)
KEYCHANGE_EMOTION4	ׁדׂ ַבדװַׁ (בָ)
KEYCHANGE_EMOTION5	ׁדׂ ַבדװַׁ (בָ ױםׁ)
KEYCHANGE_EMOTION6	ׁדׂ ַבדװַׁ (הָבֹ)
KEYCHANGE_EMOTION7	ׁדׂ ַבדװַׁ (ֹׁ)
KEYCHANGE_EMOTION8	ׁדׂ ַבדװַׁ (ַױֹ)
KEYCHANGE_EMOTION9	ׁדׂ ַבדװַׁ (ֲ׃)
KEYCHANGE_GUILD_WINDOW	ַָׁ״ֹ
KEYCHANGE_HELP_WINDOW	ד׃ַֹֿ
KEYCHANGE_IMPOSSIBLE_CHANGE	בַ ם׃דֽ והַ ַָ׃דַב [Ctrl]¡ [Alt]¡ ז [Shift]!
KEYCHANGE_INGAMEEVENT	ַַֽבםֹ
KEYCHANGE_INTERFACE	הַ׀ֹ
KEYCHANGE_INVENTORY_WINDOW	ֶַדֹ ַבּֿׁ
KEYCHANGE_KEY_SETTING	־םַַׁ בזֹֽ ַבדַםֽ
KEYCHANGE_LEFT1	ׁזַָ״
KEYCHANGE_LEFT2	ם׃ַׁ
KEYCHANGE_MESSENGER_WINDOW	ֳױֱַֿ
KEYCHANGE_MINIMAP_MINER	־ׁם״ֹ ױםֹׁ (-)
KEYCHANGE_MINIMAP_PLUS	־ׁם״ֹ ױםֹׁ (+)
KEYCHANGE_MINIMAP_WINDOW	־ׁם״ֹ ָםֹׁ
KEYCHANGE_MONSTER_CARD_WINDOW	ָ״ַֹ ַבזֽזװ
KEYCHANGE_NEXT_TARGET	ַבוֿ ַבַבם
KEYCHANGE_PARTY_MATCH_WINDOW	ַבָֻֽ ה דּדזֹ
KEYCHANGE_PET_WINDOW	ׁם
KEYCHANGE_QUEST_SCROLL_ONOFF	ׁײ ַבדוַד
KEYCHANGE_QUEST_WINDOW	דוַד
KEYCHANGE_QUICKSLOT1	ַבד׃זל 1
KEYCHANGE_QUICKSLOT2	ַבד׃זל 2
KEYCHANGE_QUICKSLOT3	ַבד׃זל 3
KEYCHANGE_QUICKSLOT4	ַבד׃זל 4
KEYCHANGE_RIDE	ׁזָ
KEYCHANGE_RIDE_BYE	ֳׁ׃ב ַבֽױַה
KEYCHANGE_RIDE_HORSE	ׁזָ
KEYCHANGE_RIDE_PEED	בם ַבֽױַה
KEYCHANGE_RIGHT1	םדםה
KEYCHANGE_RIGHT2	םדםה
KEYCHANGE_ROOT1	ַב״
KEYCHANGE_ROOT2	ַב״
KEYCHANGE_SAVE	ֽ
KEYCHANGE_SCREENSHOT	ב״ֹ װַװֹ
KEYCHANGE_SHOW_NAME	ׁײ ַבֳ׃דֱַ
KEYCHANGE_SKILL_WINDOW	דוַַׁ
KEYCHANGE_SLOT1	ַבֹֽ 1
KEYCHANGE_SLOT2	ַבֹֽ 2
KEYCHANGE_SLOT3	ַבֹֽ 3
KEYCHANGE_SLOT4	ַבֹֽ 4
KEYCHANGE_SLOT5	ַבֹֽ 5
KEYCHANGE_SLOT6	ַבֹֽ 6
KEYCHANGE_SLOT7	ַבֹֽ 7
KEYCHANGE_SLOT8	ַבֹֽ 8
KEYCHANGE_SLOT_KET	ַֽ ַבזױזב ַב׃ׁם
KEYCHANGE_STATUS_WINDOW	װ־ױםֹ
KEYCHANGE_UP1	ֵבל ַבֳדַד
KEYCHANGE_UP2	ֵבל ַבֳדַד
LANGUAGE_AE	ַבָׁםֹ
LANGUAGE_CZ	ַבװםםֹ
LANGUAGE_DE	ַבֳבדַהםֹ
LANGUAGE_DK	ַבַֿהדַׁםֹ
LANGUAGE_EN	ַבֳהּבםׂםֹ
LANGUAGE_ES	ַבֵ׃ַָהםֹ
LANGUAGE_FR	ַבׁה׃םֹ
LANGUAGE_GR	ַבםזהַהםֹ
LANGUAGE_HU	ַבוהַׁםֹ
LANGUAGE_IT	ַבֵם״ַבםֹ
LANGUAGE_NL	ַבוזבהֿםֹ
LANGUAGE_PL	ַבָזבהֿםֹ
LANGUAGE_PT	ַבַָׁבםֹ
LANGUAGE_RO	ַבׁזדַהםֹ
LANGUAGE_RU	ַבׁז׃םֹ
LANGUAGE_TR	ַבׁםֹ
LOAD_ERROR	ֵה ַבדב םׁ ױַבֽ. ַבֱַּׁ ֵַֹֿ ָֻםו. ַײ״ ַבֲה בל  ׁׂ ’’ESC’’.
LOGIN_CONNECT	ָׁ״ ַבַױַב
LOGIN_CONNECTING	׃םד ָׁ״ ַבַױַב ַָב־ַֿד.
LOGIN_DEFAULT_SERVERADDR	ַ׃ד ַב־ַֿד¡ הַֹ 1
LOGIN_EXIT	ֵהוֱַ
LOGIN_ID	ַ׃ד ַבד׃־ֿד
LOGIN_PASSWORD	בדֹ ַב׃ׁ
LOGIN_REGION_TITLE	ֽֿֿ דַהַנ בֵױַֿׁ ַבַזֹׁ
LOGIN_SELECT_BUTTON	ַ־ׁ
LOGIN_SELECT_EXIT	ֵהוֱַ
LOGIN_SELECT_OK	דזַ
LOGIN_SELECT_TITLE	ַ־ׁ ־ַֿד
LUCKY_BOX_NOTICE_YANG	ׁ׃זד םַה בָהֿ ֽ ּֿםֿ
LUCKY_BOX_RECV_BUTTON	ָזב ַבָהֿ
LUCKY_BOX_RECV_NAME	ַבדֽזל:
LUCKY_BOX_RETRY_BUTTON	ָהֿ ֽ ּֿםֿ
LUCKY_BOX_TITLE_NAME	ױהֿז ַבֽ
MAILBOX_POST_ALL_DELETE_BUTTON	ַֽ׀ ַבב
MAILBOX_POST_ALL_RECEIVE	ַָב ַבב
MAILBOX_POST_READ_BLOCK	ֽׁ
MAILBOX_POST_READ_DELETE	ַֽ׀
MAILBOX_POST_READ_FROM	דה
MAILBOX_POST_READ_MAIN_TITLE	ׁ׃ַבֹ
MAILBOX_POST_READ_RECV	ָזב
MAILBOX_POST_READ_TITLE	ַבהזַה
MAILBOX_POST_SEND_TITLE	ׁ׃ַבֹ
MAILBOX_POST_WRITE_BUTTON_TEXT	ֵׁ׃ַב
MAILBOX_POST_WRITE_CLOSE_TEXT	ֳב
MAILBOX_POST_WRITE_CONFIRM_TEXT	ֽ דה ַבדבם
MAILBOX_POST_WRITE_SEND_TEXT	ֵׁ׃ַב
MAILBOX_POST_WRITE_TITLE	ַבהזַה
MAILBOX_POST_WRITE_TO	ֵבל
MAILBOX_TITLE	ױהֿז ַבזַֿׁ
MALL_PASSWORD_TITLE	בדֹ ַב׃ׁ
MALL_TITLE	ד־ׂה דּׁ ַבָהזֿ
MARKET_TITLE	װֽה
MARKLIST_REFRESH	ּֿםֿ
MARKLIST_TITLE	׃ּב בַדֹ ַבַָׁ״ֹ
MC_EXCHANGE_BUTTON	ַָֿב
MC_MISSION_INIT_BUTTON	ַַֹֿ םםה ד׃זל ַבדודֹ
MC_MOTION_BUTTON	ֹֽׁ
MC_POLY_BUTTON	ֽזםב
MC_PROMOTION_BUTTON	ֽ׃םה
MC_REQUEST_MISSION_BUTTON	ָזב ַבדודֹ
MC_REWARD_CARD_BUTTON	ַּד ָ״ַֹ ַבזֽזװ
MC_SHUFFLE_BUTTON	־ב״ ָ״ַַ ַבדודֹ דה ּֿםֿ
MC_SUMMON_BUTTON	ַ׃ֱַֿ
MC_TAB_BUTTON_CARD_MISSION	דודֹ ַבָ״ַֹ
MC_TAB_BUTTON_PARTY	דּדזֹ ַבֳַָּׁ ַבדֽױהֹ
MC_TAB_BUTTON_SOLO	דּדזֹ ַבדםַֿםה
MC_WARP_BUTTON	ַבַהַב
MESSAGE	ו׀ו ׁ׃ַבֹ
MESSENGER_ADD_FRIEND	ֵײַֹ ױֿם
MESSENGER_BLOCK_FRIEND	ֽׁ
MESSENGER_DELETE_FRIEND	ַֽ׀
MESSENGER_MOBILE	ֵׁ׃ַב ׁ׃ַבֹ הױםֹ
MESSENGER_OPEN_GUILD	ֽ הַ׀ֹ ַבַָׁ״ֹ
MESSENGER_TITLE	ֳױֱַֿ
MESSENGER_USE_GUILD_MOVE_SKILL	ַ׃־ֿד דוַֹׁ ֽׁרץ ַבַָׁ״ֹ
MESSENGER_WHISPER	וד׃
MINIGAME_FISH_EVENT_USE_COUNT	ֿֿ
MINIMIZE	ױםׁ
MINI_BOSS_DUNGEON_DESC_BTN	זַֿ ַבַַֽבםֹ
MINI_BOSS_DUNGEON_TITLE_NAME	ַבדװַׁזה
MINI_BOSS_DUNGEON_TITLE_NUM	ָֹׁ
MINI_BOSS_DUNGEON_TITLE_POINT	הַ״ ַבָּׁ ַבדֽױה
MINI_BOSS_DUNGEON_TOOTIP_01	הֹׁ ַדֹ בבָּׁ ַבדֽױה
MINI_BOSS_DUNGEON_TOOTIP_02	ָּׁ דֽױה דה ד׃זל 40 ֽל 80
MINI_BOSS_DUNGEON_TOOTIP_03	ָּׁ דֽױה ֱַַָֿ דה ד׃זל 81
MINI_BOSS_DUNGEON_TOOTIP_04	ַבֿ־זב
MINI_BOSS_DUNGEON_TOOTIP_05	ַבז ַבדָם
MINI_BOSS_DUNGEON_TOOTIP_06	הַ״ם ם ַבָּׁ ַבדֽױה
MINI_BOSS_DUNGEON_TOOTIP_07	ַבֳַָּׁ ַבדֽױהֹ ַבדָםֹ
MINI_BOSS_DUNGEON_TOOTIP_08	דֶַם
MINI_BOSS_TITLE	ׂזֿםַ הוַםֹ ַבַבד
MINI_GAME_BLACK_AND_WHITE_DONATE	ָׁ
MINI_GAME_BLACK_AND_WHITE_GAME_TITLE	ד׃ַָֹ ַבַׁםה
MINI_GAME_BLACK_AND_WHITE_RANK_BUTTON	בֶַֹֽ ַבׁרץָ
MINI_GAME_BLACK_AND_WHITE_REWARD_TRADE	ַבּזֶַׂ
MINI_GAME_BLACK_AND_WHITE_START_BUTTON	ֳַָֿ
MINI_GAME_BLACK_AND_WHITE_WAITTING_TITLE	ד׃ַָֹ ַבַׁםה
MINI_GAME_CATCHKING_CHALLENGE	ַ׃־ַֿד
MINI_GAME_CATCHKING_HELP_TEXT	ַבזַֿ
MINI_GAME_CATCHKING_HIGH_SCORE	בֶַֹֽ ַבׁםָ
MINI_GAME_CATCHKING_MYNUMBER	ָ״ַם
MINI_GAME_CATCHKING_POPUP_CONFIRM	ׁײ/ֵ־ֱַ
MINI_GAME_CATCHKING_RETRY	ֵבָ דֹׁ ֳ־ׁל
MINI_GAME_CATCHKING_REWARD	ּזֶַׂם
MINI_GAME_CATCHKING_SCORE	הַ״
MINI_GAME_CATCHKING_SELECTION_NUMBER	ַװ ַבָ״ַֹ
MINI_GAME_CATCHKING_START_TEXT	ֳַָֿ
MINI_GAME_CATCHKING_TITLE	ַבָײ בל ַבדב
MINI_GAME_FINDM_HINT_BTN	הָםו
MINI_GAME_FINDM_START_BTN	ֳַָֿ ַבבָֹ
MINI_GAME_FINDM_TITLE	ַװ ַבזֽװ
MINI_GAME_FINDM_TRY_COUNT_TEXT	דַֽזבַ
MINI_GAME_FINDM_UPGRADE_BAR1	ָהֿ
MINI_GAME_FINDM_UPGRADE_BAR2	ׁ׃זד (םַה)
MINI_GAME_FINDM_UPGRADE_RECV	ֽױב בל ַבָהֿ.
MINI_GAME_FINDM_UPGRADE_RETRY	ֵ־ַָׁ ַבֽ׃םה
MINI_GAME_FINDM_UPGRADE_TITLE	ֽ׃ה ַבדֳַֹ
MINI_GAME_FISH_HELP_TEXT	ד׃ַֹֿ
MINI_GAME_FISH_START_TEXT	ֳַָֿ
MINI_GAME_FISH_TITLE	בׂ ַבױםֿ
MINI_GAME_RUMI_DISCARD_TEXT	זײ ֲדה
MINI_GAME_RUMI_EXIT	ֵהוֱַ
MINI_GAME_RUMI_LBUTTON_DESC	ֳײ ַבזֹׁ ָהׁ ַבׁׂ ַבֳם׃ׁ בבֳֹׁ
MINI_GAME_RUMI_RBUTTON_DESC	ֳָֿ ַבזֹׁ ָהׁ ַבׁׂ ַבֳםדה בבֳֹׁ
MINI_GAME_RUMI_SCORE	הַ״
MINI_GAME_RUMI_START_TEXT	ֳַָֿ
MINI_GAME_RUMI_TITLE	Metin2 בָֹ זׁ Okey
MINI_GAME_YUTNORI_COM_TEXT	ַֽ׃זָ
MINI_GAME_YUTNORI_PLAYER_TEXT	ַבבַָםה
MINI_GAME_YUTNORI_PROBABILITY	ץׁױֹ
MINI_GAME_YUTNORI_PROB_DESC	ֵ־ׁ ׁדםֹ םז בדהֽוַ ׁױֹ ֳבל ם ַבֽֿזֻ.
MINI_GAME_YUTNORI_REMAIN_COUNT	ֹֽׁ
MINI_GAME_YUTNORI_REWARD_TEXT	דֳַֹ
MINI_GAME_YUTNORI_SCORE	ַבהםֹּ
MINI_GAME_YUTNORI_START_TEXT	ֳַָֿ
MINI_GAME_YUTNORI_THROW	ׁדם
MINI_GAME_YUTNORI_TITLE	םזהזׁם
MINI_GAME_YUTNORI_YUTSEM1	ֿז
MINI_GAME_YUTNORI_YUTSEM2	ּם
MINI_GAME_YUTNORI_YUTSEM3	ּםזב
MINI_GAME_YUTNORI_YUTSEM4	םז
MINI_GAME_YUTNORI_YUTSEM5	דז
MINI_GAME_YUTNORI_YUTSEM6	ַָ-ֿז
MISTS_ISLAND_EMPIRE_NAME	ַ׃ד ַבֵדַָׁ״זׁםֹ
MISTS_ISLAND_EMPIRE_SCORE	הםֹּ ַבֵדַָׁ״זׁםֹ
MISTS_ISLAND_END_TIME	ַׁם־ ַבהוַםֹ
MISTS_ISLAND_EXIT	ֵבֱַ
MISTS_ISLAND_INFO_TEXT	ַבָֹׁ זַבַֽבֹ
MISTS_ISLAND_RANK	ָֹׁ
MISTS_ISLAND_SCORE	ַבהםֹּ
MISTS_ISLAND_TITLE_RANK	דבזדַ ֽזב ַבָֹׁ זַבַֽבֹ
MISTS_ISLAND_TITLE_SCORE	הֹׁ ַדֹ
MOUSEBUTTON_ATTACK	וּזד
MOUSEBUTTON_AUTO_ATTACK	וּזד בֶַם
MOUSEBUTTON_CAMERA	ַדםַׁ
MOUSEBUTTON_SKILL	דוַַׁ
MUSICLIST_TITLE	־םַַׁ ַבדז׃םל
MYSHOP_DECO_CANCEL	ֳב
MYSHOP_DECO_DEFAULT	ַֿם
MYSHOP_DECO_NEXT	ַבַבם
MYSHOP_DECO_OK	ֳםֿ
MYSHOP_DECO_PREV	ַב׃ַָ
MYSHOP_DECO_SELECT_MODEL	ַ־ׁ װב דּׁ
MYSHOP_DECO_SELECT_TITLE	ַ־ׁ װב בָ.
NO	בַ
OK	דזַ
OPPOSITES	ׁײ
OPTION_ALWAYS_SHOW_NAME	ַ׃ד
OPTION_ALWAYS_SHOW_NAME_OFF	דֽֿזֿ
OPTION_ALWAYS_SHOW_NAME_ON	ֶַֿדַנ
OPTION_BLOCK	דה
OPTION_BLOCK_EXCHANGE	ַֹּׁ
OPTION_BLOCK_FRIEND	ֳױֱַֿ
OPTION_BLOCK_GUILD	ַָׁ״ֹ
OPTION_BLOCK_PARTY	דּדזֹ
OPTION_BLOCK_PARTY_REQUEST	״בָ
OPTION_BLOCK_WHISPER	וד׃
OPTION_CAMERA_DISTANCE	ַדםַׁ
OPTION_CAMERA_DISTANCE_LONG	ָםֿ
OPTION_CAMERA_DISTANCE_SHORT	ׁםָ
OPTION_DELETE_MOBILE_BUTTON	ד׃ֽ ׁד ַבוַ ַב־בזם
OPTION_EFFECT	ׁײ ַבֵױַַָ
OPTION_ENV_EFFECT	ַבָםֶֹ
OPTION_ENV_EFFECT_OFF	ֵ־ֱַ
OPTION_ENV_EFFECT_ON	ֵוַׁ
OPTION_FOG	ײַָָ
OPTION_FOG_DENSE	ֻם
OPTION_FOG_LIGHT	־ם
OPTION_FOG_MIDDLE	דֿב
OPTION_FOG_OFF	ֵםַ
OPTION_FOG_ON	װרצב
OPTION_INPUT_MOBILE_BUTTON	ֳֿ־ב ׁד וַ ַבּזַב
OPTION_KEY_SETTING	בזֹֽ ַבדַםֽ
OPTION_LANGUAGE_CHANGE	״ָר
OPTION_LANGUAGE_SELECT	ַבבֹ
OPTION_MOBILE	ַבוַ ַבּזַב
OPTION_MOB_INFO	ה ַבזֽװ
OPTION_MOB_INFO_AGGR	הם
OPTION_MOB_INFO_LEVEL	ד׃זל
OPTION_MUSIC	דז׃םל
OPTION_MUSIC_CHANGE	םםׁ
OPTION_MUSIC_DEFAULT_THEMA	דז׃םל Metin2 ַבַֿםֹ
OPTION_NAME_COLOR	בזה ַ׃ד
OPTION_NAME_COLOR_EMPIRE	ַבֵדַָׁ״זׁםֹ
OPTION_NAME_COLOR_NORMAL	ַֿם
OPTION_NIGHT_MODE	בםב
OPTION_NIGHT_MODE_OFF	ֵ־ֱַ
OPTION_NIGHT_MODE_ON	ֵוַׁ
OPTION_PVPMODE	בַָ ײֿ בַָ
OPTION_PVPMODE_FREE	ֽץׁ
OPTION_PVPMODE_FREE_TOOLTIP	םץ׃דֽ ב ָדוַּדֹ ּדם ַבבַָםה.
OPTION_PVPMODE_GUILD	ַָׁ״ֹ
OPTION_PVPMODE_GUILD_TOOLTIP	ם׃דֽ ָדוַּדֹ ּדם ַבבַָםה ַָ׃ֻהֱַ ֳײֱַ ַבַָׁ״ֹ.
OPTION_PVPMODE_PEACE	דץ׃ַבד
OPTION_PVPMODE_PEACE_TOOLTIP	בַ ם׃דֽ ב ָדוַּדֹ בַָםה דה ה׃ ֵדַָׁ״זׁם.
OPTION_PVPMODE_REVENGE	ֶַֿם
OPTION_PVPMODE_REVENGE_TOOLTIP	ם׃דֽ ב ָדוַּדֹ בַָםה ׀זם ַֿׁ זדזַוָ ֳ־ׁל ״.
OPTION_SALESTEXT	ַ׃ד ַבדּׁ
OPTION_SALESTEXT_VIEW_OFF	ֵ־ֱַ
OPTION_SALESTEXT_VIEW_ON	ֵוַׁ
OPTION_SETTING	ַֽ
OPTION_SNOW_MODE	׃ַ״ ַבֻבּ
OPTION_SNOW_MODE_OFF	ֵ־ֱַ
OPTION_SNOW_MODE_ON	ֵוַׁ
OPTION_SNOW_TEXTURE_MODE	ֻבּ
OPTION_SNOW_TEXTURE_MODE_OFF	ֵ־ֱַ
OPTION_SNOW_TEXTURE_MODE_ON	ֵוַׁ
OPTION_SOUND	ֳֻםַׁ ױזםֹ
OPTION_TARGET_BOARD	בֶַֹֽ ַבוֿ
OPTION_TARGET_BOARD_NO_VIEW	ֵבַ
OPTION_TARGET_BOARD_VIEW	ׁײ
OPTION_TITLE	־םַַׁ
OPTION_VIEW_CHAT	ַבֿֿׁװֹ
OPTION_VIEW_CHAT_OFF	ֵ־ֱַ
OPTION_VIEW_CHAT_ON	ֵוַׁ
PARTY_MATCH_TEXT_DUNGEON_NAME	ָּׁ דֽױה
PARTY_MATCH_TEXT_DUNGEON_SELECT	ַ־ׁ ַבָּׁ ַבדֽױה
PARTY_MATCH_TEXT_ENTREE_LEVEL	ַבד׃זל : %d
PARTY_MATCH_TEXT_LEVEL_LIMIT	ַבד׃זל ַבד״בזָ
PARTY_MATCH_TEXT_REQUEST_MATCH	ָֻֽ
PARTY_MATCH_TEXT_REQUEST_MATCH_CANCEL	ֵבֱַ
PARTY_MATCH_TEXT_REQUIRED_ITEMS	ַבָהֿ ַבד״בזָ
PARTY_MEMBER_INFO_NAME	ַ׃ד ײז ַבדּדזֹ
PASSWORD_DESC_1	ַֿ־ב בדֹ ַב׃ׁ¡
PASSWORD_DESC_2	בֽ ַבד־ׂה.
PASSWORD_DESC_3	וב ד םםׁ בדֹ ַב׃ׁ¿
PASSWORD_DESC_4	ֵה בד םה ַבֳדׁ ׀ב¡ בדֹ ַב׃ׁ ַב־ַױֹ ָ ום "000000".
PASSWORD_DESC_5	םרׁ בדֹ ַב׃ׁ ַב־ַױֹ ָ ם ַבד׃זֿ.
PASSWORD_TITLE	ֽ בדֹ ַב׃ׁ
PET_AGE_TEXT	דׁ ַבׁם
PET_ATTR_CHANGE_ITEM_TEXT	׃ֽׁ ַבׁם
PET_ATTR_CHANGE_TITLE	םםׁ הז ַבׁם
PET_ATTR_CONFIRMATION	םםׁ
PET_ATTR_DETERMINE_TITLE	הז ׁם ּֿםֿ
PET_ATTR_OK	ֳב
PET_CHANGE_TEXT	ׁם
PET_FEED_TITLE	ֵ״ַד
PET_FFED_BUTTON_TEXT	ֵ״ַד
PET_HATCHING_BUTTON	דװם״
PET_HATCHING_NIK	ַ׃ד ַבׁם
PET_HATCHING_WINDOW_TITLE	ױ ַבהב
PET_INFORMATION_ABILITIES	בַזֹ
PET_INFORMATION_AGE	ַב׃ה
PET_INFORMATION_COSTUME_BONUS	בַזֹ ַבׂם
PET_INFORMATION_DEFENCE	ַֿ
PET_INFORMATION_EVOL_BUTTON	״זםׁ
PET_INFORMATION_EXP	־ָֹׁ
PET_INFORMATION_EXP_BUTTON	ָהֿ EXP
PET_INFORMATION_HP	הַ״ ַבֽםַֹ
PET_INFORMATION_LEVEL	ד׃זל
PET_INFORMATION_LIFE	דֹֿ ַבױבַֽםֹ
PET_INFORMATION_LIFETIME_BUTTON	ֵ״ַד
PET_INFORMATION_LIFE_TIME	׃ַַ
PET_INFORMATION_SKILL	דוַֹׁ
PET_INFORMATION_SP	הַ״ ַבֳ׃בזָ MP
PET_INFORMATION_TITLE	ׁם
PET_NAME_CHANGE_BUTTON	םםׁ
PET_NAME_CHANGE_WINDOW_TITLE	םםׁ ַבַ׃ד
PET_REVIVE_BUTTON	ַ׃ַּׁ ַבֽםַֹ
PET_REVIVE_CANCEL_BUTTON	ֵבֱַ
PET_REVIVE_MATERIAL_TITLE	דַֹֿ
PET_REVIVE_REUSLT_TEXT	ַבהםֹּ
PET_REVIVE_TARGET	ַ׃ַֹֿ ַבׁם
PET_REVIVE_TITLE	ֵהַװ ַבׁם
PICK_MONEY_TITLE	׃םד
PRIVATESHOPSEARCH_BUY	װֱַׁ
PRIVATESHOPSEARCH_COUNT	ֿֿ
PRIVATESHOPSEARCH_ITEMNAME	ַ׃ד
PRIVATESHOPSEARCH_ITEMTYPE	ָהזֿ
PRIVATESHOPSEARCH_JOB	״ָֹ
PRIVATESHOPSEARCH_LEVEL	ד׃זל
PRIVATESHOPSEARCH_PRICE	ֻדה
PRIVATESHOPSEARCH_REFINE	ד׃זל ַבָהֿ
PRIVATESHOPSEARCH_SEARCH	ָֻֽ
PRIVATESHOPSEARCH_SEARCH_BAR	ָֻֽ
PRIVATESHOPSEARCH_SELECT	ַ־םַׁ
PRIVATESHOPSEARCH_SELLER	ֶַָ
PRIVATE_SHOP_CLOSE_BUTTON	ֵבַ ַבדּׁ
PRIVATE_SHOP_NAME	ַ׃ד ַבדּׁ
PRIVATE_SHOP_TITLE	ּוםׂ דּׁ ־ַױ
QUEST_UI_TEXT_COLLECTION	ַָֻ ַבָםבזּם
QUEST_UI_TEXT_DAILY	דודֹ םזדםֹ
QUEST_UI_TEXT_EVENT	דוַד ַבַַֽבםֹ
QUEST_UI_TEXT_LEVELUP	דודֹ ַבױםֿ
QUEST_UI_TEXT_MAIN	ַבדוַד ַבֶׁם׃םֹ
QUEST_UI_TEXT_SCROLL	דוַד ַָ ַבדודַ
QUEST_UI_TEXT_SUB	ַבדוַד ַבַּהָםֹ
QUEST_UI_TEXT_SYSTEM	דוַד ַבבָֹ
REFINE_COST	ַבם דבםַ ַבֽ׃םה: 0 םַה
REFINE_ELEMENT_CHANGE_COST_TITLE	ַבבֹ
REFINE_ELEMENT_CHANGE_DARK	בַד
REFINE_ELEMENT_CHANGE_EARTH	ֳׁײ
REFINE_ELEMENT_CHANGE_ELECT	ָׁ
REFINE_ELEMENT_CHANGE_FIRE	הַׁ
REFINE_ELEMENT_CHANGE_ICE	ּבםֿ
REFINE_ELEMENT_CHANGE_TITLE	םםׁ ַבהױׁ
REFINE_ELEMENT_CHANGE_WIND	ׁםַֽ
REFINE_ELEMENT_DOWNGRADE_TITLE	־םײ
REFINE_ELEMENT_UPGRADE_TITLE	ֽ׃םה
REFINE_INFO	ׁױ הַּֽ דבםֹ ַבֽ׃םה: 100%
REFINE_MONEY	ַבם ַבױב
REFINE_SELECT	ױב
REFINE_TTILE	ֽ׃םהַ
REPORT_VIOLENT_WHISPER	
RESTART_GIVEUP	ַבֵ׃׃בַד
RESTART_HERE	ֳַָֿ דַּֿֿנ דה והַ
RESTART_IMMEDIATE	ֵַֹֿ ַבֽםַֹ
RESTART_TOWN	ֳַָֿ דַּֿֿנ דה ַבדֿםהֹ
ROULETTE_SPECIAL_TITLE	דֲַ (%s)
ROULETTE_SPIN_TEXT1	ֳֿׁ
ROULETTE_SPIN_TEXT2	50 ׁזֽ
ROULETTE_SPIN_TEXT3	250.000 םַה
ROULETTE_TITLE	דֲַ
SAFE_CHANGE_PASSWORD	םםׁ בדֹ ַב׃ׁ
SAFE_TITLE	ד־ׂה
SELECT_ATTR_CHANGED	ּֿםֿ
SELECT_ATTR_CURRENT	ַבַֽבם
SELECT_ATTR_SELECT	ַ־םַׁ
SELECT_ATTR_TITLE	׃ֽׁ ַבװםֱ+
SELECT_ATT_GRADE	זֹ
SELECT_CREATE	ֵהװֱַ
SELECT_DELETE	ד׃ֽ
SELECT_DEX_GRADE	דהַזֹׁ
SELECT_EMPIRE_NAME	ַ׃ד ַבַדַָׁ״זׁםֹ
SELECT_EXIT	ֵהוֱַ
SELECT_HP	ֽםזםֹ
SELECT_LEVEL	ַבד׃זל
SELECT_METIN_STONE_TITLE	ַ־ׁ ַבּֽׁ ַבװרָֽם
SELECT_NAME	ַ׃ד
SELECT_NO_GUILD	בַ זּזֿ בַָׁ״ֹ
SELECT_PLAYTIME	ז ַבבָ
SELECT_SELECT	ֳַָֿ
SELECT_SP	׀ֱַ
SELECT_TITLE	ַ־ׁ הזַהַנ
SHOP_BUY	װֱַׁ
SHOP_SELL	ָם
SHOP_TITLE	דּׁ
SKILL_SUPPORT_TITLE	דוַַׁ ַֿםֹ
STEP	ֹּֿׁ ַבױֱַ
STEP_SELECT	ֹּֿׁ ַבױֱַ
STRENGTH	זםֹ
STRENGTH_SELECT	ד׃זל
STRUCTURE_VIEW_MODE	ּדםב
STRUCTURE_VIEW_TYPE_STRUCTURE	ֵ־ֱַ
SYSTEMOPTION_TITLE	־םַַׁ ַבהַד
SYSTEM_CHANGE	םםׁ ַבװ־ױםֹ
SYSTEM_EXIT	ֵהוֱַ ַבבָֹ
SYSTEM_HELP	ד׃ַֹֿ
SYSTEM_LOGOUT	׃ּםב ַב־ׁזּ
SYSTEM_MALL	ַבדּׁ
SYSTEM_MOVE_CHANNEL	םםׁ ַבהַֹ
SYSTEM_OPTION	־םַַׁ ַבהַד
TASKBAR_CHARACTER	ַבװ־ױםֹ [C/V/B/N]
TASKBAR_CHAT	הַ׀ֹ ַבֿֿׁװֹ [Enter]
TASKBAR_DISABLE	םׁ דץרב
TASKBAR_DRAGON_SOUL	םדםֱַ ּֽׁ ַבהםה
TASKBAR_EXPAND	ָםׁ ַבהַ׀ֹ
TASKBAR_INVENTORY	ֶַדֹ ַבדדבַ [I]
TASKBAR_MESSENGER	ֳױֱַֿ [Alt+M]
TASKBAR_MONEY_EXPAND	ַבֻׁזֹ
TASKBAR_NEXT_QUICKSLOT	ֽב ַבֿ־זב ַבַבם [Shift+Number, Alt]
TASKBAR_PET_INFO	דבזדַ ה ַבׁם
TASKBAR_PREV_QUICKSLOT	ֽב ַבֿ־זב ַב׃ׁם ַב׃ַָ [Shift+Number]
TASKBAR_SYSTEM	־םַַׁ [ESC]
TOTAL_RANKING	ַבבֶַֹֽ ַבבםֹ בבָׁ
WARP_MI_LABEL	ֵבל ַבײׁםֽ ַבדוַּד
WEEKLY_RANKING	בֶַֹֽ ַבׁרץָ ַבֳ׃ָזםֹ
WHISPER_BAN	ֽׁ
WHISPER_NAME	וד׃
WHISPER_REPORT	
WHISPER_SEND	ֵׁ׃ַב
YES	הד
ZONE_MAP	־ׁם״ֹ ָםֹׁ
