ACCE_ABSORB_COST	Absorberingsprijs: %d
ACCE_ALREADY_REGISTER	Dit item is al gebruikt.
ACCE_DEL_ABSORDITEM	Item absorberen, waarmee het dus vernietigd wordt?
ACCE_DEL_SERVEITEM	Gordel 2 zal worden vernietigd, mocht het combineren mislukken.
ACCE_DEL_SERVEITEM2	Gordel 2 zal worden vernietigd, mocht het combineren mislukken.
ACCE_INITEM	Sleep de items naar het venster.
ACCE_MAXGRADE	Dit is al aangepast.
ACCE_MAX_DRAINRATE	Max. Absorberingswaarde
ACCE_NOTABSORBITEM	Je kunt een wapen of pantserstuk dat al geabsorbeerd is niet gebruiken.
ACCE_NOT_SEALITEM	Je kunt geen zielsgebonden voorwerpen gebruiken.
ACCE_NOT_USINGITEM	Je kunt een voorwerp dat je draagt niet combineren.
ACCE_NOT_WINDOWOPEN	Je kunt het voorwerp niet gebruiken wanneer het combineervenster open is.
ACCE_POSSIBLE_ACCE	Je kunt alleen Schoudergordels gebruiken.
ACCE_POSSIBLE_ACCEITEM	Je kunt alleen bonussen van wapens en pantser onttrekken.
AFF_LOVE_POINT	Liefdespunten: %d%%	
ALIGNMENT_NAME	Rang punten:	
ATTACK_ERROR_UNKNOWN	Onbekend Aanvals Fout: %s	
ATTENDANCE_REWARD_QUESTION	Wil je jouw beloning komen innen?
ATTR_6TH_7TH_ADD_QUESTION1	Je kunt dit item niet gebruiken wanneer er een bonus aan toegevoegd wordt.
ATTR_6TH_7TH_ADD_QUESTION2	Weet je zeker dat je de bonus wil toevoegen?
ATTR_6TH_7TH_CHANGE_FAIL	Je kunt de bonus niet veranderen.
ATTR_6TH_7TH_DESC1	a. Je moet de materialen toevoegen die het item vereist om een 6de of 7de bonus toe te voegen.
ATTR_6TH_7TH_DESC2	b. Elke krachtscherf verhoogt de kans op succes met 2%.
ATTR_6TH_7TH_DESC3	b. Gebruik een additief om de succeskans nog verder te verhogen.
ATTR_6TH_7TH_DESC4	d. Het duurt 24 uur om een bonus toe te voegen. Gedurende deze periode zal de NPC het item bij zich houden waaraan de bonus toegevoegd moet worden. Zodra het proces voltooid is kun je het weer ophalen.
ATTR_6TH_7TH_POSSIBILITY	Je kunt een extra bonus toevoegen.
ATTR_6TH_7TH_TOTAL_SUCCESS_PERCENT	Succeskans: %.1f%%
AURA_DRAIN_PER	Absorptiewaarde %.1f%%
AURA_EVOLUTION_GOLD	[Aura] Onvoldoende Yang om te evolueren.
AURA_IMPOSSIBLE_ABSORBITEM	[Aura] Overgedragen item kan niet gebruikt worden.
AURA_IMPOSSIBLE_EQUIPITEM	[Aura] Gedragen items kunnen overgedragen worden.
AURA_IMPOSSIBLE_EVOLUTION_ITEM	[Aura] Kan niet geëvolueerd worden.
AURA_IMPOSSIBLE_EVOLUTION_ITEMCOUNT	[Aura] Huidige aantal items is niet toereikend om te evolueren.
AURA_IMPOSSIBLE_GROWTHITEM	[Aura] Kan niet verbeterd worden.
AURA_IMPOSSIBLE_REFINEITEM	[Aura] Alleen een Aura Outfit, Schild, Ketting, Oorbel en Armband kan gebruikt worden.
AURA_IMPOSSIBLE_SEALITEM	[Aura] Zielsgebonden items kunnen niet overgedragen worden.
AURA_ITEM_NEED_REGISTER	[Aura] Items moeten ingevoegd worden.
AURA_LEVEL_STEP	Lvl%d (Stap %d)
AURA_MAX_LEVEL	[Aura] Aura Outfit heeft het maximale level bereikt.
AURA_NOTICE_DEL_ABSORDITEM	[Aura] Overgedragen item is vernietigd.
AURA_OPEN_OTHER_WINDOW	Je kunt dit niet doen zolang het scherm voor verbetering, evolutie of voor het overdragen van items geopend is.
AURA_POSSIBLE_AURAITEM	[Aura] Alleen een Aura Outfit kan gebruikt worden.
AURA_POSSIBLE_REGISTER_AURAITEM	[Aura] Aura Outfit moet eerst ingevoegd worden.
AURA_TITLE_ABSORB	Waardes overdragen aan Aura Outfit
AURA_TITLE_EVOLUTION	Aura Outfit evolueren
AURA_TITLE_GROWTH	Aura Outfit verbeteren
AURA_TOOLTIP_EXP	ERV (%d%% / 100%%)
AURA_TOOLTIP_LEVEL	Lvl%d (Stap %d) (Absorberingswaarde %.1f%%)
AURA_TOOLTIP_NEED_YANG	%s Yang
AURA_TOOLTIP_NEXT	Nieuw
AURA_TOOLTIP_NOW	Huidig
AURA_TOOLTIP_RESOURCE	Gebruiksvoorwerpen
AURA_TOOLTIP_RESOURCE_ITEM	%s * %d
AUTO_TOOLTIP_LINE1	Vaardigheden: Kies vaardigheden voor de strijd en sleep ze naar de sloten. (Premium)
AUTO_TOOLTIP_LINE2	Hint: Je kunt de activeringsinterval (in seconden) onder elke vaardigheid aanpassen.
AUTO_TOOLTIP_LINE3	Drankjes: Kies drankjes voor de strijd en sleep ze naar de sloten. (Premium)
AUTO_TOOLTIP_LINE4	Hint: LP- en TP-drankjes worden geactiveerd zodra het niveau zakt onder de %-waarde die onder elk drankje staat aangegeven.
AUTO_TOOLTIP_LINE5	Hint: De duur van andere drankjes wordt weergegeven in seconden.
AUTO_TOOLTIP_TITLE	Auto-Jacht Hulp
BATTLE_POINT	Strijdpunten
BEAD	Animasphere
BEAD_TIME_REMAINING_TO_GET	Animasphere opgeladen over: %d min.
BNW_COIN	Ziener Munt
BUY_LIMIT_LEVEL	Kooplimiet: %s
CANNOT_ATTACK_DEST_IN_SAFE	De Tegenstander is te ver weg.
CANNOT_ATTACK_SELF_IN_SAFE	Ik kan niet aanvallen.	
CANNOT_EQUIP_IN_EXCHANGE	Je kunt wat je draagt niet veranderen wanneer je aan het handelen bent.
CANNOT_EQUIP_IN_SHOP	Je kunt wat je draagt niet veranderen wanneer je aan het handelen bent.
CANNOT_OPEN_PRIVATE_SHOP_IN_SAFE_AREA	Je kunt geen privé Warenhuis openen in een openbaar gebied.
CANNOT_SHOOT_DEST_IN_SAFE	De vijand is te ver weg.	
CANNOT_SHOOT_EMPTY_ARROW	Ik heb een Pijl nodig.	
CANNOT_SHOOT_SELF_IN_SAFE	Ik kan dit niet doen.	
CANNOT_SKILL_APPROACH	Ik weet zeker dat ik niet dichterbij kan komen.	
CANNOT_SKILL_ATTACK	Ik kan niet aanvallen.	
CANNOT_SKILL_BLUE	Je kunt Indigo Wolf Ziel niet gebruiken wanneer Bloedrode Wolf Ziel actief is.
CANNOT_SKILL_DEST_IN_SAFE	De vijand is te ver weg.	
CANNOT_SKILL_EQUIP_FISHING_ROD	Je kunt niet vissen als je geen vishengel draagt.
CANNOT_SKILL_HAVE_TO_RIDE	Ik heb eerst een Paard nodig voordat ik dit kan gebruiken.	
CANNOT_SKILL_NEED_EMPTY_BOTTLE	Ik heb geen Lege Fles.	
CANNOT_SKILL_NEED_POISON_BOTTLE	Ik heb geen Gif Fles.	
CANNOT_SKILL_NEED_TARGET	Wie is het doelwit?	
CANNOT_SKILL_NOT_ENOUGH_HP	Ik heb niet genoeg LP!	
CANNOT_SKILL_NOT_ENOUGH_SP	Ik heb niet genoeg TP!	
CANNOT_SKILL_NOT_HORSE_SKILL	Ik kan dit niet gebruiken tijdens het rijden.	
CANNOT_SKILL_NOT_MATCHABLE_WEAPON	Ik kan deze Vaardigheid niet met dit wapen gebruiken.	
CANNOT_SKILL_NOT_YET_LEARN	Ik heb deze Vaardigheid nog niet geleerd.	
CANNOT_SKILL_ONLY_FOR_ALLIANCE	Dit beïnvloedt alleen groepsleden.	
CANNOT_SKILL_ONLY_FOR_CORPSE	Dit beïnvloedt alleen dode mensen.	
CANNOT_SKILL_RED	Je kunt Bloedrode Wolf Ziel niet gebruiken wanneer Indigo Wolf Ziel actief is.
CANNOT_SKILL_REMOVE_FISHING_ROD	Ik kan deze Vaardigheid niet met een Hengel gebruiken.
CANNOT_SKILL_SELF_IN_SAFE	Ik kan vanaf hier niet aanvallen.	
CANNOT_SKILL_USE_SELF	Ik kan dit niet op mijzelf gebruiken.	
CANNOT_SKILL_WAIT_COOLTIME	Ik kan deze Vaardigheid nog niet gebruiken.	
CANNOT_USE	Je kan dit niet gebruiken.
CANNOT_WHISPER_DEST_REFUSE	%s blokkeert fluisteren compleet.	SA
CANNOT_WHISPER_NOT_LOGON	%s is niet online.	SA
CANNOT_WHISPER_SELF_REFUSE	Je kunt niet naar iemand fluisteren wanneer je het fluisteren geblokkeerd hebt.	SNA
CATEGORY_ARMOR_ARMOR_BODY	Pantsers
CATEGORY_ARMOR_ARMOR_HEAD	Helmen
CATEGORY_ARMOR_ARMOR_SHIELD	Schilden
CATEGORY_COSTUMES	Kostuums
CATEGORY_COSTUMES_COSTUME_BODY	Kostuums
CATEGORY_COSTUMES_COSTUME_HAIR	Haardracht
CATEGORY_COSTUMES_COSTUME_WEAPON	Wapen-skins
CATEGORY_COSTUMES_ETC	Overig
CATEGORY_COSTUMES_SASH	Schoudergordels
CATEGORY_DRAGON_STONE	Drakensteen Alchemie
CATEGORY_DRAGON_STONE_DRAGON_DIAMOND	Diamant
CATEGORY_DRAGON_STONE_DRAGON_GARNET	Granaat
CATEGORY_DRAGON_STONE_DRAGON_JADE	Jade
CATEGORY_DRAGON_STONE_DRAGON_ONYX	Onyx
CATEGORY_DRAGON_STONE_DRAGON_RUBY	Robijn
CATEGORY_DRAGON_STONE_DRAGON_SAPPHIRE	Saffier
CATEGORY_DRAGON_STONE_ETC	Overig
CATEGORY_EQUIPMENT_ARMOR	Uitrusting
CATEGORY_EQUIPMENT_JEWELRY	Sieraden
CATEGORY_EQUIPMENT_WEAPON	Wapens
CATEGORY_ETC	Overig
CATEGORY_ETC_ETC	Overig
CATEGORY_ETC_EVENT	Event Items
CATEGORY_ETC_GIFTBOX	Kisten | Dozen
CATEGORY_ETC_MATRIMORY	Huwelijk
CATEGORY_ETC_PARTI	Kunst van de Oorlog Boeken
CATEGORY_ETC_POLYMORPH	Metamorfose Bollen
CATEGORY_ETC_RECIPE	Drankjes Productie
CATEGORY_ETC_SEAL	Zielbinding
CATEGORY_FISHING_PICK	Visserij | Mijnbouw
CATEGORY_FISHING_PICK_EQUIPMENT_PICK	Pikhouwelen
CATEGORY_FISHING_PICK_ETC	Overig
CATEGORY_FISHING_PICK_FISHING_POLE	Vishengels
CATEGORY_FISHING_PICK_FOOD	Vissen
CATEGORY_FISHING_PICK_PICK_BOOK	Mijnbouw Boeken
CATEGORY_FISHING_PICK_STONE	Ertsen
CATEGORY_JEWELRY_ARMOR_EAR	Oorbellen
CATEGORY_JEWELRY_ARMOR_FOOTS	Schoenen
CATEGORY_JEWELRY_ARMOR_NECK	Kettingen
CATEGORY_JEWELRY_ARMOR_PENDANT	Talisman
CATEGORY_JEWELRY_ARMOR_WRIST	Armbanden
CATEGORY_JEWELRY_ITEM_BELT	Riemen
CATEGORY_MOUNT_PET	Rijdieren | Huisdieren
CATEGORY_MOUNT_PET_CHARGED_PET	Huisdieren
CATEGORY_MOUNT_PET_EGG	Huisdiereieren
CATEGORY_MOUNT_PET_FREE_PET	Evolueerbare Huisdieren
CATEGORY_MOUNT_PET_MOUNT	Rijdieren
CATEGORY_POTION	Drankjes
CATEGORY_POTION_ABILITY	Verbruiksartikelen
CATEGORY_POTION_ETC	Overig
CATEGORY_POTION_HAIRDYE	Haarverf
CATEGORY_SKILL	Vaardigheden
CATEGORY_SKILL_BOOK_OF_OBLIVION	Boeken der Vergetelheid
CATEGORY_SKILL_ETC	Overig
CATEGORY_SKILL_PAHAE	Bescherming | Boost
CATEGORY_SKILL_SKILL_BOOK	Vaardigheden Boeken
CATEGORY_TUNING	Verbeteringen
CATEGORY_TUNING_ETC	Overig
CATEGORY_TUNING_RESOURCE	Materialen
CATEGORY_TUNING_STONE	Geestenstenen
CATEGORY_UNIQUE	Speciale Items
CATEGORY_UNIQUE_ABILITY	Verbruiksartikelen
CATEGORY_UNIQUE_ETC	Overig
CATEGORY_WEAPON_WEAPON_ARROW	Pijlen
CATEGORY_WEAPON_WEAPON_BELL	Bellen
CATEGORY_WEAPON_WEAPON_BOW	Bogen
CATEGORY_WEAPON_WEAPON_CLAW	Klauwen
CATEGORY_WEAPON_WEAPON_DAGGER	Dolken
CATEGORY_WEAPON_WEAPON_FAN	Waaiers
CATEGORY_WEAPON_WEAPON_MOUNT_SPEAR	Speren
CATEGORY_WEAPON_WEAPON_QUIVER	Pijlkokers
CATEGORY_WEAPON_WEAPON_SWORD	Eenhandswapens
CATEGORY_WEAPON_WEAPON_TWO_HANDED	Tweehandswapens
CHANGE_ALREADY_REGISTER	[Transmutatie] Dit item is al toegevoegd.
CHANGE_LOOK_CHANGE_ITEM	Wil je dit item transmuteren?
CHANGE_LOOK_CHECK_OUT_REGISTER_ITEM	[Transmutatie] Verwijder eerst het item dat je wil transmuteren a.u.b.
CHANGE_LOOK_COST	Kosten van transmutatie: %s Yang
CHANGE_LOOK_DEL_ITEM	Het geabsorbeerde item zal verwijderd worden.
CHANGE_LOOK_DO_NOT_CHANGE_LOOK_ITEM	[Transmutatie] Dit item kan niet getransmuteerd worden.
CHANGE_LOOK_DO_NOT_EQUIP_ITEM	[Transmutatie] Je kunt geen item transmuteren dat je momenteel draagt.
CHANGE_LOOK_DO_NOT_REGISTER_ITEM	[Transmutatie] Je kunt dit item niet toevoegen.
CHANGE_LOOK_DO_NOT_SEAL_ITEM	[Transmutatie] Het item is zielsgebonden.
CHANGE_LOOK_INSERT_CHANGE_LOOK_ITEM	[Transmutatie] Voeg het item dat je wil transmuteren toe a.u.b.
CHANGE_LOOK_INSERT_ITEM	[Transmutatie] Je moet het item eerst toevoegen.
CHANGE_LOOK_NEED_MONEY	Je hebt of niet genoeg Yang of niet voldoende items.
CHANGE_LOOK_OPEN_OTHER_WINDOW	[Transmutatie] Deze actie is niet mogelijk als het Transmutatie-scherm geopend is.
CHANGE_LOOK_TITLE	Transmutatie
CHANGE_LOOK_TITLE2	Rijdiertransformatie
CHANGE_PET_PLEASE_APPEND_FIRST	Het huisdier moet eerst geselecteerd zijn.
CHANGE_TOOLTIP2_LINE1	Voeg het doelitem toe aan de linkerkant en het materiaal aan de rechterkant.
CHANGE_TOOLTIP2_LINE2	Klik op het vakje om Yang of een Transformatiepenning te gebruiken en verander het uiterlijk van je rijdier.
CHANGE_TOOLTIP2_LINE3	Door gebruik te maken van een Transformatiepenning kun je het uiterlijk van je rijdier aanpassen zonder dat het je Yang kost (dit verbruikt wel de penning).
CHANGE_TOOLTIP2_LINE4	Als je het uiterlijk aanpast van een rijdier met een gebruiksduur, dan blijft de gebruiksduur van dit rijdier ongewijzigd.
CHANGE_TOOLTIP2_LINE5	Als het doelrijdier permanent is en het materialenrijdier een gebruiksduur heeft, dan blijft het rijdier dit uiterlijk houden zolang de gebruiksduur van het materialenrijdier loopt.
CHANGE_TOOLTIP_LINE1	Plaats het item dat je wilt transmuteren links.
CHANGE_TOOLTIP_LINE2	Plaats het andere item rechts.
CHANGE_TOOLTIP_LINE3	Het uiterlijk van het item aan de linkerkant zal veranderen
CHANGE_TOOLTIP_LINE4	zodra je de transmutatie bevestigt (V) en het Yang betaald hebt.
CHANGE_TOOLTIP_LINE5	Met dit item kun je
CHANGE_TOOLTIP_LINE6	jouw item transmuteren zonder Yang te spenderen.
CHANGE_TOOLTIP_TITLE	Transmutatie
CHANNEL	Kanaal	
CHANNELING_CANNOT_LOGOUT	Je kunt niet terug gaan naar het login scherm.	
CHANNEL_EMPTY_SERVER	Geen server	
CHANNEL_NORMAL	Kanaal %d	
CHANNEL_NOTIFY_FULL	Dit kanaal is vol! Kies een andere alstublieft.
CHANNEL_NOT_FIND_INFO	Geen informatie gevonden via het kanaal.	
CHANNEL_PVP	Vrije duel	
CHANNEL_SELECT_CHANNEL	Kies een kanaal	
CHANNEL_SELECT_REGION	Kies een regio.	
CHANNEL_SELECT_SERVER	Kies een server	
CHANNEL_STATUS_BUSY	Druk
CHANNEL_STATUS_FULL	Vol
CHANNEL_STATUS_OFFLINE	Onbekend
CHANNEL_STATUS_RECOMMENDED	Aanbevolen
CHANNEL_STATUS_VACANT	Rustig
CHANNEL_TEST_SERVER	Test Server	
CHANNEL_TEST_SERVER_ADDR	Test %s:%d	
CHARACTER_CREATE_MODE	Karakter aanmaken
CHARACTER_NAME	Naam
CHARACTER_SELECT_MODE	Karakter selecteren
CHARGE_BEAD_QUESTION	Animaspheres benodigd: %d Wil je doorgaan?
CHAT_ALL	Alles	
CHAT_BLOCK	Blokkeren	
CHAT_DICE_INFO	Werpen
CHAT_GUILD	Gilde	
CHAT_INFORMATION	Info	
CHAT_INSULT_STRING	Deze zin bevat ongeldige woorden.	
CHAT_LOG	Laat oude berichten zien [L]	
CHAT_LOG_TITLE	Chat-log	
CHAT_NORMAL	Normaal	
CHAT_NOTICE	Server	
CHAT_PARTY	Groep	
CHAT_SEND_CHAT	Stuur Chat	
CHAT_SEND_MEMO	Stuur Fluister[Shift+Enter]
CHAT_SHOUT	Roep	
CHAT_SHOUT_LIMIT	Je kunt slechts elke 15 seconden roepen.	
CHAT_WHISPER	Fluisteren	
CHEQUE_SYSTEM_DO_NOT_DROP_MONEY	Je kunt geen geld laten vallen.
CHEQUE_SYSTEM_PICK_WON	Je hebt %s Won ontvangen.
CHEQUE_SYSTEM_SELL_PRICE	[Verkoopsprijs]
CHEQUE_SYSTEM_UNIT_WON	Won
CHEQUE_SYSTEM_UNIT_YANG	Yang
CHEQUE_SYSTEM_WON	%s Won
CHEQUE_SYSTEM_YANG	%s Yang
CLEAR_FLOOR	Level
CLEAR_TIME	Tijd
ClosePetChangeWndButton	Sluiten
COMB_ACCE_IS_CONTINUE_PROCESS	Wil je doorgaan?
COMB_ACCE_WARNING_MESSAGE	Het bron-item wordt vernietigd bij een volledig of gedeeltelijk succes. De overdracht kan mislukken. De absorberingswaarde van het doel-item zal verminderd worden bij een gedeeltelijk succes of bij mislukking.
COMB_ACCE_WARNING_MESSAGE1	De bron wordt vernietigd bij een volledig of gedeeltelijk succes.
COMB_ACCE_WARNING_MESSAGE2	De overdracht kan mislukken.
COMB_ACCE_WARNING_MESSAGE3	De absorberingswaarde van het doel-item zal verminderd worden bij een gedeeltelijk succes of bij mislukking.
COMB_ACCE_WILL_REMOVE_MATERIAL	De bron wordt vernietigd bij een volledig of gedeeltelijk succes.
COMB_ALREADY_APPEND	Dit item is al geselecteerd.
COMB_CANT_APPEND_ITEM	Dit item kan niet gebruikt worden.
COMB_CANT_APPEND_SEALED_ITEM	Je kunt geen zielsgebonden items gebruiken.
COMB_CANT_BASE_ITEM	Een gordel die al een bonus heeft kan niet als doel gebruikt worden.
COMB_CANT_MATCH_DRAINRATE	De absorberingswaarde van beide items moet identiek zijn voor een bonusoverdracht.
COMB_CANT_MATCH_GRADE	De kwaliteit van beide items moet identiek zijn voor een bonusoverdracht.
COMB_CANT_MATERIAL_ITEM	Het bron-item moet een bonus hebben.
COMB_COST	Prijs: %s
COMB_IS_CONTINUE_PROCESS	Wil je doorgaan?
COMB_NOTICE	Je kunt geen privé warenhuis openen wanneer je boeken aan het verhandelen bent.
COMB_NOTICE_NOT_OPEN	Je kunt geen boeken verhandelen als je een privé warenhuis open hebt staan.
COMB_NOT_ALL_SLOT_APPEND_ITEM	Je hebt een bron- en doel-item nodig plus het item voor de overdracht om bonussen over te kunnen dragen.
COMB_NOT_FULL_BOOK	Nee, zo doen we geen zaken. Zoals ik al zei: ik sta alleen open om te handelen als je 10 boeken in te ruilen hebt.
COMB_NOT_ITEM_IN_INVENTORY	Je kunt geen items gebruiken die je aan hebt.
COMB_NOT_MEDIUM_ITEM	Dit item kan niet gebruikt worden.
COMB_WILL_REMOVE_MATERIAL	Het bron-item wordt vernietigd bij succes.
CREATE_ERROR_GM_NAME	Het is niet toegestaan om ,GM‘ in je karakter naam te gebruiken.	
CREATE_ERROR_INSULT_NAME	Deze naam is ongeldig.	
CREATE_ERROR_LIMIT_LEVEL	Jouw karakter moet minstens level 80 zijn.
CREATE_ERROR_TIME_LIMIT	Je kunt slechts één karakter per 30 seconden aanmaken.
CREATE_ERROR_WRONG_STRING	Deze karakternaam is ongeldig.
CREATE_EXIST_SAME_NAME	Een ander karakter gebruikt deze naam.	
CREATE_FAILURE	Je kunt niet nog een karakter aanmaken.	
CREATE_FULL	Je kunt niet meer karakters aanmaken.
CREATE_GM_NAME	GM	
CREATE_INPUT_NAME	Voer de naam in.	
CREATE_PLUS_STAT	Er zijn nog status punten over.	
CUBE_CATEGORY_ACCESSORY	Sieraden
CUBE_CATEGORY_ARMOR	Pantser
CUBE_CATEGORY_BELT	Riemen
CUBE_CATEGORY_ETC	Etc.
CUBE_CATEGORY_EVENT	Evenement
CUBE_CATEGORY_WEAPON	Wapen
CUBE_MAKE_CONFIRM_QUESTION_1	Tenminste één van de gebruikte items is uiterst waardevol (het heeft meer dan %d bonussen).
CUBE_MAKE_CONFIRM_QUESTION_2	Wil je echt doorgaan?
CUBE_NOT_ENOUGH_GOLD	Onvoldoende Yang voor productie/smeden.
CUBE_NOT_ENOUGH_MATERIAL	Onvoldoende materiaal voor het smeden.
CUBE_PLEASE_SELECT	Er zijn geen items geselecteerd.
CZ_REWARD_QUESTION_COMPLETE	Wil je deze plaats inwisselen?
CZ_REWARD_TOOLTIP_10GAN	Zodiac Embleem
CZ_REWARD_TOOLTIP_10GAN_COUNT	Nummer in inventaris
CZ_REWARD_TOOLTIP_10GAN_NEED_COUNT	Vereist aantal
CZ_REWARD_TOOLTIP_12ZI	Wachter Embleem
CZ_REWARD_TOOLTIP_12ZI_COUNT	Nummer in inventaris
CZ_REWARD_TOOLTIP_12ZI_NEED_COUNT	Vereist aantal
CZ_REWARD_TOOLTIP_ALL_BOX	Astrale Schat
CZ_REWARD_TOOLTIP_CAN_GET_ALL_BOX	Klik hier om jouw Astrale Schat als beloning op te halen.
CZ_REWARD_TOOLTIP_CAN_GET_GREEN_BOX	Klik hier om jouw Aventurine Schat als beloning op te halen.
CZ_REWARD_TOOLTIP_CAN_GET_YELLOW_BOX	Klik hier om jouw Aureolin Schat als beloning op te halen.
CZ_REWARD_TOOLTIP_COMPLETABLE	Inwisselen
CZ_REWARD_TOOLTIP_GREEN_BOX	Aventurine Schat
CZ_REWARD_TOOLTIP_GREEN_BOX_COMP_CNT	Ingewisselde Aventurine Schatten: %d
CZ_REWARD_TOOLTIP_WEEKLY	Dag
CZ_REWARD_TOOLTIP_WEEKLY_FRI	Vrijdag
CZ_REWARD_TOOLTIP_WEEKLY_MON	Maandag
CZ_REWARD_TOOLTIP_WEEKLY_SAT	Zaterdag
CZ_REWARD_TOOLTIP_WEEKLY_SAT_SUN	Zaterdag/Zondag
CZ_REWARD_TOOLTIP_WEEKLY_THU	Donderdag
CZ_REWARD_TOOLTIP_WEEKLY_TUE	Dinsdag
CZ_REWARD_TOOLTIP_WEEKLY_WED	Woensdag
CZ_REWARD_TOOLTIP_YELLOW_BOX	Aureolin Schat
CZ_REWARD_TOOLTIP_YELLOW_BOX_COMP_CNT	Ingewisselde Aureolin Schatten: %d
DAY	d
DETAILS_1	Kr. tegen Halfmensen
DETAILS_10	Kr. tegen Woest. Mon
DETAILS_11	Kr. tegen Insecten
DETAILS_12	Aanvalswaarde
DETAILS_13	Verdedigingswaarde
DETAILS_14	Gemiddelde Schade
DETAILS_15	Gem. Schade Weerst.
DETAILS_16	Vaardigheden Schade
DETAILS_17	Vaardig. Schade Weerstand
DETAILS_18	Magische/Fys. Aanval
DETAILS_19	Magische Aanval
DETAILS_2	Weerst. tg. Halfmens
DETAILS_20	Kritieke Slag Kans
DETAILS_21	Perforerende Slag
DETAILS_22	Kritieke Slag Weerst
DETAILS_23	Perf. Slag Weerst.
DETAILS_24	Bliksem Weerstand
DETAILS_25	IJs Weerstand
DETAILS_26	Duisternis Weerstand
DETAILS_27	Vuur Weerstand
DETAILS_28	Wind Weerstand
DETAILS_29	Aarde Weerstand
DETAILS_3	Sterk tegen Orks
DETAILS_30	Kracht van Bliksem
DETAILS_31	Kracht van IJs
DETAILS_32	Kracht van Duistern.
DETAILS_33	Kracht van Vuur
DETAILS_34	Kracht van de Wind
DETAILS_35	Kracht van Aarde
DETAILS_36	Sterk tegen Krijgers
DETAILS_37	Sterk tegen Ninja's
DETAILS_38	Sterk tegen Sura's
DETAILS_39	Sterk tegen Sjamanen
DETAILS_4	Sterk tegen Ondoden
DETAILS_40	Sterk tegen Lycanen
DETAILS_41	Verd. tegen Krijgers
DETAILS_42	Verd. tegen Ninja's
DETAILS_43	Verd. tegen Sura's
DETAILS_44	Verd. tegen Sjamanen
DETAILS_45	Verd. tegen Lycanen
DETAILS_46	Zwaard Verdediging
DETAILS_47	Twee-handig Verd.
DETAILS_48	Dolk Verdediging
DETAILS_49	Klauw Verdediging
DETAILS_5	Sterk tegen Monsters
DETAILS_50	Bel Verdediging
DETAILS_51	Waaier Verdediging
DETAILS_52	Pijl Verdediging
DETAILS_53	Flauwvalkans
DETAILS_54	Langzaam maken Kans
DETAILS_55	Vergiftigingskans
DETAILS_56	Gif Weerstand
DETAILS_57	Bloedingsaanval
DETAILS_58	Bloedingsaanval Wst.
DETAILS_59	LP Stelen
DETAILS_6	Kr. tegen Zodiac Mon
DETAILS_60	TP Stelen
DETAILS_61	LP Herstel
DETAILS_62	TP Herstel
DETAILS_63	Blokkeer Aanval
DETAILS_64	Ontwijk Pijlaanval
DETAILS_65	Weerkaats Fys. Aanv.
DETAILS_66	LP Herstel bij Doden
DETAILS_67	TP Herstel bij Doden
DETAILS_68	Dubbel ERV
DETAILS_69	Dubbel Yang
DETAILS_7	Sterk tegen Dieren
DETAILS_70	Drop Kans
DETAILS_71	Aanvalswaarde
DETAILS_72	Verdedigingswaarde
DETAILS_73	ERV
DETAILS_74	Drop Kans
DETAILS_75	Dubbel Yang
DETAILS_76	Magie Weerstand
DETAILS_77	Anti-Magie
DETAILS_8	Sterk tegen Esoteri.
DETAILS_9	Sterk tegen Duivels
DETAILS_ATTBONUS_BELL	Belbreuk
DETAILS_ATTBONUS_BOW	Pijlbreuk
DETAILS_ATTBONUS_CLAW	Klauwbreuk
DETAILS_ATTBONUS_DAGGER	Dolkbreuk
DETAILS_ATTBONUS_FAN	Waaierbreuk
DETAILS_ATTBONUS_SWORD	Zwaardbreuk
DETAILS_ATTBONUS_TWOHAND	Tweehandsbreuk
DETAILS_CATE_1	Schade/Verdediging
DETAILS_CATE_2	Elementale bonus
DETAILS_CATE_3	Klasse bonus
DETAILS_CATE_4	Wapenbonus
DETAILS_CATE_5	Overige bonus
DETAILS_CATE_6	Speciale bonus
DETAILS_RESIST_MOUNT_FALL	Valweerstand
DETAILS_TITLE	Details
DETAILS_TOOLTIP_1	Sterk tegen Halfmensen: Brengt zwaardere schade toe aan Halfmensen.
DETAILS_TOOLTIP_10	Sterk tegen Woestijn Monsters: Brengt zwaardere schade toe aan woestijnmonsters.
DETAILS_TOOLTIP_11	Sterk tegen Insecten: Brengt zwaardere schade toe aan insecten.
DETAILS_TOOLTIP_12	Verhoogt je aanvalswaarde
DETAILS_TOOLTIP_13	Verhoogt je verdedigingswaarde
DETAILS_TOOLTIP_14	Verhoogt de gemiddelde schade die je aan vijanden toebrengt bij een aanval.
DETAILS_TOOLTIP_15	Weerstand tegen gemiddelde schade: vermindert de schade die je oploopt bij een aanval.
DETAILS_TOOLTIP_16	Verhoogt de schade toegebracht door een vaardigheid.
DETAILS_TOOLTIP_17	Weerstand tegen vaardigheden schade: Vermindert de schade die je toegebracht wordt door een vaardigheid.
DETAILS_TOOLTIP_18	Verhoogt zowel je fysieke als magische aanvalswaarde.
DETAILS_TOOLTIP_19	Verhoogt de schade die je aan vijanden toebrengt bij een magische aanval.
DETAILS_TOOLTIP_2	Weerstand tegen Halfmensen: Vermindert de schade die je oploopt van Halfmensen.
DETAILS_TOOLTIP_20	Verhoogt de kans op het uitdelen van een kritieke slag.
DETAILS_TOOLTIP_21	Perforerende slag kans: Verhoogt de kans op het uitdelen van een perforerende slag.
DETAILS_TOOLTIP_22	Kritische slag weerstand: Vermindert de schade toegebracht door een kritieke slag.
DETAILS_TOOLTIP_23	Perforerende slag weerstand: Vermindert de schade toegebracht door een perforerende slag.
DETAILS_TOOLTIP_24	Vermindert de schade die je oploopt van bepaalde monsters.
DETAILS_TOOLTIP_25	Vermindert de schade die je oploopt van bepaalde monsters.
DETAILS_TOOLTIP_26	Duisternis weerstand: Vermindert de schade die je oploopt van bepaalde monsters.
DETAILS_TOOLTIP_27	Vermindert de schade die je oploopt van bepaalde monsters.
DETAILS_TOOLTIP_28	Vermindert de schade die je oploopt van bepaalde monsters.
DETAILS_TOOLTIP_29	Vermindert de schade die je oploopt van bepaalde monsters.
DETAILS_TOOLTIP_3	Sterk tegen Orks: Brengt zwaardere schade toe aan orks.
DETAILS_TOOLTIP_30	Verhoogt de schade toe je toebrengt door de kracht van bliksem.
DETAILS_TOOLTIP_31	Verhoogt de schade toe je toebrengt door de kracht van ijs.
DETAILS_TOOLTIP_32	Verhoogt de schade toe je toebrengt door de kracht van duisternis.
DETAILS_TOOLTIP_33	Verhoogt de schade toe je toebrengt door de kracht van vuur.
DETAILS_TOOLTIP_34	Verhoogt de schade toe je toebrengt door de kracht van de wind.
DETAILS_TOOLTIP_35	Verhoogt de schade toe je toebrengt door de kracht van aarde.
DETAILS_TOOLTIP_36	Sterk tegen Krijgers: Brengt zwaardere schade toe aan krijgers.
DETAILS_TOOLTIP_37	Sterk tegen Ninja's: Brengt zwaardere schade toe aan ninja's.
DETAILS_TOOLTIP_38	Sterk tegen Sura's: Brengt zwaardere schade toe aan sura's.
DETAILS_TOOLTIP_39	Sterk tegen Sjamanen: Brengt zwaardere schade toe aan sjamanen.
DETAILS_TOOLTIP_4	Sterk tegen Sterk tegen Ondoden: Brengt zwaardere schade toe aan ondoden.
DETAILS_TOOLTIP_40	Sterk tegen Lycanen: Brengt zwaardere schade toe aan lycanen.
DETAILS_TOOLTIP_41	Verdedigingskans tegen aanvallen van krijgers: Vermindert de schade die je oploopt van krijgers.
DETAILS_TOOLTIP_42	Verdedigingskans tegen aanvallen van ninja's: Vermindert de schade die je oploopt van ninja's.
DETAILS_TOOLTIP_43	Verdedigingskans tegen aanvallen van sura's: Vermindert de schade die je oploopt van sura's.
DETAILS_TOOLTIP_44	Verdedigingskans tegen aanvallen van sjamanen: Vermindert de schade die je oploopt van sjamanen.
DETAILS_TOOLTIP_45	Verdedigingskans tegen aanvallen van lycanen: Vermindert de schade die je oploopt van lycanen.
DETAILS_TOOLTIP_46	Vermindert de schade toegebracht door een zwaard.
DETAILS_TOOLTIP_47	Vermindert de schade toegebracht door een twee-handig wapen.
DETAILS_TOOLTIP_48	Vermindert de schade toegebracht door een dolk.
DETAILS_TOOLTIP_49	Vermindert de schade toegebracht door een klauw.
DETAILS_TOOLTIP_5	Sterk tegen Monsters: Brengt zwaardere schade toe aan monsters.
DETAILS_TOOLTIP_50	Vermindert de schade toegebracht door een bel.
DETAILS_TOOLTIP_51	Vermindert de schade toegebracht door een waaier.
DETAILS_TOOLTIP_52	Vermindert de schade toegebracht door pijl en boog.
DETAILS_TOOLTIP_53	Verhoogt de kans om een tegenstander te laten flauw vallen.
DETAILS_TOOLTIP_54	Verhoogt de kans om een tegenstander te vertragen.
DETAILS_TOOLTIP_55	Verhoogt de kans om een tegenstander te vergiftigen.
DETAILS_TOOLTIP_56	Vermindert de schade toegebracht door gif.
DETAILS_TOOLTIP_57	Verhoogt de kans om een bloedingsaanval uit te voeren.
DETAILS_TOOLTIP_58	Weerstand tegen bloedingsaanvallen: Vermindert de schade toegebracht door een bloedingsaanval.
DETAILS_TOOLTIP_59	Steelt LP van je vijanden als je ze raakt.
DETAILS_TOOLTIP_6	Sterk tegen Zodiac Monsters: Brengt zwaardere schade toe aan Zodiac-monsters.
DETAILS_TOOLTIP_60	Steelt TP van je vijanden als je ze raakt.
DETAILS_TOOLTIP_61	Verhoogt het herstel van je levenspunten.
DETAILS_TOOLTIP_62	Verhoogt het herstel van je spreukpunten.
DETAILS_TOOLTIP_63	Kans om een fysieke aanval te blokkeren: Verhoogt de kans op het ontwijken van een fysieke aanval.
DETAILS_TOOLTIP_64	Kans om een pijlaanval te ontwijken: Verhoogt de kans op het ontwijken van pijl- of afstandsaanval door een monster.
DETAILS_TOOLTIP_65	Kans om fysieke aanvallen te weerkaatsen: Een deel van de fysieke aanval van de vijand wordt weerkaatst naar hen.
DETAILS_TOOLTIP_66	HP herstel bij doden: Je levenspunten stijgen wanneer je een vijand doodt.
DETAILS_TOOLTIP_67	TP herstel bij doden: Je spreukpunten stijgen wanneer je een vijand doodt.
DETAILS_TOOLTIP_68	Kans om dubbele ervaring te krijgen: Verhoogt de kans op een ERV-bonus als je een tegenstander verslaat.
DETAILS_TOOLTIP_69	Kans op dubbele Yang: Verhoogt de kans op het ontvangen van twee keer zoveel Yang.
DETAILS_TOOLTIP_7	Sterk tegen dieren: Brengt zwaardere schade toe aan dieren.
DETAILS_TOOLTIP_70	Kans op het droppen van items: Verhoogt de kans op het buitmaken van twee keer zoveel items.
DETAILS_TOOLTIP_71	Verhoogt je aanvalswaarde
DETAILS_TOOLTIP_72	Verhoogt je verdedigingswaarde
DETAILS_TOOLTIP_73	Verhoogt het verzamelen van ervaring.
DETAILS_TOOLTIP_74	Item drop-kans: Verhoogt de kans op het buitmaken van items.
DETAILS_TOOLTIP_75	Yang drop-kans: Verhoogt de kans op het buitmaken van meer Yang.
DETAILS_TOOLTIP_76	Vermindert de schade die je oploopt bij een magische aanval.
DETAILS_TOOLTIP_77	Vermindert de magieweerstand van je vijand.
DETAILS_TOOLTIP_8	Sterk tegen Esoteristen: Brengt zwaardere schade toe aan esoteristen.
DETAILS_TOOLTIP_9	Sterk tegen Duivels: Brengt zwaardere schade toe aan duivels.
DETAILS_TOOLTIP_ATTBONUS_BELL	Belverdedigingsbreuk: Vermindert de belverdediging van je tegenstander.
DETAILS_TOOLTIP_ATTBONUS_BOW	Pijlverdedigingsbreuk: Vermindert de pijlverdediging van je tegenstander.
DETAILS_TOOLTIP_ATTBONUS_CLAW	Klauwverdedigingsbreuk: Vermindert de klauwverdediging van je tegenstander.
DETAILS_TOOLTIP_ATTBONUS_DAGGER	Dolkverdedigingsbreuk: Vermindert de dolkverdediging van je tegenstander.
DETAILS_TOOLTIP_ATTBONUS_FAN	Waaierverdedigingsbreuk: Vermindert de waaierverdediging van je tegenstander.
DETAILS_TOOLTIP_ATTBONUS_SWORD	Zwaardverdedigingsbreuk: Vermindert de zwaardverdediging van je tegenstander.
DETAILS_TOOLTIP_ATTBONUS_TWOHAND	Tweehandsverdedigingsbreuk: Vermindert de tweehandsverdediging van je tegenstander.
DETAILS_TOOLTIP_RESIST_MOUNT_FALL	Valweerstand: Vermindert de kans om van je rijdier af te vallen.
DONT_USE_ITEM_WHEN_SHOW_CONFIRM	Wanneer een aanvraag loopt kun je geen items verplaatsen.
DO_NOT_INSERT_UPBRINGING_PET	Het actieve huisdier kan niet geselecteerd worden.
DO_YOU_BUY_ITEM1	Wil je %s voor %s Yang kopen?
DO_YOU_BUY_ITEM2	Wil je %s (%s stuks) voor %s Yang kopen?
DO_YOU_BUY_ITEM3	Wil je %s kopen voor %s Won en %s Yang?
DO_YOU_BUY_ITEM4	Wil je %s (%s stuks) kopen voor %s Won en %s Yang?
DO_YOU_DROP_MONEY	Wil je %d Yang laten vallen?
DO_YOU_SELL_ITEM1	Wil je %s voor %s Yang verkopen?
DO_YOU_SELL_ITEM2	Wil je %s (%s stuks) voor %s Yang verkopen?
DRAGON_SOUL_CANNOT_REFINE	Deze Drakensteen kan niet worden verbeterd.
DRAGON_SOUL_CANNOT_REFINE_MORE	Deze Drakensteen heeft al het hoogste level.
DRAGON_SOUL_EQUIP_WARNING1	Het is moeilijk om een Drakensteen te verwijderen als deze vastgezet is.
DRAGON_SOUL_EQUIP_WARNING2	Wil je nog steeds doorgaan?
DRAGON_SOUL_EXPIRED	Verlopen Drakensteen
DRAGON_SOUL_INVALID_DRAGON_SOUL	Dat is de verkeerde Drakensteen.
DRAGON_SOUL_IS_NOT_DRAGON_SOUL	Dat is geen Drakensteen.
DRAGON_SOUL_NOT_DRAGON_SOUL_REFINE_STONE	Dat is niet de juiste Drakensteen.
DRAGON_SOUL_NOT_ENOUGH_MATERIAL	Je hebt niet genoeg materialen om te verbeteren.
DRAGON_SOUL_NOT_ENOUGH_MATERIAL2	Voor jouw %s\n heb je %s %dx nodig.
DRAGON_SOUL_NOT_ENOUGH_MONEY	Je hebt niet genoeg Yang om de bonus te wijzigen.
DRAGON_SOUL_NOT_MATCHED_SLOT	De Drakensteen past niet op deze plek.
DRAGON_SOUL_STEP_LEVEL1	Helderheid: Mat,
DRAGON_SOUL_STEP_LEVEL2	Helderheid: Doorzichtig,
DRAGON_SOUL_STEP_LEVEL3	Helderheid: Foutloos,
DRAGON_SOUL_STEP_LEVEL4	Helderheid: Briljant,
DRAGON_SOUL_STEP_LEVEL5	Helderheid: Perfect,
DRAGON_SOUL_STRENGTH	Level: +%d	SA
DRAGON_SOUL_UNEQUIP_WARNING1	De Drakensteen kan vernietigt worden in het proces.
DRAGON_SOUL_UNEQUIP_WARNING2	Wil je nog steeds doorgaan?
DRAGON_SOUL_UNMATCHED_SLOT	Dat is de verkeerde plek.
DRAGON_SOUL_UNQUALIFIED	Je kan nog geen Drakensteen alchemie gebruiken.
DROP_ITEM_FAILURE_EQUIP_ITEM	Je kunt items die je aan hebt niet laten vallen.
DROP_ITEM_FAILURE_PRIVATE_SHOP	Je kunt geen voorwerpen laten vallen als je privé Warenhuis open is.
DROP_MONEY_FAILURE_1000_OVER	Je kunt maximaal 999 Yang laten vallen.
DS_SYSTEM_MSG_1	Je hebt %s nodig (%dx).
DUTCH_AUCTION_CLOSE_OTHER_WINDOW	Sluit eerst a.u.b. alle andere vensters voordat je de Flash Veilingen opent.
EMOTION_ALCOHOL	Proost!
EMOTION_ANGRY	Ergerlijk
EMOTION_ATTRACTIVE	Verleiding	
EMOTION_BANTER	Spottend	
EMOTION_BUSY	Stress
EMOTION_CALL	Roepen
EMOTION_CELEBRATION	Feesten
EMOTION_CHARGING	Opladen
EMOTION_CHEERS_1	Gejuich 1	
EMOTION_CHEERS_2	Gejuich 2	
EMOTION_CHEERUP	Gejuich	
EMOTION_CHOOSE_ONE	Kies een doelwit	
EMOTION_CLAP	Klappen	
EMOTION_CLAP_KISS	Kus	
EMOTION_CONGRATULATION	Instemming	
EMOTION_DANCE_1	Dans 1	
EMOTION_DANCE_2	Dans 2	
EMOTION_DANCE_3	Dans 3	
EMOTION_DANCE_4	Dans 4	
EMOTION_DANCE_5	Dans 5	
EMOTION_DANCE_6	Gumsan Stijl
EMOTION_DANCE_7	Samba
EMOTION_DOZE	Indutten
EMOTION_EXERCISE	Opwarmen
EMOTION_FORGIVE	Vergeving	
EMOTION_FRENCH_KISS	Tongzoen	
EMOTION_HUNGRY	Hongerig
EMOTION_JOY	Vreugde	
EMOTION_LETTER	Liefdesbrief
EMOTION_NOSAY	Sprakeloos
EMOTION_PUSH_UP	Push-ups
EMOTION_SAD	Verdriet	
EMOTION_SELFIE	Selfie
EMOTION_SHY	Afwijzing	
EMOTION_SIREN	Sirene
EMOTION_SLAP	Slaan	
EMOTION_WEATHER_1	Zonneschijn
EMOTION_WEATHER_2	Regenboog
EMOTION_WEATHER_3	Maan
EMOTION_WHIRL	Verbaasd
EMPIRE_A	Shinsoo Keizerrijk	
EMPIRE_B	Chunjo Koninkrijk	
EMPIRE_C	Jinno Keizerrijk
EMPIRE_SELECT_MODE	Koninkrijk selecteren
EXCHANGE_CANNOT_GIVE	Je kunt dit Voorwerp niet verhandelen.
EXCHANGE_CANT_EDIT_MONEY	Je kunt de som nu niet veranderen.	
EXCHANGE_FAILURE_EQUIP_ITEM	Je kunt Voorwerpen die je draagt niet ruilen.
EXCHANGE_MONEY	Som	
EXCHANGE_TITLE	Handel met %s (%d)
EXINVEN_USE_ITEM_FAIL_FALL_SHORT	Je hebt nog %d Inventaris Uitbreiding(en) nodig.
EXINVEN_USE_ITEM_FAIL_FOURTH_PAGE_STAGE_MAX	Jouw inventaris heeft het maximale aantal uitbreidingen gehad.
EXINVEN_USE_ITEM_QUESTION	Wil je jouw inventaris uitbreiden door %d Inventaris Uitbreidingen te gebruiken?
FINDM_BUTTON_01	Verzamelen
FINDM_BUTTON_02	Verbeteren
FINDM_POPUP_01	Je hebt niet alle benodigde items om de minigame te starten.
FINDM_POPUP_02	Je hebt niet genoeg %s.
FINDM_POPUP_03	Je kunt dat niet meer gebruiken.
FINDM_POPUP_04	Dit is al de best mogelijke beloning.
FINDM_POPUP_05	Onvoldoende Yang voor de minigame.
FINDM_POPUP_06	Drie kaarten zullen automatisch onthuld worden als je dat niet zelf doet binnen %d seconden.
FINDM_QUESTION_01	Dit vereist %d Yang en %s.\nWil je doorgaan?
FINDM_QUESTION_02	Wil je het opnieuw proberen en %s (%d) gebruiken?
FINDM_QUESTION_03	Beloning: %s
FINDM_QUESTION_04	Opnieuw proberen? Je huidige beloning blijft veilig ook al mislukt je poging.
FINDM_QUESTION_05	Spel beëindigen en je beloning ophalen?
FINDM_TOOLTIP_01	Als je het niet probeert binnen de toegestane tijd zullen er automatisch drie kaarten onthuld worden.
FISHING_FAILURE	Je hebt het Aas verloren.	
FISHING_NOTIFY1	Het lijkt alsof %s beet heeft.
FISHING_NOTIFY2	Het lijkt alsof %s gepakt is.	
FISHING_RENEWAL_CANNOT_EMOTION	Je kunt geen emoties uiten terwijl je aan het vissen bent.
FISHING_RENEWAL_CANNOT_OPEN_1	Je kunt het niet openen tijdens het vissen.
FISHING_RENEWAL_CANNOT_OPEN_2	Je kunt deze actie niet uitvoeren zolang je aan het vissen bent.
FISHING_RENEWAL_QUESTION	Je hebt beet. Wil je het vangen?
FISHING_RENEWAL_TIMEOUT	Je hebt te lang gewacht. De vis is ontsnapt.
FISHING_SUCCESS1	Je hebt %s gevangen!	
FISHING_SUCCESS2	Je hebt %s uit het water gevist!	
FISHING_UNKNOWN	Iets heeft het aas genomen maar je kunt niet zien wat.	
FISHING_WRONG_PLACE	Ik kan hier niet vissen.	
FLOWER_EVENT_USE_ITEM_TEXT1	Wil je het actieve effect vervangen?
FLOWER_EVENT_USE_ITEM_TEXT2	De poging kan mislukken waardoor de bloem zal verwelken.
FOR_FEMALE	voor vrouwen	
FOR_MALE	voor mannen	
FRAGMENT_COMB_COST	Combinatiekosten: %s
GAME_CANNOT_MINING	Je kunt geen erts mijnen terwijl je rijdt.	
GAME_CANNOT_PICK_ITEM	Je kunt dit Voorwerp niet oppakken want je hebt het niet gewonnen.	
GAME_GUILDWAR_NOW_JOIN	Wil je deelnemen aan de Gilde Oorlog?
GAME_INIT_ERROR_CURSOR	De cursor kan niet worden gebruikt.	
GAME_INIT_ERROR_DIRECTX	DirectX 8.1 moet geïnstalleerd worden zodat het spel kan draaien.\nInstalleer DirectX 8.1 or higher.
GAME_INIT_ERROR_GRAPHICS_BAD_PERFORMANCE	Er is geen grafisch apparaat gevonden. \nControleer of je Videokaart correct geïnstalleerd is.
GAME_INIT_ERROR_GRAPHICS_NOT_EXIST	Grafisch apparaat kon niet gevonden worden. \nControleer of je een Grafische kaart hebt. \nOf, je kunt de hardware accelerator inschakelen \nStel de hardware accelerator in op max \nconfiguratiescherm -> beeldscherm -> instellingen- > geavanceerd -> probleem oplossen
GAME_INIT_ERROR_GRAPHICS_NOT_SUPPORT_32BIT	De Grafische Kaart van de computer ondersteunt de venstermodus in 32bit Modus niet. \nVerander naar 16bit Modus of gebruik Volledige Scherm Modus.
GAME_INIT_ERROR_ITEM_PROTO	Geen Voorwerp data aanwezig. \nInstalleer het spel opnieuw.	
GAME_INIT_ERROR_MAIN_WINDOW	Hoofdvenster kan niet geladen worden.	
GAME_INIT_ERROR_MOB_PROTO	Geen Monster data aanwezig. \nInstalleer het spel opnieuw.	
GAME_INIT_ERROR_NETWORK	Netwerk apparaten konden niet geladen worden. \nControleer je internet verbinding.	
GAME_PICK_MONEY	Je hebt %d Yang ontvangen.
GEM_SYSTEM_ADD_SLOT	Vereist item: %s.\nWil je er %d van gebruiken om een extra plaats te ontgrendelen?
GEM_SYSTEM_BUY_ITEM	Wil je dit item kopen?
GEM_SYSTEM_NAME	Gaya
GEM_SYSTEM_NOT_ENOUGHT_REFRESHITEM	[Gaya] Je hebt niet genoeg Ververs Gaya Markt-items.
GEM_SYSTEM_NOT_ENOUGH_HP_GEM	[Gaya] Je hebt niet genoeg Gaya.
GEM_SYSTEM_NO_MORE_ADDSLOT	[Gaya] Er kunnen geen plaatsen meer ontgrendeld worden.
GEM_SYSTEM_OPEN_GEMSHOP	[Gaya] Open eerst de Gaya Markt.
GEM_SYSTEM_PICK_GEM	[Gaya] Hoeveelheid Gaya: %d
GEM_SYSTEM_REFRESH_SHOP_ITEMS	Wil je de shop verversen?
GIVEUP_QUESTION	Wil je echt opgeven?
GUILDBANK_CLEARBANK	Waarschuwing: Het Gilde Warenhuis moet geleegd worden!
GUILDBANK_DONT_MONEY_OUT	Je hebt geen Yang op de gildebank staan!
GUILDBANK_GOLD_IN	Storting
GUILDBANK_GOLD_OUT	Opname
GUILDBANK_ITEM_IN	Opslaan
GUILDBANK_ITEM_OUT	Verwijderen
GUILDBANK_MONEYIN	Yang storten
GUILDBANK_MONEYOUT	Yang opnemen
GUILDBANK_NOTUSE	Je hebt niet de benodigde machtigingen.
GUILDBANK_NOT_ENOUGH_MONEY	Je hebt niet genoeg Yang om te storten.
GUILDBANK_OVER_INCOME	Accountlimiet bereikt.
GUILDBANK_OVER_MONEY	Het gildeaccount is vol.
GUILDLAND_ABANDON	Gilde Gebied opgeven
GUILDLAND_ABANDON_VOTE	Gilde [%s]'s gebied opgeven.
GUILDLAND_ABANDON_VOTE_RESULT1	Gilde [%s]'s gebied is opgegeven.
GUILDLAND_ABANDON_VOTE_RESULT2	Het gildegebied is opgegeven.
GUILDLAND_ABANDON_VOTE_RESULT3	Stemresultaat:
GUILDLAND_ABANDON_VOTE_RESULT4	Stem is ongeldig.
GUILDLAND_ABANDON_VOTE_TEXT	Wil je echt starten met deze stemming?
GUILDLAND_ABANDON_VOTE_TEXT1	Stem je ermee in om het gildegebied te verlaten?
GUILDLAND_ACCEPT	Ja
GUILDLAND_DEAL	Gilde Gebied verkopen
GUILDLAND_DEAL_TEXT1	Gilde [%s] wil hun
GUILDLAND_DEAL_TEXT2	gebied verkopen voor [%s] Yang.
GUILDLAND_DEAL_TEXT3	Accepteer je dit aanbod?
GUILDLAND_DELA_VOTE	Het gilde [%s] wil ons gildegebied kopen.
GUILDLAND_DELA_VOTE_RESULT1	Gildegebiedsverkoop aan gilde [%s]
GUILDLAND_DELA_VOTE_RESULT2	Het stemmen is voltooid.
GUILDLAND_DELA_VOTE_RESULT3	Stemresultaat voor verkoop van gildegebied:
GUILDLAND_DELA_VOTE_RESULT4	Stem is ongeldig.
GUILDLAND_DELA_VOTE_TEXT	Aan welk gilde wil je jouw gebied verkopen?
GUILDLAND_DELA_VOTE_TEXT1	Stem je ermee in om het gildegebied te verkopen?
GUILDLAND_DONTHAVE_LAND	Je bent niet in het bezit van een gildegebied.
GUILDLAND_NOT	Nee
GUILDLAND_VOTE_TEXT	Wil je het gebied aan [%s] geven?
GUILDLIST_APPLICANT	Wil je jezelf aanmelden?
GUILDMARK_UPLOADER_ERROR_128_HEIGHT	Hoogte is niet 128 Pixel	
GUILDMARK_UPLOADER_ERROR_12_HEIGHT	Hoogte is niet 12 Pixel
GUILDMARK_UPLOADER_ERROR_16_WIDTH	Breedte is niet 16 Pixel	
GUILDMARK_UPLOADER_ERROR_64_WIDTH	Breedte is niet 64 Pixel	
GUILDMARK_UPLOADER_ERROR_FILE_FORMAT	Het spel ondersteunt deze afbeelding niet.	
GUILDMARK_UPLOADER_ERROR_PATH	Plaats de data in de folder metin2/upload	
GUILDMARK_UPLOADER_ERROR_SELECT	Geen afbeelding bestand geselecteerd.	
GUILDVOTE_CHANGEMASTER	Gilde Leider veranderen
GUILDVOTE_CHANGEMASTER_RESULT1	Het gilde is succesvol overgedragen.
GUILDVOTE_CHANGEMASTER_RESULT2	Het gilde [%s] is aan jou overgedragen.
GUILDVOTE_CHANGEMASTER_RESULT3	Gilde overdragen aan lid [%s]
GUILDVOTE_CHANGEMASTER_RESULT4	Stem is ongeldig.
GUILDVOTE_CHANGEMASTER_RESULT5	Nieuwe Gilde Leider: %s
GUILDVOTE_CHANGEMASTER_TEXT1	Wil je het gilde overdragen aan [%s]?
GUILDVOTE_CHANGEMASTER_TEXT2	
GUILDVOTE_CHANGEMASTER_TEXT3	Wil je het leiderschap van het gilde echt opgeven?
GUILDVOTE_CHANGEMASTER_TEXT4	
GUILDVOTE_CHANGEMASTER_VOTETEXT1	Gilde overdragen aan lid [%s]
GUILDVOTE_CHANGEMASTER_VOTETEXT2	Stem je in met de overdracht van gildeleider?
GUILDVOTE_MEMBEROUT	Lid verwijderen
GUILDVOTE_MEMBEROUT_AUTH	Je hebt niet de benodigde machtigingen.
GUILDVOTE_MEMBEROUT_NOMAL	Wil je dit lid echt verwijderen?
GUILDVOTE_MEMBEROUT_RESULT1	Verwijder lid: [%s]
GUILDVOTE_MEMBEROUT_RESULT2	Stemresultaat
GUILDVOTE_MEMBEROUT_RESULT3	Je bent verwijderd uit het gilde [%s].
GUILDVOTE_MEMBEROUT_RESULT4	Stemresultaat
GUILDVOTE_MEMBEROUT_RESULT5	Stem is ongeldig.
GUILDVOTE_MEMBEROUT_TEXT1	Wil je de stemming tegen [%s] starten?
GUILDVOTE_MEMBEROUT_TEXT2	Stem: Verwijder lid uit het gilde?
GUILDVOTE_MEMBEROUT_VOTETEXT1	Stem: Moet [%s] verwijderd worden uit het gilde?
GUILDVOTE_MEMBEROUT_VOTETEXT2	
GUILDVOTE_NO	Tegen
GUILDVOTE_OK	Voor
GUILDVOTE_RESULT_AGGRE_MEMBER	Voor: %d
GUILDVOTE_RESULT_ALL_MEMBER	Deelnemers: %d
GUILDVOTE_RESULT_OPPESE_MEMBER	Tegen: %d
GUILDVOTE_RESULT_TIME	%d dagen %d uren %d minuten %d seconden
GUILDVOTE_SELECT_ONE	Kies a.u.b. een karakter.
GUILDWAR_ALL	Gevechten (G)
GUILDWAR_CTF_TITLE	Verover de Vlag
GUILDWAR_DRAW	Quitte (Q)
GUILDWAR_GAINSCORE_FIFTY	50 punten
GUILDWAR_GAINSCORE_HUNDRED	100 punten
GUILDWAR_GAINSCORE_THIRTY	30 punten
GUILDWAR_GAMETIME_SIXTY	60 minuten
GUILDWAR_GAMETIME_TEN	10 minuten
GUILDWAR_GAMETIME_THIRTY	30 minuten
GUILDWAR_INPUT_OTHERGUILD	Voer a.u.b. het tegengestelde gilde in.
GUILDWAR_LADDER	Rang Punten
GUILDWAR_LIMIT_MEMBER_FIVE	Minimaal 5 deelnemers.
GUILDWAR_LOSE	Verliezen (V)
GUILDWAR_NORMAL_TITLE	Veld Gevecht
GUILDWAR_OVER_MEMBERCOUNT	Je hebt de deelnemerslimiet bereikt.
GUILDWAR_QUESTION_LINE_1	De %s Gilde heeft de oorlog verklaard aan jouw Gilde.	
GUILDWAR_QUESTION_LINE_2	Accepteren?(%s)	
GUILDWAR_RANKING	Rang
GUILDWAR_RECODE_ALL	%d G, %d O, %d V, %d Q
GUILDWAR_SELECT_MEMBER_COUNT	Kies het aantal deelnemers.
GUILDWAR_TYPE_DEFENSE	Schild Gevecht
GUILDWAR_TYPE_TIGER	Vernietiging
GUILDWAR_TYPE_TIME	Tijd Aanval
GUILDWAR_UNKNOWN_TITLE	...	
GUILDWAR_WARP_TITLE	Gilde theater van Oorlog
GUILDWAR_WIN	Overwinningen (O)
GUILDWAR_WIN_FIVE	5 ronden
GUILDWAR_WIN_ONE	1 ronde
GUILDWAR_WIN_THREE	3 ronden
GUILDWINDOW_BUTTON_BANKGOLDINFO	Gilde Warenhuis Log
GUILDWINDOW_BUTTON_BASEABANDON	Gilde Gebied opgeven
GUILDWINDOW_BUTTON_BASEDEAL	Gilde Gebied verkopen
GUILDWINDOW_BUTTON_BASEDEALVOTE	Stemmen
GUILDWINDOW_BUTTON_BOARD	Gilde Berichten
GUILDWINDOW_BUTTON_CHANGEMASTER	Gilde Leider veranderen
GUILDWINDOW_BUTTON_DECLARE	Oorlog verklaren
GUILDWINDOW_BUTTON_DONATE	Doneren
GUILDWINDOW_BUTTON_GOLDIN	Storting
GUILDWINDOW_BUTTON_GOLDOUT	Opname
GUILDWINDOW_BUTTON_GRADE	Machtigingen beheren
GUILDWINDOW_BUTTON_GUILDLIST	Gilde Lijst
GUILDWINDOW_BUTTON_HEALGSP	Herstel Draken God Kracht
GUILDWINDOW_BUTTON_INFO	Gilde Informatie
GUILDWINDOW_BUTTON_LANDINFO	Gebied Informatie
GUILDWINDOW_BUTTON_MARK	Gilde Embleem uploaden
GUILDWINDOW_BUTTON_MEMBER	Lid
GUILDWINDOW_BUTTON_OFFER	ERV doneren
GUILDWINDOW_BUTTON_OUTMEMBER	Lid verwijderen
GUILDWINDOW_BUTTON_SKILL	Gilde Vaardigheden
GUILDWINDOW_BUTTON_SYMBOL	Gilde Vlag uploaden
GUILDWINDOW_BUTTON_VOTECHECK	Stemmen bekijken
GUILDWINDOW_BUY_GUILD_LAND	Land kopen
GUILDWINDOW_CHANGE_BLACKSMITH	Beroep Wijzigen
GUILDWINDOW_CHANGE_OBJECT	Reconstructie
GUILDWINDOW_CHANGE_SMELTER	Oven veranderen
GUILDWINDOW_CREATE_OBJECT	Constructie
GUILDWINDOW_DEAL_GUILD_LAND	Land verkopen
GUILDWINDOW_GRADE_BANK	Mag gildebank en warenhuis gebruiken
GUILDWINDOW_GRADE_DRIVEOUTAUTHORITY	Mag leden verwijderen uit het gilde
GUILDWINDOW_GRADE_GRADENAME	Rang Naam
GUILDWINDOW_GRADE_GRADENUMBER	Rang Nummer
GUILDWINDOW_GRADE_GUILDWAR	Mag leden selecteren als strijders
GUILDWINDOW_GRADE_INVITEAUTHORITY	Mag spelers accepteren voor gilde
GUILDWINDOW_GRADE_NOTICEAUTHORITY	Mag gildeberichten opstellen
GUILDWINDOW_GRADE_SKILLAUTHORITY	Mag gildevaardigheden gebruiken
GUILDWINDOW_INFO_LEVEL10	Verhoogd max. ledenaantal
GUILDWINDOW_INFO_LEVEL15	Kostenred.: Draken God Kr.
GUILDWINDOW_INFO_LEVEL20	Bank: Belastingvrijstelling
GUILDWINDOW_INFO_LEVEL5	+5% ERV naar gildedonaties
GUILDWINDOW_LIST_ALL	Alle Koninkrijken
GUILDWINDOW_LIST_ALREADY_REGISTER	[Gilde] Je hebt je al aangemeld.
GUILDWINDOW_LIST_APPLICANT_LIST	Aanmeldingenlijst
GUILDWINDOW_LIST_CHRACTER_JOB	Klasse
GUILDWINDOW_LIST_CHRACTER_LV	Level
GUILDWINDOW_LIST_CHRACTER_NAME	Karakter Naam
GUILDWINDOW_LIST_CHRACTER_SUB_JOB	Subklasse
GUILDWINDOW_LIST_EMPIRE_A	Shinsoo
GUILDWINDOW_LIST_EMPIRE_B	Chunjo
GUILDWINDOW_LIST_EMPIRE_C	Jinno
GUILDWINDOW_LIST_GUILDMEMBER	Lid
GUILDWINDOW_LIST_GUILD_LIST	Gilde Lijst
GUILDWINDOW_LIST_GUILD_LV	Level
GUILDWINDOW_LIST_GUILD_NAME	Gilde
GUILDWINDOW_LIST_INPUT_GUILDNAME	[Gilde] Vul a.u.b. een gildenaam in.
GUILDWINDOW_LIST_LADDER	Rang Punten
GUILDWINDOW_LIST_NOTPROMOTEGUILD	[Gilde] Dit gilde adverteert niet.
GUILDWINDOW_LIST_PROMOTE_GUILD	Aanmelding
GUILDWINDOW_LIST_PROMOTE_GUILD_LIST	Gilde Lijst
GUILDWINDOW_LIST_RANKING	Positie
GUILDWINDOW_LIST_RANKING_COUNT	Positie
GUILDWINDOW_LIST_REGISTER	Aanmeldingen
GUILDWINDOW_LIST_REGISTER_GUILD	Aanmelden bij gilde
GUILDWINDOW_LIST_SEARCH	Zoeken
GUILDWINDOW_LIST_SELECT_GUILD	[Gilde] Kies a.u.b. een gilde om je bij aan te melden.
GUILDWINDOW_PROMOTE_REFRESH	Adverteren
GUILDWINDOW_PROMOTE_REGISTER	Adverteren
GUILDWINDOW_SP_RECOVER	Draken God Kracht
GUILDWINDOW_UPGRADE_ALTEROFPOWER	Altaar verbeteren
GUILDWINDOW_UPGRADE_GUILDBANK	Bank verbeteren
GUILD_ATTENDANCE_FAIL_ALREADY	Je hebt vandaag al deelgenomen.
GUILD_ATTENDANCE_FAIL_JOIN_TIME	Je kunt nu niet deelnemen. Deelname wordt dagelijks gereset om vijf uur 's nachts.
GUILD_BANKINFO_CLOSE	Sluiten
GUILD_BANKINFO_NAME	Lid
GUILD_BANKINFO_TYPE	Item/Valuta
GUILD_BANKINFO_USETYPE	Actie
GUILD_BANK_CLOSE	Sluiten
GUILD_BANK_INFO	Gilde Warenhuis Log
GUILD_BOARD_ID	Lid
GUILD_BOARD_TEXT	Bericht
GUILD_BUILDING_FIX_CHANGE	Wil je echt de positie veranderen?
GUILD_BUILDING_FIX_CHANGE_GOLD	Kosten: 1.000.000 Yang
GUILD_BUILDING_FIX_DELETE	Wil je het object echt verwijderen?
GUILD_BUILDING_FIX_NEED_BUILDING	Geen gebouw aanwezig.
GUILD_BUILDING_GRADE	Rank	
GUILD_BUILDING_NAME	Naam van het gebouw	
GUILD_CANNOT_HEAL_GSP_ANYMORE	De Drakengeest energie is volledig hersteld
GUILD_COMMENT	Schrijf	
GUILD_CREATE_ERROR_INSULT_NAME	Gildenaam is ongeldig.	
GUILD_DEFAULT_GRADE	Gilde leden	
GUILD_DELETE	Verwijder	
GUILD_DEPOSIT	Deponeer	
GUILD_DONATE_FAIL_NOT_ENOUGH_HIGH_ITEM	Je hebt niet genoeg Grote Donatie Tickets.
GUILD_DONATE_FAIL_NOT_ENOUGH_INVENTORY	Je inventaris is vol. Je kunt niet doneren.
GUILD_DONATE_FAIL_NOT_ENOUGH_LEVEL	Jouw karakter moet minstens level 30 zijn.
GUILD_DONATE_FAIL_NOT_ENOUGH_MIDDLE_ITEM	Je hebt niet genoeg Gemiddelde Donatie Tickets.
GUILD_DONATE_FAIL_NOT_ENOUGH_YANG	Niet genoeg Yang.
GUILD_DONATE_FAIL_TIME	Tot over 24 uur!
GUILD_DONATE_QUESTION_HIGH	Wil je een Grote Donatie doen?
GUILD_DONATE_QUESTION_MIDDLE	Wil je een Gemiddelde Donatie doen?
GUILD_DONATE_QUESTION_NORMAL	Wil je een Kleine Donatie doen?
GUILD_DO_YOU_HEAL_GSP	Wil je %d Yang gebruiken om %d Drakengeest te herstellen?
GUILD_DO_YOU_JOIN	 heeft je uitgenodigd. Wil je je aansluiten bij de Gilde?
GUILD_DRAGONLAIR_MIN	min.
GUILD_DRAGONLAIR_PARTY_ALL	Algemene Ranglijst
GUILD_DRAGONLAIR_PARTY_LINE_FOUR	11de Plaats en Lager: 100 Gaya
GUILD_DRAGONLAIR_PARTY_LINE_HELP	Help
GUILD_DRAGONLAIR_PARTY_LINE_ONE	1ste Plaats: 400 Gaya
GUILD_DRAGONLAIR_PARTY_LINE_THREE	4de-10de Plaats: 200 Gaya
GUILD_DRAGONLAIR_PARTY_LINE_TWO	2de-3de Plaats: 300 Gaya
GUILD_DRAGONLAIR_PARTY_MEMBER	Leden
GUILD_DRAGONLAIR_PARTY_NOW	Wekelijkse Ranglijst
GUILD_DRAGONLAIR_PARTY_PAST	Vorige Ranglijst
GUILD_DRAGONLAIR_PARTY_TIME	Tijd
GUILD_DRAGONLAIR_PARTY_TOOLTIP_TITLE	Beloning
GUILD_DRAGONLAIR_RANKING_FAIL	MISLUKT
GUILD_DRAGONLAIR_RANKING_NONE	NIEUW
GUILD_DRAGONLAIR_RANKING_SUCCESS	SUCCES!
GUILD_DRAGONLAIR_SECOND	sec.
GUILD_EMPTY_AREA	Leeg Land	
GUILD_ENEMY_GUILD_NAME	Gilde naam van de vijand	
GUILD_FACILITY	Bijgebouw
GUILD_GEM	Edelsteen	
GUILD_HEADQUARTER	Hoofdgebouw
GUILD_HEAL_GSP	Herstel Drakengeest
GUILD_INFO_ENEMY_GUILD_EMPTY	Geen	
GUILD_MARK_NOT_ENOUGH_LEVEL	Minstens level 3 nodig.
GUILD_MARK_UPLOAD_NOTICE	Wacht een moment zodat je gildelogo's kunt toevoegen.
GUILD_MEMBER_JOB	Klasse
GUILD_MEMBER_KNIGHT	Strijder
GUILD_MEMBER_LEVEL	Level
GUILD_MEMBER_NAME	Lid
GUILD_MEMBER_RANK	Rang
GUILD_MEMBER_SPECIFIC_GRAVITY	ERV gedoneerd
GUILD_NAME	Gilde Naam	
GUILD_NOT_ENOUGH_MATERIAL	Je hebt niet genoeg grondstoffen voor dit gebouw.
GUILD_NOT_ENOUGH_MONEY	Je hebt niet genoeg Yang voor dit gebouw.
GUILD_NO_NOTICE_PERMISSION	Je hebt geen rechten om aankondigingen te doen.	
GUILD_OBJECT	Voorwerpen	
GUILD_OFFER_EXP	Te investeren Ervaring
GUILD_SHORT_EXP	Niet genoeg ervaringspunten.
GUILD_TILE_BASEINFO	Gebied Informatie
GUILD_TILE_BOARD	Gilde Berichten
GUILD_TILE_GRADE	Rechten Beheer	
GUILD_TILE_INFO	Gilde Informatie	
GUILD_TILE_MEMBER	Lid
GUILD_TILE_SKILL	Gilde Vaardigheden	
GUILD_USE_MASTER_ONLY	Alleen de gildeleider is hiertoe gemachtigd.
GUILD_VILLAGE_01	Miryang
GUILD_VILLAGE_02	Songpa
GUILD_VILLAGE_03	Daeyami
GUILD_WAR1	Gilde Oorlog Gebied
GUILD_WAR2	Gilde Oorlog Gebied
GUILD_WAR3	Gilde Oorlog Gebied
GUILD_WAR4	Gilde Oorlog Gebied
GUILD_WAR_GAINSCORE_FIFTY	50 punten
GUILD_WAR_GAINSCORE_HUNDRED	100 punten
GUILD_WAR_GAINSCORE_THIRTY	30 punten
GUILD_WAR_GAMETIME_SIXTY	60 minuten
GUILD_WAR_GAMETIME_TEN	10 minuten
GUILD_WAR_GAMETIME_THIRTY	30 minuten
GUILD_WAR_LIMIT_30MIN	Tijd: 30 Minuten	
GUILD_WAR_REWARD_POTION	Prijs: De winnaar ontvangt een Brouwsel	
GUILD_WAR_SELECT_WAR	Selecteer type
GUILD_WAR_TYPE_DEFENSE	Schild Gevecht
GUILD_WAR_TYPE_DIE	Arena Gevecht
GUILD_WAR_TYPE_FLAG	Verover de Vlag
GUILD_WAR_TYPE_NORMAL	Veld Gevecht
GUILD_WAR_TYPE_TIGER	Vernietiging
GUILD_WAR_TYPE_TIME	Tijd Aanval
GUILD_WAR_USE_BATTLE_MAP	Locatie: Gilde Oorlog Theater
GUILD_WAR_USE_NORMAL_MAP	Locatie: Normale Map
GUILD_WAR_WIN_CHECK_SCORE	Het hoogste resultaat wint de oorlog.	
GUILD_WAR_WIN_FIVE	5 ronden
GUILD_WAR_WIN_ONE	1 ronde
GUILD_WAR_WIN_TAKE_AWAY_FLAG1	Verover de vlag van de vijand
GUILD_WAR_WIN_TAKE_AWAY_FLAG2	en breng het naar je basis.
GUILD_WAR_WIN_THREE	3 ronden
GUILD_WAR_WIN_WIPE_OUT_GUILD	Versla alle vijanden om te winnen.	
GUILD_WITHDRAW	Terugtrekken	
GUILD_YOU_DO_NOT_JOIN	Je bent geen lid van een Gilde.	
HORSE_HEALTH0	Dood	
HORSE_HEALTH1	Uithongeren
HORSE_HEALTH2	Hongerig
HORSE_HEALTH3	Vol	
HORSE_LEVEL1	Normale Paard
HORSE_LEVEL2	Vecht Paard
HORSE_LEVEL3	Militaire Paard
HOUR	u
HOW_MANY_ITEM_DO_YOU_DROP1	Wil je %s laten vallen?	
HOW_MANY_ITEM_DO_YOU_DROP2	Wil je %s %d laten vallen?	
INPUT_MATRIX_CARD_NUMBER	Voer Matrix Kaartnummer in.	
INPUT_MATRIX_CARD_TITLE	Matrix Kaart	
INPUT_PRIVATE_CODE_DIALOG_DESCRIPTION	Voer de code die je hebt gecreëerd in Account Beheer hier in.	
INPUT_PRIVATE_CODE_DIALOG_TITLE	Verwijder karakter	
INVENTORY_DO_NOT_PACK_WARP_SCROLL	Geschrigten kunnen niet gecombineerd worden.	
INVENTORY_REALLY_USE_ITEM	Dit voorwerp op dit voorwerp gebruiken?
INVENTORY_REALLY_USE_ITEM2	Wil je dit item echt gebruiken?
INVENTORY_REALLY_USE_PET_BAG_ITEM	Weet je zeker dat je jouw huisdier in de Transporteer Doos wil stoppen?
INVENTORY_REALLY_USE_PET_BAG_TAKE_OUT	Wil je een Transporteer Doos openen?
INVENTORY_REALLY_USE_PET_FEEDSTUFF_ITEM	Wil je %s aan %s voeren?
IS_NOT_PET_CHANGE_ITEM	Dat is geen Betoverd Huisdier-item.
IS_NOT_PET_ITEM	Dat is geen huisdier.
JOB_ASSASSIN	Ninja	
JOB_ASSASSIN0	Geen
JOB_ASSASSIN1	Messen Ninja
JOB_ASSASSIN2	Boog Ninja
JOB_SHAMAN	Sjamaan	
JOB_SHAMAN0	Geen
JOB_SHAMAN1	Draken Sjamaan
JOB_SHAMAN2	Helende Sjamaan
JOB_SURA	Sura	
JOB_SURA0	Geen
JOB_SURA1	Wapen Sura
JOB_SURA2	Magie Sura
JOB_WARRIOR	Krijger	
JOB_WARRIOR0	Geen
JOB_WARRIOR1	Fysieke Krijger
JOB_WARRIOR2	Mentale Krijger
JOB_WOLFMAN	Lycaan
JOB_WOLFMAN0	Amateur Lycaan
JOB_WOLFMAN1	Instinct
JOB_WOLFMAN2	N.A.
KEYCHANGE_DONT_SAVE_EXIT	Sluiten zonder opslaan?
KEYCHANGE_IMPOSSIBLE_CHANGE	[CTRL], [ALT] en [SHIFT] zijn hier niet toegestaan!
KEYCHANGE_SAVE_EXIT	Opslaan en sluiten?
KEY_0	0
KEY_0_LALT	ALT + 0
KEY_0_LCONTROL	CTRL + 0
KEY_0_LSHIFT	SHIFT + 0
KEY_1	1
KEY_1_LALT	ALT + 1
KEY_1_LCONTROL	CTRL + 1
KEY_1_LSHIFT	SHIFT + 1
KEY_2	2
KEY_2_LALT	ALT + 2
KEY_2_LCONTROL	CTRL + 2
KEY_2_LSHIFT	SHIFT + 2
KEY_3	3
KEY_3_LALT	ALT + 3
KEY_3_LCONTROL	CTRL + 3
KEY_3_LSHIFT	SHIFT + 3
KEY_4	4
KEY_4_LALT	ALT + 4
KEY_4_LCONTROL	CTRL + 4
KEY_4_LSHIFT	SHIFT + 4
KEY_5	5
KEY_5_LALT	ALT + 5
KEY_5_LCONTROL	CTRL + 5
KEY_5_LSHIFT	SHIFT + 5
KEY_6	6
KEY_6_LALT	ALT + 6
KEY_6_LCONTROL	CTRL + 6
KEY_6_LSHIFT	SHIFT + 6
KEY_7	7
KEY_7_LALT	ALT + 7
KEY_7_LCONTROL	CTRL + 7
KEY_7_LSHIFT	SHIFT + 7
KEY_8	8
KEY_8_LALT	ALT + 8
KEY_8_LCONTROL	CTRL + 8
KEY_8_LSHIFT	SHIFT + 8
KEY_9	9
KEY_9_LALT	ALT + 9
KEY_9_LCONTROL	CTRL + 9
KEY_9_LSHIFT	SHIFT + 9
KEY_A	A
KEY_ADD	+
KEY_A_LALT	ALT + A
KEY_A_LCONTROL	CTRL + A
KEY_A_LSHIFT	SHIFT + A
KEY_B	B
KEY_B_LALT	ALT + B
KEY_B_LCONTROL	CTRL + B
KEY_B_LSHIFT	SHIFT + B
KEY_C	C
KEY_COMMA	,
KEY_COMMA_LALT	ALT + ,
KEY_COMMA_LCONTROL	CTRL + ,
KEY_COMMA_LSHIFT	SHIFT + ,
KEY_C_LALT	ALT + C
KEY_C_LCONTROL	CTRL + C
KEY_C_LSHIFT	SHIFT + C
KEY_D	D
KEY_DOWN	OMLAAG
KEY_D_LALT	ALT + D
KEY_D_LCONTROL	CTRL + D
KEY_D_LSHIFT	SHIFT + D
KEY_E	E
KEY_E_LALT	ALT + E
KEY_E_LCONTROL	CTRL + E
KEY_E_LSHIFT	SHIFT + E
KEY_F	F
KEY_F1	F1
KEY_F10	F10
KEY_F10_LALT	ALT + F10
KEY_F10_LCONTROL	CTRL + F10
KEY_F10_LSHIFT	SHIFT + F10
KEY_F1_LALT	ALT + F1
KEY_F1_LCONTROL	CTRL + F1
KEY_F1_LSHIFT	SHIFT + F1
KEY_F2	F2
KEY_F2_LALT	ALT + F2
KEY_F2_LCONTROL	CTRL + F2
KEY_F2_LSHIFT	SHIFT + F2
KEY_F3	F3
KEY_F3_LALT	ALT + F3
KEY_F3_LCONTROL	CTRL + F3
KEY_F3_LSHIFT	SHIFT + F3
KEY_F4	F4
KEY_F4_LALT	ALT + F4
KEY_F4_LCONTROL	CTRL + F4
KEY_F4_LSHIFT	SHIFT + F4
KEY_F5	F5
KEY_F5_LALT	ALT + F5
KEY_F5_LCONTROL	CTRL + F5
KEY_F5_LSHIFT	SHIFT + F5
KEY_F6	F6
KEY_F6_LALT	ALT + F6
KEY_F6_LCONTROL	CTRL + F6
KEY_F6_LSHIFT	SHIFT + F6
KEY_F7	F7
KEY_F7_LALT	ALT + F7
KEY_F7_LCONTROL	CTRL + F7
KEY_F7_LSHIFT	SHIFT + F7
KEY_F8	F8
KEY_F8_LALT	ALT + F8
KEY_F8_LCONTROL	CTRL + F8
KEY_F8_LSHIFT	SHIFT + F8
KEY_F9	F9
KEY_F9_LALT	ALT + F9
KEY_F9_LCONTROL	CTRL + F9
KEY_F9_LSHIFT	SHIFT + F9
KEY_F_LALT	ALT + F
KEY_F_LCONTROL	CTRL + F
KEY_F_LSHIFT	SHIFT + F
KEY_G	G
KEY_GRAVE	@
KEY_GRAVE_LALT	ALT + @
KEY_GRAVE_LCONTROL	CTRL + @
KEY_GRAVE_LSHIFT	SHIFT + @
KEY_G_LALT	ALT + G
KEY_G_LCONTROL	CTRL + G
KEY_G_LSHIFT	SHIFT + G
KEY_H	H
KEY_H_LALT	ALT + H
KEY_H_LCONTROL	CTRL + H
KEY_H_LSHIFT	SHIFT + H
KEY_I	I
KEY_I_LALT	ALT + I
KEY_I_LCONTROL	CTRL + I
KEY_I_LSHIFT	SHIFT + I
KEY_J	J
KEY_J_LALT	ALT + J
KEY_J_LCONTROL	CTRL + J
KEY_J_LSHIFT	SHIFT + J
KEY_K	K
KEY_K_LALT	ALT + K
KEY_K_LCONTROL	CTRL + K
KEY_K_LSHIFT	SHIFT + K
KEY_L	L
KEY_LALT	ALT
KEY_LCONTROL	CTRL
KEY_LEFT	LINKS
KEY_LSHIFT	SHIFT
KEY_L_LALT	ALT + L
KEY_L_LCONTROL	CTRL + L
KEY_L_LSHIFT	SHIFT + L
KEY_M	M
KEY_M_LALT	ALT + M
KEY_M_LCONTROL	CTRL + M
KEY_M_LSHIFT	SHIFT + M
KEY_N	N
KEY_NUMLOCK	NUM LOCK
KEY_NUMPAD0	NUM 0
KEY_NUMPAD1	NUM 1
KEY_NUMPAD2	NUM 2
KEY_NUMPAD3	NUM 3
KEY_NUMPAD4	NUM 4
KEY_NUMPAD5	NUM 5
KEY_NUMPAD6	NUM 6
KEY_NUMPAD7	NUM 7
KEY_NUMPAD8	NUM 8
KEY_NUMPAD9	NUM 9
KEY_N_LALT	ALT + N
KEY_N_LCONTROL	CTRL + N
KEY_N_LSHIFT	SHIFT + N
KEY_O	O
KEY_O_LALT	ALT + O
KEY_O_LCONTROL	CTRL + O
KEY_O_LSHIFT	SHIFT + O
KEY_P	P
KEY_PERIOD	.
KEY_PERIOD_LALT	ALT + .
KEY_PERIOD_LCONTROL	CTRL + .
KEY_PERIOD_LSHIFT	SHIFT + .
KEY_PGDN	PAGE DOWN
KEY_PGUP	PAGE UP
KEY_P_LALT	ALT + P
KEY_P_LCONTROL	CTRL + P
KEY_P_LSHIFT	SHIFT + P
KEY_Q	Q
KEY_Q_LALT	ALT + Q
KEY_Q_LCONTROL	CTRL + Q
KEY_Q_LSHIFT	SHIFT + Q
KEY_R	R
KEY_RIGHT	RECHTS
KEY_R_LALT	ALT + R
KEY_R_LCONTROL	CTRL + R
KEY_R_LSHIFT	SHIFT + R
KEY_S	S
KEY_SPACE	SPATIE
KEY_SUBTRACT	-
KEY_SYSRQ	PRT SCR
KEY_S_LALT	ALT + S
KEY_S_LCONTROL	CTRL + S
KEY_S_LSHIFT	SHIFT + S
KEY_T	T
KEY_TAB	TAB
KEY_T_LALT	ALT + T
KEY_T_LCONTROL	CTRL + T
KEY_T_LSHIFT	SHIFT + T
KEY_U	U
KEY_UP	OMHOOG
KEY_U_LALT	ALT + U
KEY_U_LCONTROL	CTRL + U
KEY_U_LSHIFT	SHIFT + U
KEY_V	V
KEY_V_LALT	ALT + V
KEY_V_LCONTROL	CTRL + V
KEY_V_LSHIFT	SHIFT + V
KEY_W	W
KEY_W_LALT	ALT + W
KEY_W_LCONTROL	CTRL + W
KEY_W_LSHIFT	SHIFT + W
KEY_X	X
KEY_X_LALT	ALT + X
KEY_X_LCONTROL	CTRL + X
KEY_X_LSHIFT	SHIFT + X
KEY_Y	Y
KEY_Y_LALT	ALT + Y
KEY_Y_LCONTROL	CTRL + Y
KEY_Y_LSHIFT	SHIFT + Y
KEY_Z	Z
KEY_Z_LALT	ALT + Z
KEY_Z_LCONTROL	CTRL + Z
KEY_Z_LSHIFT	SHIFT + Z
LEADER_NAME	Leidernaam
LEFT_TIME	Overgebleven Tijd	
LIMIT_LEVEL_GUILD	Gildelevel: %d
LOGIN_CONNECT_FAILURE	Fout bij de server verbinding.	
LOGIN_CONNECT_SUCCESS	Je  bent verbonden met de server
LOGIN_CONNETING	Even geduld. Je wordt met de server verbonden.
LOGIN_FAILURE_ALREAY	Je account is al verbonden.
LOGIN_FAILURE_BACKEND_ERR	Er is een fout opgetreden. Neem a.u.b. contact op met Support.
LOGIN_FAILURE_BE_SAME_KEY	Registratie probleem.	
LOGIN_FAILURE_BLOCK_ID	Dit account is geblokkeerd.
LOGIN_FAILURE_BLOCK_LOGIN	kies een van de andere servers!
LOGIN_FAILURE_COUNTRY_ERR	De landcode is niet correct.\nNeem a.u.b. contact op met Support.
LOGIN_FAILURE_INTEGRTING	Dit account wordt momenteel samengevoegd. Probeer het later opnieuw a.u.b.
LOGIN_FAILURE_IOVATION_ERR	Er is helaas een fout opgetreden. Neem a.u.b. contact op met Support.
LOGIN_FAILURE_NOBILL	Dit account heeft geen speeltijd.
LOGIN_FAILURE_NOT_AVAIL	Het account is niet beschikbaar.
LOGIN_FAILURE_NOT_EXIST_ID	Account naam of wachtwoord is incorrect
LOGIN_FAILURE_NOT_MAIL_CONFIRM	Je dient je account te verifiëren via e-mail.
LOGIN_FAILURE_REPAIR_ID	Items zijn hersteld voor dit account.
LOGIN_FAILURE_SAMELOGIN	Iemand heeft zich met jouw account verbonden.
LOGIN_FAILURE_SHUTDOWN	De server is nog niet open.	
LOGIN_FAILURE_STEAM_SESSION	Jouw sessie is verlopen. Herstart de client a.u.b.
LOGIN_FAILURE_TNT_SESSION	De client kan niet geopend worden. Herstart de launcher a.u.b. en log in.
LOGIN_FAILURE_TOO_MANY_USER	Je kan niet verbonden worden want er zijn teveel spelers online.	
LOGIN_FAILURE_UNKNOWN	Je kon niet registreren voor onbekende redenen.	
LOGIN_FAILURE_WEB_BLOCK	Je bent geblokkerd bij de website. Controleer je e-mails alstublieft.
LOGIN_FAILURE_WRONG_MATRIX_CARD_NUMBER	Je hebt een verkeerd nummer ingevoerd.	
LOGIN_FAILURE_WRONG_MATRIX_CARD_NUMBER_TRIPLE	Je hebt drie keer een verkeerd nummer ingevoerd. /n Je verbinding wordt verbroken.	
LOGIN_FAILURE_WRONG_PASSWORD	Account naam of wachtwoord is incorrect.
LOGIN_INPUT_ID	Voer ID in.	
LOGIN_INPUT_PASSWORD	Voer wachtwoord in.	
LOGIN_PROCESSING	Login proces is gestart.
LUCKY_BOX_DIALOG_RECV_TEXT	Wil je het item accepteren?
LUCKY_BOX_DIALOG_RETRY_TEXT	Wil je je geluk nog eens beproeven?
MAILBOX_FAIL_USE_TIME_LIMIT	Brievenbus wordt bijgewerkt. Probeer het later opnieuw a.u.b.
MAILBOX_POST_ALL_DELETE_FAIL_EMPTY	Geen berichten
MAILBOX_POST_ALL_DELETE_QUESTION1	Alle berichten verwijderen?
MAILBOX_POST_ALL_DELETE_QUESTION2	Berichten met bijlagen worden niet verwijderd.
MAILBOX_POST_ALL_GET_ITEMS_FAIL_EMPTY	Je hebt geen berichten met bijlagen in je brievenbus.
MAILBOX_POST_ALL_GET_ITEMS_QUESTION	Bijlage accepteren? (Min 5% belasting op Yang)
MAILBOX_POST_DELETE_FAIL_EXIST_ITEMS	Het bericht kon niet verwijderd worden. Accepteer de bijlage eerst a.u.b.
MAILBOX_POST_DELETE_QUESTION	Wil je dit bericht echt verwijderen?
MAILBOX_POST_GET_ITEMS_NOT_ENOUGHT_INVENTORY	Items konden niet geaccepteerd worden. Je inventaris is vol.
MAILBOX_POST_GET_ITEMS_QUESTION	Bijlage accepteren? (Min 5% belasting op Yang)
MAILBOX_POST_GET_ITEMS_WON_OVERFLOW	Je kunt niet meer Won accepteren.
MAILBOX_POST_GET_ITEMS_YANG_OVERFLOW	Je kunt niet meer Yang accepteren.
MAILBOX_POST_GM_ARRIVE	GM Bericht
MAILBOX_POST_NOT_CONFIRM_INFO_1	Ongelezen berichten: %d
MAILBOX_POST_NOT_CONFIRM_INFO_2	Zonder bijlage: %d / Met bijlage: %d
MAILBOX_POST_READ_BLOCK	Weet je zeker dat je %s wil blokkeren?
MAILBOX_POST_WRITE_ALREADY_ITEM	Je kunt slechts één item per bericht versturen.
MAILBOX_POST_WRITE_CAN_NOT_SPLIT_ITEM	Maak de gestapelde items in je inventaris los voordat je ze als bijlage toevoegt.
MAILBOX_POST_WRITE_CONFIRM_FAIL	Ontvanger onbekend. Het bericht kon niet verzonden worden.
MAILBOX_POST_WRITE_CONFIRM_FULL_MAILBOX	De brievenbus van de ontvanger is vol. Het bericht kon niet verzonden worden.
MAILBOX_POST_WRITE_LEVEL_LIMIT	Je kunt berichten versturen vanaf level 20.
MAILBOX_POST_WRITE_MONEY_NOT_ENOUGHT	Je hebt niet genoeg Yang om dit bericht te versturen.
MAILBOX_POST_WRITE_NAME_CHECK	Bevestig de naam van de ontvanger door op Ontvanger controleren te klikken.
MAILBOX_POST_WRITE_NAME_EMPTY	Vul de ontvanger in.
MAILBOX_POST_WRITE_QUESTION1	Wil je het bericht naar %s nu versturen?
MAILBOX_POST_WRITE_QUESTION2	Bezorgingskosten: %d Yang
MAILBOX_POST_WRITE_SEND_FAIL_EMPTY_NAME	Vul een ontvanger in.
MAILBOX_POST_WRITE_SEND_FAIL_EMPTY_TITLE	Vul een onderwerp in.
MAILBOX_POST_WRITE_SEND_MONEY_TITLE	Geld
MAILBOX_POST_WRITE_WRONG_ITEM	Je kunt geen zielsgebonden items versturen.
MAILBOX_POST_WRITE_WRONG_MESSAGE	Het bericht bevat niet toegestane woorden.
MAILBOX_POST_WRITE_WRONG_TITLE	Het onderwerp bevat niet toegestane woorden.
MALL_CANNOT_INSERT	Je kunt het Voorwerp niet plaatsen.	
MALL_PASSWORD_TITLE	Wachtwoord	
MAP_A1	Yongan Gebied
MAP_A2	Vallei van Seungryong	
MAP_A2_1	
MAP_A3	Yayang Gebied
MAP_AG	Jungrang	
MAP_B1	Joan Gebied	
MAP_B2	Imji Vallei
MAP_B3	Bokjung Gebied
MAP_BATTLE_FIELD	Strijd Zone
MAP_BAY	Baai van Nefriet
MAP_BAYBLACKSAND	Baai van Nefriet
MAP_BG	Waryong
MAP_BOSS_AWAKEN_DAWNMIST	RX: Betoverd Woud
MAP_BOSS_AWAKEN_FLAME	RX: Rode Draken Fort
MAP_BOSS_AWAKEN_SKIPIA	RX: Grot der Verbanning
MAP_BOSS_AWAKEN_SNOW	RX: Nemere's Uitkijktoren
MAP_BOSS_CRACK_DAWNMIST	TS: Betoverd Woud
MAP_BOSS_CRACK_FLAME	TS: Rode Draken Fort
MAP_BOSS_CRACK_SKIPIA	TS: De Grot der Verbanning
MAP_BOSS_CRACK_SNOW	TS: Nemere's Uitkijktoren
MAP_BOSS_LABYRINTH	Plateau der Illusies
MAP_C1	Pyungmo Gebied
MAP_C2	Bangsan Vallei
MAP_C3	Bakra Gebied
MAP_CAPE	Cape Drakenvuur
MAP_CAPEDRAGONHEAD	Cape Drakenvuur
MAP_CG	Imha
MAP_CZ_DUNGEON	Zodiac Tempel
MAP_DAWN	Gautama Klif
MAP_DAWNMISTWOOD	Gautama Klif
MAP_DAWNMIST_DUNGEON_01	Betoverde Woud
MAP_DEFENSE_WAVE	Schip Verdediging
MAP_DEFENSE_WAVE_PORT	Haven
MAP_DESERT	Yongbi Woestijn	
MAP_DEVILCATACOMB	Duivelse Catacomben
MAP_DEVILTOWER1	Demonen Toren
MAP_DUEL	Trainingsgevecht Gebied
MAP_E	Kolonie
MAP_EMPIREWAR01	Kasteelgevecht
MAP_EMPIREWAR02	Kasteelgevecht
MAP_EMPIREWAR03	Kasteelgevecht
MAP_FLAME	Doyyumhwan
MAP_GUILD_01	Jungrang
MAP_GUILD_02	Waryong
MAP_GUILD_03	Imha
MAP_GUILD_PVE	Paleis van de Drakenkoning
MAP_HOLYPLACE_DESERT	Woestijnland Koninkrijk Gevecht
MAP_HOLYPLACE_FLAME	Vuurland Koninkrijk Gevecht
MAP_HOLYPLACE_ICE	IJsland Koninkrijk Gevecht
MAP_MILGYO	Hwang Tempel
MAP_MILGYO_A	
MAP_MINIBOSS_01	Blauwe Kerker – Lvl 40-80
MAP_MINIBOSS_02	Rode Kerker – Lvl 81+
MAP_MISTS_OF_ISLAND	Eiland van Mist
MAP_MONKEY_DUNGEON	Hasun Dong
MAP_MONKEY_DUNGEON2	Jungsun Dong
MAP_MONKEY_DUNGEON3	Sangsun Dong
MAP_MONKEY_DUNGEON_11	Hasun Dong
MAP_MONKEY_DUNGEON_12	Hasun Dong
MAP_MONKEY_DUNGEON_13	Hasun Dong
MAP_MT_THUNDER	Donder Gebergte
MAP_MT_TH_DUNGEON_01	Tempel van de Ochao
MAP_NUSLUCK	Reuzen Land
MAP_NUSLUCK01	Reuzen Land
MAP_N_DESERT_01	Yongbi Woestijn
MAP_N_DESERT_02	
MAP_N_FLAME_01	Vuurland
MAP_N_FLAME_02	
MAP_N_FLAME_DRAGON	Meley's Hol
MAP_N_FLAME_DUNGEON_01	Rode Draken Fort
MAP_N_SNOWM_01	Berg Sohan
MAP_N_SNOWM_02	
MAP_N_SNOW_DUNGEON_01	Nemeres Uitkijktoren
MAP_N_THREEWAY	Vallei van Seungryong
MAP_OXEVENT	OX-wedstrijd
MAP_PATHWAY_DESERT_01	Woestijnland Koninkrijk Gevecht
MAP_PATHWAY_DESERT_02	Woestijnland Koninkrijk Gevecht
MAP_PATHWAY_DESERT_03	Woestijnland Koninkrijk Gevecht
MAP_PATHWAY_FLAME_01	Vuurland Koninkrijk Gevecht
MAP_PATHWAY_FLAME_02	Vuurland Koninkrijk Gevecht
MAP_PATHWAY_FLAME_03	Vuurland Koninkrijk Gevecht
MAP_PATHWAY_ICE_01	IJsland Koninkrijk Gevecht
MAP_PATHWAY_ICE_02	Speelland
MAP_PATHWAY_ICE_03	IJsland Koninkrijk Gevecht
MAP_SKELTOWER	Gumsan Toren
MAP_SKIPIA_DUNGEON_01	Grot der Verbanning
MAP_SKIPIA_DUNGEON_011	
MAP_SKIPIA_DUNGEON_012	
MAP_SKIPIA_DUNGEON_013	
MAP_SKIPIA_DUNGEON_02	Grot der Verbanning 2
MAP_SKIPIA_DUNGEON_021	
MAP_SKIPIA_DUNGEON_022	
MAP_SKIPIA_DUNGEON_023	
MAP_SKIPIA_DUNGEON_BOSS	Drakentempel
MAP_SKIPIA_DUNGEON_BOSS_1	Spinnenkerker 1
MAP_SKIPIA_DUNGEON_BOSS_2	Spinnenkerker 2
MAP_SKIPIA_DUNGEON_BOSS_3	Spinnenkerker 3
MAP_SNOW	Berg Sohan
MAP_SPIDER	Kuahlo Dong
MAP_SPIDERDUNGEON	Spinnenkerker 1
MAP_SPIDERDUNGEON_02	Spinnenkerker 2
MAP_SPIDERDUNGEON_02_1	Spinnenkerker 2
MAP_SPIDERDUNGEON_03	Spinnenkerker 3
MAP_SUNGZI	Koninkrijk Gevecht
MAP_SUNGZI_DESERT_01	Woestijnland Koninkrijk Gevecht
MAP_SUNGZI_DESERT_HILL_01	Woestijnland Koninkrijk Gevecht
MAP_SUNGZI_DESERT_HILL_02	Woestijnland Koninkrijk Gevecht
MAP_SUNGZI_DESERT_HILL_03	Woestijnland Koninkrijk Gevecht
MAP_SUNGZI_FLAME_HILL_01	Vuurland Koninkrijk Gevecht
MAP_SUNGZI_FLAME_HILL_02	Vuurland Koninkrijk Gevecht
MAP_SUNGZI_FLAME_HILL_03	Vuurland Koninkrijk Gevecht
MAP_SUNGZI_SNOW	IJsland Koninkrijk Gevecht
MAP_SUNGZI_SNOW_PASS01	IJsland Koninkrijk Gevecht
MAP_SUNGZI_SNOW_PASS02	IJsland Koninkrijk Gevecht
MAP_SUNGZI_SNOW_PASS03	IJsland Koninkrijk Gevecht
MAP_T1	Gilde Oorlog Gebied
MAP_T2	Gilde Oorlog Gebied
MAP_T3	Gilde Oorlog Gebied
MAP_T4	Gilde Oorlog Gebied
MAP_TEMPLE	Hwang Tempel	
MAP_THUNDER	Donder Gebergte
MAP_TREE	Lungsam	
MAP_TRENT	Spoken Woud
MAP_TRENT02	Rode Bos
MAP_TRENT02_A	Rood Bos
MAP_TRENT_A	
MAP_WEDDING_01	Trouwkaart
MAP_WL	Slangenveld
MAP_WL_01	Slangenveld
MC_ACCUMULATION_COUNT	Verzamelde Monsterkaarten: %d
MC_ALTER_TEXT	Opdrachtlevel: %d
MC_CARD_FALL_SHORT	Onvoldoende geregistreerde kaarten.
MC_CARD_SHUFFLE	Wil je de kaarten schudden?
MC_INIT_ITEM_FALL_SHORT	Je hebt %d Herstel Ticket(s) nodig.
MC_MISSION_FAIL_MSG	Geen actieve opdracht of limiet overschreden.
MC_MISSION_INIT	Wil je de opdracht herstellen naar level 1?
MC_MISSION_NO_CLEAR	Je moet de opdracht eerst voltooien.
MC_MOTION_BUTTON_OVER_MSG	Deze optie is alleen beschikbaar vanaf 2 sterren.
MC_POLY_BUTTON_OVER_MSG	Deze optie is alleen beschikbaar vanaf 3 sterren.
MC_POLY_FAIL	Je kunt op dit moment niet transformeren.
MC_POLY_QUESTION	Wil je in dit monster transformeren?
MC_PROMOTION_MAX	Kan niet verder gepromoveerd worden.
MC_PROMOTION_QUESTION	Wil je het level verhogen?
MC_QUESTION_BUTTON_DESC1	Kan slechts 6 keer hersteld worden binnen 24 uur.
MC_QUESTION_BUTTON_DESC2	Elke opeenvolgende herstelactie vereist meer Herstel Tickets.
MC_QUESTION_BUTTON_DESC3	Klik hier om de resterende afkoelperiode te bekijken.
MC_REWARD_FAIL	Er is niet genoeg ruimte in je inventaris.
MC_REWARD_MISSION	Wil jij jouw Monsterkaart nu komen innen?
MC_SHUFFLE_NO_ITEM	Je hebt geen Herschud Ticket.
MC_TIME	Afkoelperiode: %s
MC_TRADE_QUESTION	%d kaarten worden afgelegd. Wil je doorgaan?
MC_USE_ITEM_FAIL	Deze kaart kan niet toegevoegd worden.
MC_USE_ITEM_QUESTION	Wil je deze Monsterkaart toevoegen?
MC_WARP_BUTTON_OVER_MSG	Deze optie is alleen beschikbaar vanaf 4 sterren.
MC_WARP_FAIL	Je kunt niet meer teleporteren.
MC_WARP_LIMIT_LEVEL	Je huidige level is niet hoog genoeg om te teleporteren.
MC_WARP_QUESTION	Wil je naar het gebied van dit monster teleporteren?
MD_POPUP_MSG_1	Je kunt alleen binnentreden vanuit de Zodiac Tempel.
MD_POPUP_MSG_2	De Zodiac Wachters moeten weer op krachten komen.\nGeef ze wat tijd.
MD_SYSTEM_MSG_1	Je bent geen zombie. Je kunt niet vechten als je dood bent.
MEDAL_OF_HONOR	Medaille van Heldhaftigheid
MEDAL_OF_HONOR_SYSTEM_PICK	Item ontvangen: Medaille van Heldhaftigheid x %d
MESSENGER_ADD_BLOCK_FRIEND	Toevoegen
MESSENGER_ADD_FRIEND	Voeg Vriend toe	
MESSENGER_BLOCK	Geblokkeerd
MESSENGER_DO_YOU_ACCEPT_ADD_FRIEND_1	%s heeft je als vriend toegevoegd.	
MESSENGER_DO_YOU_ACCEPT_ADD_FRIEND_2	Accepteren?	
MESSENGER_DO_YOU_DELETE	Verwijderen?	
MESSENGER_DO_YOU_DELETE_PHONE_NUMBER	Wil je de Mobiele Telefoonnummer verwijderen?	
MESSENGER_DO_YOU_MOVE	Wil je doorgaan?	
MESSENGER_EMPTY_LIST	Leeg	
MESSENGER_FAMILY	Familie	
MESSENGER_FRIEND	Vrienden	
MESSENGER_GUILD	Gilde	
MESSENGER_INPUT_MOBILE_AUTHORITY_DESCRIPTION	Voer het confirmatie nummer in dat naar je mobiele telefoon is gestuurd.	
MESSENGER_INPUT_MOBILE_AUTHORITY_TITLE	Voer confirmatie nummer in	
MESSENGER_INPUT_MOBILE_PHONE_NUMBER_1	Voer mobiele telefoon nummer in voor het sms.	
MESSENGER_INPUT_MOBILE_PHONE_NUMBER_2	Wil je nu het nummer invoeren?	
MESSENGER_INPUT_MOBILE_PHONE_NUMBER_TITLE	Voer mobiele telefoon nummr in.	
MESSENGER_SEND_MOBILE_MESSAGE_TITLE	Stuur bericht.	
METIN_TEST	
MINIGAMEUI_CALENDAR	Evenementenkalender
MINIGAME_FISH_EVENT_ADD_ACCEPT	Wil je dit toevoegen?
MINIGAME_FISH_EVENT_DROP_ACCEPT	Wil je dit item echt laten vallen?
MINIGAME_FISH_EVENT_REWARD_MSG	Je hebt %s ontvangen.
MINIGAME_FISH_EVENT_USE_ACCEPT	Wil je dit gebruiken?
MINIMAP	Open Mini Map	
MINIMAP_CANNOT_SEE	Mini Map kan niet gezien worden.	
MINIMAP_CAN_NOT_SHOW_AREAMAP	Mini Map kan niet getoond worden.
MINIMAP_DEC_SCALE	Uit zoomen
MINIMAP_INC_SCALE	Inzoomen	
MINIMAP_OBSERVER_COUNT	%d toeschouwers	
MINIMAP_OPEN_INGAMEEVENT	Evenementen
MINIMAP_SHOW_AREAMAP	Open Grote Map	
MINI_GAME_BNW_DONATE_QUESTION1	Wil je doneren?
MINI_GAME_BNW_DONATE_QUESTION2	Een donatie kost 15 Ziener Munten.
MINI_GAME_BNW_FONT	Arial:15
MINI_GAME_BNW_GAME_GIVEUP_MSG1	Wil je het spel echt verlaten?
MINI_GAME_BNW_GAME_GIVEUP_MSG2	Onthoud dat je beloningen kunt verdienen als je wint.
MINI_GAME_BNW_GAME_RESULT_DRAW	Gelijkspel! Je hebt %d Ziener Munt(en) verdiend.
MINI_GAME_BNW_GAME_RESULT_LOSE	Verslagen! Je hebt %d Ziener Munt(en) verdiend.
MINI_GAME_BNW_GAME_RESULT_SCORE	Score: %d
MINI_GAME_BNW_GAME_RESULT_WIN	Overwinning! Je hebt %d Ziener Munt(en) verdiend.
MINI_GAME_BNW_NOT_ENOUGH_INVEN	Er is niet genoeg ruimte in je inventaris.
MINI_GAME_BNW_NOT_ENOUGH_ITEM	Je hebt een Tarotset nodig om te kunnen spelen.
MINI_GAME_BNW_NOT_ENOUGH_YANG	Je hebt niet genoeg Yang om het spel te starten.
MINI_GAME_BNW_RESULT_DRAW1	Jouw nummer is hetzelfde.
MINI_GAME_BNW_RESULT_DRAW2	Gelijkspel!
MINI_GAME_BNW_RESULT_LOSE1	Jouw nummer is lager.
MINI_GAME_BNW_RESULT_LOSE2	Verslagen!
MINI_GAME_BNW_RESULT_WIN1	Jouw nummer is hoger.
MINI_GAME_BNW_RESULT_WIN2	Overwinning!
MINI_GAME_BNW_START_QUESTION	Je hebt een Tarotset en 30.000 Yang nodig om te kunnen spelen. Wil jij meedoen met het Duel van de Zieners?
MINI_GAME_CATCHKING_CHALLENGE_TOOLTIP1	Als je meerdere %s inzet wordt je beloond met hetzelfde aantal kisten.
MINI_GAME_CATCHKING_CHALLENGE_TOOLTIP2	Maximale inzet: %d Koningsstokken.
MINI_GAME_CATCHKING_HELP_MSG1	Wat jammer! De waarde van jouw kaart is lager.\nJe verdient geen punten. Kies een nieuwe kaart uit jouw stok.
MINI_GAME_CATCHKING_HELP_MSG2	Goed gedaan! De kaarten hebben dezelfde waarde.\nJe beurt is voorbij. Kies een nieuwe kaart uit jouw stok.
MINI_GAME_CATCHKING_HELP_MSG3	Ga zo door! De waarde van jouw kaart is hoger.\nDraai nog een kaart om.
MINI_GAME_CATCHKING_HELP_MSG4	Er lag een [5] in de buurt van de kaart die je onthuld hebt.\nHelaas ontvang je geen punten. Selecteer nu jouw Koning [K].
MINI_GAME_CATCHKING_POPUP_CATCH_FAIL	De koning is ontsnapt! Het spel is afgelopen. \nAls je minimaal 10 punten verdient hebt kun je nu je prijs ophalen.
MINI_GAME_CATCHKING_POPUP_REWARD_FAIL	Je kunt geen prijs ophalen.
MINI_GAME_CATCHKING_SEARCH_NUMBER5	Er ligt een [5] in de buurt.
MINI_GAME_CATCHKING_START_QUESTION	Je moet het volgende betalen voor een potje: %d Yang en %s: %d stuks\nWil je nu spelen?
MINI_GAME_CATCHKING_TOOLTIP_CARD1	Kan de volgende kaart gevangen nemen: [1]
MINI_GAME_CATCHKING_TOOLTIP_CARD2	Kan de volgende kaarten gevangen nemen: [1], [2]
MINI_GAME_CATCHKING_TOOLTIP_CARD3	Kan de volgende kaarten gevangen nemen: [1], [2], [3]
MINI_GAME_CATCHKING_TOOLTIP_CARD4	Kan de volgende kaarten gevangen nemen: [1], [2], [3], [4]
MINI_GAME_CATCHKING_TOOLTIP_CARD5	Kan de volgende kaarten gevangen nemen: [1], [2], [3], [4], [5]\nAls er nog een [5] in de buurt ligt van de kaart die je onthult,\ndan eindigt je beurt en ontvang je geen punten.
MINI_GAME_CATCHKING_TOOLTIP_CARD6	Kan de volgende kaart gevangen nemen: [K]
MINI_GAME_CATCHKING_TOOLTIP_SCORE1	%s: 550 of meer
MINI_GAME_CATCHKING_TOOLTIP_SCORE2	%s: 400 tot 549
MINI_GAME_CATCHKING_TOOLTIP_SCORE3	%s: 10 tot 399
MINI_GAME_CATCHKING_TOOLTIP_SCORE4	Je ontvangt 10 bonuspunten als je alle kaarten op een rij onthult.
MINI_GAME_GIVEUP_QUESTION	Wil je het spel echt verlaten? Je zult geen beloning ontvangen.
MINI_GAME_NOTICE_1	Klik op 'Werpen' om de startspeler te bepalen.
MINI_GAME_NOTICE_10	Ha! Je hebt de computer uitgeschakeld!
MINI_GAME_NOTICE_11	Pech! De computer heeft jou uitgeschakeld.
MINI_GAME_NOTICE_12	Je had Yut of Mo en kan opnieuw werpen.
MINI_GAME_NOTICE_13	Het spel is afgelopen. Haal je beloning op.
MINI_GAME_NOTICE_2	Yut Staven werpen.
MINI_GAME_NOTICE_3	De computer werpt Yut Staven om te startspeler te bepalen.
MINI_GAME_NOTICE_4	Je hebt gelijkgespeeld of de computer had de laagste werpscore. De computer zal beginnen.
MINI_GAME_NOTICE_5	Jij had de laagste werpscore en mag beginnen.
MINI_GAME_NOTICE_6	Jouw worp: %s. Beweeg %d veld(en) vooruit.
MINI_GAME_NOTICE_7	Jouw worp: %s. Je moet 1 veld achteruit bewegen.
MINI_GAME_NOTICE_8	Worp: %s
MINI_GAME_NOTICE_9	De computer is aan de beurt.
MINI_GAME_RUMI_DISCARD_QUESTION	Weet je zeker dat je deze kaart wil afleggen?
MINI_GAME_RUMI_EXIT_QUESTION	Wil je het spel beëindigen en je beloning uitbetaald krijgen?\nJe score en resterende kaarten worden gereset!
MINI_GAME_RUMI_START_QUESTION	Je moet een bedrag van %d Yang betalen om te mogen spelen. Je hebt ook %d Kaartenset(s) nodig.\nWil je het spel starten?
MINI_GAME_YUTNORI_COM_WIN	Soms win je, soms verlies je.
MINI_GAME_YUTNORI_PC_WIN	De buit is aan de overwinnaar!
MINI_GAME_YUTNORI_PC_WIN_SCORE	Score: %d
MINI_GAME_YUTNORI_RETHROW_BUTTON	Werpen
MINI_GAME_YUTNORI_RETHROW_POPUP	Geluksvogel! Het is weer jouw beurt.
MINI_GAME_YUTNORI_SCORE_FONT	Tahoma:24b
MINI_GAME_YUTNORI_START_QUESTION	Je hebt %d Yang en %d Yut Nori Bord nodig om een spelletje Yut Nori te spelen. \n Nu spelen?
MINUTE	min
MISTS_ISLAND_BUFF_MSG_01	Energie +2
MISTS_ISLAND_BUFF_MSG_02	Item Drop-percentage +10%
MISTS_ISLAND_BUFF_MSG_03	Kracht, Intelligentie, Vitaliteit, Behendigheid +3
MISTS_ISLAND_BUFF_MSG_04	Yang Drop-percentage +10%
MISTS_ISLAND_BUFF_MSG_05	Kostuumbonussen +3%
MISTS_ISLAND_INFO_01	Jouw level is te laag.
MISTS_ISLAND_INFO_02	Niet genoeg Yang.
MISTS_ISLAND_INFO_03	Er vind momenteel geen gevecht plaats.
MISTS_ISLAND_MSG_01	%s is vernietigd door %s!
MISTS_ISLAND_MSG_02	%s heeft %s gevangen!
MISTS_ISLAND_MSG_03	%s heeft %s bezet!
MISTS_ISLAND_MSG_04	%s valt %s aan!
MISTS_ISLAND_MSG_05	%s heeft de %s met succes verbeterd naar level %d!
MISTS_ISLAND_MSG_06	%s is verschenen op het strijdtoneel!
MISTS_ISLAND_QUESTION_01	Wil je de Slag om de Vijf Altaren verlaten?
MISTS_ISLAND_QUESTION_02	Wil je teleporteren naar het recentelijk aangevallen altaar? \n Kosten: %s Yang
MISTS_ISLAND_TOOLTIP_01	[%s]
MISTS_ISLAND_TOOLTIP_02	Bezettend Koninkrijk: %s
MISTS_ISLAND_TOOLTIP_03	Verbeteringslevel: +%d
MISTS_ISLAND_TOOLTIP_04	Bezettings-buff: %s
MISTS_ISLAND_TOOLTIP_05	Veroveren van de Altaren
MISTS_ISLAND_TOOLTIP_06	1. Om een altaar in te nemen moet het eerst vernietigd worden.
MISTS_ISLAND_TOOLTIP_07	2. Het koninkrijk waarvan de meeste strijdkrachten in de buurt zijn na één minuut zal het altaar bezetten.
MISTS_ISLAND_TOOLTIP_08	3. Na drie minuten zal het altaar opnieuw verschijnen in de kleur van het koninkrijk waar het door bezet is.
MISTS_ISLAND_TOOLTIP_09	4. Hoe langer een altaar onder bevel staat van hetzelfde koninkrijk, des te moeilijker het zal zijn om het te vernietigen.
MONETARY_UNIT0	Yang
MONETARY_UNIT1	Tien Duizend	
MONETARY_UNIT2	Honderd Miljard	
MONEY_INPUT_DIALOG_SELLPRICE	Verkoop Prijs:	
MOVE_CHANNEL_99	CH0
MOVE_CHANNEL_CANCEL	Annuleren
MOVE_CHANNEL_NOTICE	Je bent verbonden met kanaal %d.
MOVE_CHANNEL_NOT_MOVE	Je kunt je kanaal niet veranderen.
MOVE_CHANNEL_SELECT	OK
MOVE_CHANNEL_TITLE	Kanalen
MOVE_ITEM_FAILURE_PRIVATE_SHOP	Je kunt geen voorwerpen verplaatsen wanneer je een privé Warenhuis hebt geopend.
MUSIC_EMPTY_MUSIC_LIST	Geen Achtergrond muziek.	
MUSIC_METIN2_DEFAULT_THEMA	Metin2 Standaard muziek.	
MUSIC_NOT_SELECT_MUSIC	Geen Muziek bestand geselecteerd.	
NEEFD_REST	Je moet eerst rusten.	
NOT_YET_SUPPORT	Nog niet ondersteund	
OPEN_THE_SPECIAL_ACTION_KIT	%s toegevoegd aan emoties.
OPTION_PVPMODE_CANNOT_SET_GUILD_MODE	Je kunt Gilde Modus niet activeren wanneer je niet bij een Gilde hoort.	
OPTION_PVPMODE_NOT_SUPPORT	Je kunt deze configuratie niet kiezen in PvP Modus.	
OPTION_PVPMODE_PROTECT	Je moet minstens level %d hebben om de PvP Modus te veranderen.	
PARTY_ANSWER_TIMEOVER	De uitnodiging is geweigerd.
PARTY_BONUS_ATTACKER	Aanvals Waarde: +%d	SA
PARTY_BONUS_BERSERKER	Aanvals Snelheid: +%d	SA
PARTY_BONUS_BUFFER	Vaardig. duur: +%d	SA
PARTY_BONUS_DEFENDER	Verdediging: +%d	SA
PARTY_BONUS_EXP	Bonus ERV: %d%%	SA
PARTY_BONUS_SKILL_MASTER	Max. TP: +%d	SA
PARTY_BONUS_TANKER	Max. LP: +%d	SA
PARTY_BREAK_UP	Verwijder Groep	
PARTY_DO_YOU_ACCEPT	 will zich aansluiten bij de Groep.
PARTY_DO_YOU_JOIN	 heeft je uitgenodigd om in de groep te komen. Accepteer?
PARTY_EXP_DISTRIBUTION_MODE	ERV Verdeling	
PARTY_EXP_DISTRIBUTION_MODE_LEVEL	Level afhankelijk
PARTY_EXP_DISTRIBUTION_MODE_LEVEL_TOOLTIP	Hoger Level groepsleden ontvangen meer ERV.
PARTY_EXP_DISTRIBUTION_MODE_PARITY	Gelijk
PARTY_EXP_DISTRIBUTION_MODE_PARITY_TOOLTIP	Alle Groepsleden ontvangen dezelfde ERV.	
PARTY_HEAL_ALL_MEMBER	Herstel alles.	
PARTY_INCREASE_AREA_150	Bereik van de GRoep verhoogt met een factor 1.5.	SNA
PARTY_INCREASE_AREA_200	Bereik van de Groep veerhoogd met een factor 2.	SNA
PARTY_LEAVE	Groep verlaten
PARTY_LONGTIME_BONUS_EXP	Bonus ERV voor een lange groeps spel: +%d%%	SA
PARTY_MATCH_CANCEL	De groepszoekactie voor %s is geannuleerd.
PARTY_MATCH_FAIL_FULL_MEMBER	Jouw groep kan niet meer leden accepteren.
PARTY_MATCH_FAIL_IMPOSSIBLE_MAP	Je kunt niet aanmelden voor deze kerker.
PARTY_MATCH_FAIL_LEVEL	Jouw level is te laag.
PARTY_MATCH_FAIL_MEMBER_NOT_CONDITION	Het lid %s voldoet niet aan de noodzakelijke vereisten.
PARTY_MATCH_FAIL_NONE_MAP_INDEX	Kies a.u.b. eerst een kerker.
PARTY_MATCH_FAIL_NOT_LEADER	Alleen de groepsleider kan aanmelden.
PARTY_MATCH_FAIL_NO_ITEM	Je hebt niet genoeg %s.
PARTY_MATCH_SEARCHING	Zoeken
PARTY_MATCH_START	Je hebt je groep aangemeld voor de volgende kerker: %s!
PARTY_MEMBER_OFFLINE	[Offline]
PARTY_RECALL_MEMBER	Roep een Groepslid.	
PARTY_REGEN_BONUS	Bonus voor LP- + TP  regeneratie: +%d%%	SA
PARTY_REQUEST_DENIED	Je uitnodiging is afgeslagen.
PARTY_RK_CATEGORY_CZ_CHICKEN	You Wachter Ranglijst
PARTY_RK_CATEGORY_CZ_COW	Chou Wachter Ranglijst
PARTY_RK_CATEGORY_CZ_DOG	Xu Wachter Ranglijst
PARTY_RK_CATEGORY_CZ_DRAGON	Chen Wachter Ranglijst
PARTY_RK_CATEGORY_CZ_HORSE	Wu Wachter Ranglijst
PARTY_RK_CATEGORY_CZ_MONKEY	Shen Wachter Ranglijst
PARTY_RK_CATEGORY_CZ_MOUSE	Zi Wachter Ranglijst
PARTY_RK_CATEGORY_CZ_PIG	Hai Wachter Ranglijst
PARTY_RK_CATEGORY_CZ_RABBIT	Mao Wachter Ranglijst
PARTY_RK_CATEGORY_CZ_SHEEP	Wei Wachter Ranglijst
PARTY_RK_CATEGORY_CZ_SNAKE	Si Wachter Ranglijst
PARTY_RK_CATEGORY_CZ_TIGER	Yin Wachter Ranglijst
PARTY_SET_ATTACKER	Voor Aanvaller uitmaken.	
PARTY_SET_BERSERKER	Voor Woesteling uitmaken.	
PARTY_SET_BUFFER	Voor Blokkeerder uitmaken.	
PARTY_SET_DEFENDER	Voor Verdediger uitmaken.	
PARTY_SET_NORMAL	Instellingen terugtrekken.	
PARTY_SET_SKILL_MASTER	Voor Vaardigheid Meester uitmaken.	
PARTY_SET_TANKER	Als Mesvechter vastleggen	
PARTY_SKILL_ATTACKER	Basis Aanvals Waarde Aanvaller +%.0f	
PARTY_SKILL_BERSERKER	Aanval Snelheid Woesteling  +%.0f	
PARTY_SKILL_BUFFER	Vaardig. Duur Block +%.0f	
PARTY_SKILL_DEFENDER	Verdediging Verdediger +%.0f	
PARTY_SKILL_HP_REGEN	LP Regeneratie +%.0f%%	
PARTY_SKILL_PARTY_AREA	Groeps Bereik +%d%%	
PARTY_SKILL_SKILL_MASTER	Max. TP Vaardigheden Meester +%.0f	
PARTY_SKILL_SP_REGEN	TP Regeneratie +%.0f%%	
PARTY_SKILL_TANKER	Max. LP Mes Vechter +%.0f	
PARTY_SKILL_WARP	Mogelijk om groepsleden te roepen.	
PASSWORD_TITLE	Warenhuis wachtwoord
PET_ATTR_CHANGE_DIALOG_TEXT	Wil je de attributen van je huisdier nu aanpassen?\nHet item 'Betoverd Huisdier' zal gebruikt worden voor dit proces.\nHet proces kan echter mislukken.
PET_ATTR_CHANGE_USE	Deze actie kan niet uitgevoerd worden wanneer huisdierattributen aangepast worden.
PET_ATTR_DETERMINE_TYPE1	Huisdiertype 1: onhandig. Niet bijzonder sterk.\nOp den duur kun je zijn vaardigheden verbeteren.
PET_ATTR_DETERMINE_TYPE2	Huisdiertype 2: nieuwsgierig. Niet bijzonder sterk.\nEen trouwe metgezel wiens vaardigheden na verloop van tijd verbeteren.
PET_ATTR_DETERMINE_TYPE3	Huisdiertype 3: levendig. Gemiddelde kracht.\nOp den duur kun je zijn vaardigheden verbeteren.
PET_ATTR_DETERMINE_TYPE4	Huisdiertype 4: moedig. Gemiddelde kracht.\nEen trouwe metgezel wiens vaardigheden na verloop van tijd verbeteren.
PET_ATTR_DETERMINE_TYPE5	Huisdiertype 5: brutaal. Sterk.\nOp den duur kun je zijn vaardigheden verder verbeteren.
PET_ATTR_DETERMINE_TYPE6	Huisdiertype 6: legendarisch. Sterk.\nEen trouwe metgezel wiens vaardigheden zelfs na verloop van tijd verbeteren.
PET_ATTR_DETERMINE_TYPE7	Huisdiertype 7: mythisch. Enorm sterk.\nZal zijn volledige potentie mettertijd bereiken.
PET_ATTR_DETERMINE_TYPE8	Huisdiertype 8: prismatisch. Extreem sterk.\nEen trouwe compagnon waar je altijd op kunt bouwen.
PET_BAG_DESC	%s
PET_CANNOT_FEED_CUBEOPEN	Je kunt je huisdier niet voeren wanneer het verbeteringsscherm geopend is.
PET_CAN_NOT_ATTRCHANGE_BECUASE_LIFE_TIME_END	Je kunt geen attributen van een dood huisdier aanpassen.
PET_CAN_NOT_EGG_ITEM_USE	Je kunt je Broedmachine niet openen tijdens het handelen of terwijl je jouw Opslag of Privé Warenhuis open hebt.
PET_CAN_NOT_FEED_SPLIT_ITEM	Je kunt geen verdeelde items plaatsen in dit venster.
PET_CAN_NOT_FEED_TYPE	Zo kun je jouw huisdier niet voeren. Probeer a.u.b. iets anders.
PET_CAN_NOT_OPEN_EVOL_BUTTON	Je huisdier moet level %d zijn om te trainen en promoveren naar het volgende level van evolutie.
PET_CAN_NOT_OPEN_EVOL_BUTTON_EXP_LACK	Je huisdier moet 100% ervaring hebben om te trainen en promoveren naar het volgende level van evolutie.
PET_CAN_NOT_OPEN_EVOL_BUTTON_LEVEL_MAX	Je huisdier heeft het hoogste level van evolutie al bereikt.
PET_CAN_NOT_OPEN_SHOP_BECAUSE_SUMMON	Je kunt geen Privé Warenhuis openen als je jouw huisdier opgeroepen hebt.
PET_CAN_NOT_OPEN_SPECIAL_EVOL_BUTTON	Je huisdier moet %d dagen oud zijn om te trainen en promoveren naar het volgende level van evolutie.
PET_CAN_NOT_SUMMON_BECAUSE_LIFE_TIME_END	Je kunt je huisdier niet oproepen omdat de duur verlopen is.
PET_CAN_NOT_USE_BAG	Je kunt de Transporteer Doos niet gebruiken omdat je huisdier al verlopen is.
PET_EMPTY_SKILL_SLOT_USE_ITEM	Je huisdier heeft geen vaardigheden om te resetten.
PET_HATCHING_ACCEPT	Wil je jouw huisdier '%s' noemen?
PET_HATCHING_MONEY	Prijs: %s
PET_HATCHING_WINDOW_OPEN_CAN_NOT_USE	Je kunt geen andere interacties uitvoeren terwijl de Broedmachine geopend is.
PET_INFORMATION_STAGE1	Jong
PET_INFORMATION_STAGE2	Wild
PET_INFORMATION_STAGE3	Moedig
PET_INFORMATION_STAGE4	Heroïsch
PET_INFO_EXP	Huidige ervaring:
PET_INFO_ITEM_EXP	Huidig Item EXP
PET_INFO_NEXT_EXP	Resterende ervaring:
PET_INFO_NEXT_ITEM_EXP	Resterend Item EXP
PET_MSG_NOT_ENOUGH_MONEY	Je hebt niet genoeg Yang.
PET_NAME_CHANGE_ACCEPT	Wil je de naam van je huisdier veranderen in %s?
PET_NAME_MIN	De ingevoerde naam is te kort.
PET_REVIVE_FAIL_EMPTY_PET_SLOT	Er is geen huisdier om tot leven te wekken.
PET_REVIVE_FAIL_NOT_ENOUGHT_MATERIAL	Je hebt niet genoeg materialen.
PET_REVIVE_UI_MATERIAL_COUNT	%d/%d
PET_SKILL_DELETE_QUESTION_DLG_MSG	Vaardigheden zijn nu beschikbaar.
PET_SKILL_DELETE_QUESTION_DLG_MSG1	Het resetten van de vaardigheden van je huisdier is onomkeerbaar.
PET_SKILL_DELETE_QUESTION_DLG_MSG2	Wil je doorgaan?
PET_SKILL_LEARN_FAIL_CONDITIONS	Je huisdier is niet oud genoeg of heeft het vereiste level nog niet bereikt. Alleen heroïsche huisdieren kunnen vaardigheden leren.
PET_SKILL_LEARN_QUESTION_DLG_MSG	Wil je de heldentraining starten met '%s'?
PET_SKILL_TOOLTIP_COOLTIME	Afkoelperiode: %s seconden
PET_SKILL_TOOLTIP_DURATION	Duur: %d seconden
PET_SKILL_TOOLTIP_FEATHER	Het huisdier heeft een kans van %d%% om Vederlicht Lopen te activeren voor %.1f seconden.\n Aanval %d - %d	SAAAA
PET_SKILL_TOOLTIP_HEAL	Als je LP onder de 20%% komt, heb je een \n kans van %d%% om je LP te verhogen met %d.	SAA
PET_SKILL_TOOLTIP_INVINVIBILITY	Je karakter heeft een kans van %d%% om onkwetsbaar\n te worden als je LP onder 10%% zakt. \n Effectduur: %.1f seconden.	SAA
PET_SKILL_TOOLTIP_REMOVAL	Er is een kans van %d%% om onmiddellijk \n alle effecten zoals langzaam, gif of bloeden te stoppen als je\n karakter hierdoor beïnvloed is.	SAN
PET_SKILL_UPGRADE_QUESTION_DLG_MSG1	Heldentraining verhogen naar volgend level?
PET_SKILL_UPGRADE_QUESTION_DLG_MSG2	Kosten: %s
PET_TOOLTIP_COSTUME_BONUS	
PET_TOOLTIP_DEF	Verdediging
PET_TOOLTIP_HP	LP
PET_TOOLTIP_LEVEL	Level
PET_TOOLTIP_LIFETIME_OVER	Verlopen
PET_TOOLTIP_SKILL_BONUS_VALUE	in heldentraining
PET_TOOLTIP_SKILL_CUR_LEVEL	Level: %d
PET_TOOLTIP_SKILL_NEXT_LEVEL	Volgend level: %d (max. %d)
PET_TOOLTIP_SP	TP
PET_TOOLTIP_TRADABLE	Verhandelbaar
PET_TOOLTUP_SKILL	%s (Level %d)
PICK_ITEM_TITLE	Voorwerp Nummer	
PICK_MONEY_TITLE	Som	
PRIVATESHOPSEARCH_ABLITY_POTION	Dauw
PRIVATESHOPSEARCH_ACCESSORY_SOCKET	Fijn Doek
PRIVATESHOPSEARCH_ARMOR	Uitrusting
PRIVATESHOPSEARCH_ARROW	Pijlen
PRIVATESHOPSEARCH_BELL	Bellen
PRIVATESHOPSEARCH_BELT	Riemen
PRIVATESHOPSEARCH_BLEND	Drankjes
PRIVATESHOPSEARCH_BLOOD_PEARL	Bloedrode Parel
PRIVATESHOPSEARCH_BLUE_PEARL	Blauwe Parel
PRIVATESHOPSEARCH_BODY	Uitrusting
PRIVATESHOPSEARCH_BOW	Bogen
PRIVATESHOPSEARCH_BUYTIME	Wil je het geselecteerde item kopen?
PRIVATESHOPSEARCH_CLAW	Klauwen
PRIVATESHOPSEARCH_CLEAR_POTION	Elixers
PRIVATESHOPSEARCH_COSTUME	Kostuums
PRIVATESHOPSEARCH_COSTUMEBODY	Kostuum
PRIVATESHOPSEARCH_COSTUMEHAIR	Haarstijl
PRIVATESHOPSEARCH_COSTUME_ACCE	Schoudergordels
PRIVATESHOPSEARCH_COSTUME_MOUNT	Mount
PRIVATESHOPSEARCH_CRYSTAL	Kristal
PRIVATESHOPSEARCH_DAGGER	Dolken
PRIVATESHOPSEARCH_DEAD	Dood
PRIVATESHOPSEARCH_DETACHMENT	Steen Handboek
PRIVATESHOPSEARCH_DIAMOND	Diamant
PRIVATESHOPSEARCH_DS	Drakensteen Alchemie
PRIVATESHOPSEARCH_DS_BLACK	Onyx
PRIVATESHOPSEARCH_DS_BLUE	Saffier
PRIVATESHOPSEARCH_DS_GREEN	Jade
PRIVATESHOPSEARCH_DS_RED	Robijn
PRIVATESHOPSEARCH_DS_WHITE	Diamant
PRIVATESHOPSEARCH_DS_YELLOW	Granaat
PRIVATESHOPSEARCH_EAR	Oorbellen
PRIVATESHOPSEARCH_FAN	Waaiers
PRIVATESHOPSEARCH_FISH	Vissen
PRIVATESHOPSEARCH_FOOTS	Schoenen
PRIVATESHOPSEARCH_GEM	Edelstenen
PRIVATESHOPSEARCH_GIFTBOX	Geschenkdozen
PRIVATESHOPSEARCH_HEAD	Helmen
PRIVATESHOPSEARCH_LIVE	Levend
PRIVATESHOPSEARCH_MATERIAL	Materialen
PRIVATESHOPSEARCH_METIN	Geestenstenen
PRIVATESHOPSEARCH_NECK	Kettingen
PRIVATESHOPSEARCH_NEED_ITEM_BUY	Je kunt geen items kopen zonder de juiste bundel.
PRIVATESHOPSEARCH_NEED_ITEM_FIND	Je kunt niet zoeken naar items zonder de juiste bundel.
PRIVATESHOPSEARCH_NODELAY_POTION	LP Items
PRIVATESHOPSEARCH_ORE	Erts
PRIVATESHOPSEARCH_PET	Huisdiersysteem
PRIVATESHOPSEARCH_PETAGG	Huisdieren Eieren
PRIVATESHOPSEARCH_PETSKILLBOOK	Huisdieren Vaardigheden Boeken
PRIVATESHOPSEARCH_PICK	Pikhouwelen
PRIVATESHOPSEARCH_POTION	Drankjes
PRIVATESHOPSEARCH_QUEST	Quest
PRIVATESHOPSEARCH_QUIVER	Pijlenkokers
PRIVATESHOPSEARCH_RESOURCE	Item Verbetering
PRIVATESHOPSEARCH_ROD	Vishengels
PRIVATESHOPSEARCH_SELECTITEM	Item geselecteerd
PRIVATESHOPSEARCH_SHIELD	Schilden
PRIVATESHOPSEARCH_SKILLBOOK	Vaardigheden Boeken
PRIVATESHOPSEARCH_SKILLFORGET	Vergeetachtigheid Boek
PRIVATESHOPSEARCH_SPECIAL	Overige
PRIVATESHOPSEARCH_STONE	Energie Fragmenten
PRIVATESHOPSEARCH_SWORD	Eenhandszwaarden
PRIVATESHOPSEARCH_TREASUREBOX	Kisten
PRIVATESHOPSEARCH_TUNING	Geschriften
PRIVATESHOPSEARCH_TWOSWORD	Tweehandszwaarden
PRIVATESHOPSEARCH_UNIQUE	Uniek
PRIVATESHOPSEARCH_USEITEM	Gebruiksvoorwerpen
PRIVATESHOPSEARCH_USESPECIAL	Overige
PRIVATESHOPSEARCH_WEAPON	Wapens
PRIVATESHOPSEARCH_WHITE_PEARL	Witte Parel
PRIVATESHOPSEARCH_WRIST	Armbanden
PRIVATE_SHOP_CANNOT_SELL_ITEM	Je kunt dit Voorwerp niet verkopen in een privé Warenhuis.
PRIVATE_SHOP_CLOSE_QUESTION	Wil je dit privé Warenhuis sluiten?
PRIVATE_SHOP_INPUT_NAME_DIALOG_TITLE	Naam van het privé Warenhuis
PRIVATE_SHOP_INPUT_PRICE_DIALOG_TITLE	Prijs
PVP_LEVEL0	Ridderlijk	
PVP_LEVEL1	Nobel	
PVP_LEVEL2	Goed	
PVP_LEVEL3	Vriendelijk	
PVP_LEVEL4	Neutraal	
PVP_LEVEL5	Agressief	
PVP_LEVEL6	Frauduleus	
PVP_LEVEL7	Kwaadwillig	
PVP_LEVEL8	Gemeen	
PVP_MODE_GUILD	PvP - Gilde geactiveerd
PVP_MODE_KILL	PvP - Vrij geactiveerd
PVP_MODE_NORMAL	PvP - Vrede geactiveerd
PVP_MODE_PROTECT	PvP - Bescherming geactiveerd
PVP_MODE_REVENGE	PvP - Vijandig geactiveerd
PVP_OPTION_KILL	Vrij	
PVP_OPTION_NORMAL	Vrede	
PVP_OPTION_PROTECT	Bescherming	
PVP_OPTION_REVENGE	Vijandig	
PVP_TOURNAMENT_DO_NOT_AUTO	Je kunt 'automatisch aanvallen' niet gebruiken tijdens het PvP-toernooi.
QUEST_APPEND	Nieuwe Quest verworven.	
QUEST_HOUR	Uur
QUEST_MIN	Min.	
QUEST_SEC	Sec.	
QUEST_TIMEOVER	Tijd Verlopen	
QUEST_UNLIMITED_TIME	Geen tijd limiet.	
QUEST_ZEROSEC	0 Sec.	
QUICKSLOT_REGISTER_DISABLE_ITEM	Dit Voorwerp kan niet toegevoegd worden in de Snelle Toegangs Gebied	
RANKING	Rang
RANKING_BOARD_MEMBER	Lid
RECEIVE_MESSAGE	%s heeft je een bericht gestuurd.	
REFINE_COST	Kosten voor Bevordering: %d Yang
REFINE_DESTROY_WARNING	Dit Voorwerp kan vernietigd worden tijden het opwaarderen.	
REFINE_DESTROY_WARNING_WITH_BONUS_PERCENT_1	Wil je dit item echt verbeteren?
REFINE_DESTROY_WARNING_WITH_BONUS_PERCENT_2	Als het mislukt, zal het item vernietigd worden. Wil je doorgaan?
REFINE_DOWN_GRADE_WARNING	Dit Voorwerp kan gedegradeerd worden.	
REFINE_DO_YOU_SEPARATE_METIN	Wil je alle beschikbare Geestenstenen verwijderen?
REFINE_ELEMENT_CHANGE_TEXT	%s heeft nu het element %s!
REFINE_ELEMENT_DOWNGRADE_TEXT	De elementale betovering is verslechterd.
REFINE_ELEMENT_EXIST	Het item heeft al een ander element.
REFINE_ELEMENT_GRADE_MAX	Het maximale level van elementale betovering is al bereikt.
REFINE_ELEMENT_NOT_ENOUGHT_GRADE	De elementale betovering is alleen beschikbaar voor +7 wapens of hoger.
REFINE_ELEMENT_NOT_ENOUGHT_YANG	Niet genoeg Yang.
REFINE_ELEMENT_NOT_EXSIT	Kan niet gebruikt worden met dit item.
REFINE_ELEMENT_TEXT_DARK	Duisternis +%d
REFINE_ELEMENT_TEXT_EARTH	Aarde +%d
REFINE_ELEMENT_TEXT_ELECT	Bliksem +%d
REFINE_ELEMENT_TEXT_FIRE	Vuur +%d
REFINE_ELEMENT_TEXT_ICE	IJs +%d
REFINE_ELEMENT_TEXT_WIND	Wind +%d
REFINE_ELEMENT_UPGRADE_FAIL_TEXT	Elementale betovering is mislukt.
REFINE_ELEMENT_UPGRADE_SUCCESS_TEXT	Elementale betovering is gelukt!
REFINE_FAILURE	Oh nee, dat werkte niet! We hebben gefaald.
REFINE_FAILURE_CAN_NOT_ATTACH	%s kan niet toegevoegd worden aan dat Voorwerp.	
REFINE_FAILURE_DEL_ITEM	De verbetering is mislukt. Het item is vernietigd.
REFINE_FAILURE_EQUIP_ITEM	Je kunt geen voorwerpen die je draagt upgraden.
REFINE_FAILURE_GRADE_DOWN	De verbetering is mislukt. De itemklasse is verminderd.
REFINE_FAILURE_KEEP_GRADE	De verbetering is mislukt. Gelukkig is het item onbeschadigd gebleven.
REFINE_FAILURE_METIN_INSEPARABLE_ITEM	Er kon geen Geestensteen weggehaald worden.	
REFINE_FAILURE_NEED_BETTER_SCROLL	Je hebt een betere Bevorderings Geschrift nodig.	
REFINE_FAILURE_NO_GOLD_SOCKET	Er is geen Goud fitting om %s in te zetten.	
REFINE_FAILURE_NO_MORE_SOCKET	Je kunt niet meer Fittingen maken.	
REFINE_FAILURE_NO_SOCKET0	Er is geen Fitting om %s in te zetten.
REFINE_FAILURE_SOCKET_DISABLE_ITEM	Je kunt geen Fitting maken in dit Voorwerp.	
REFINE_FAILURE_UPGRADE_DISABLE_ITEM	Dit Voorwerp kan niet geüpgrade worden.
REFINE_SUCCESS	Het bevorderen van het Voorwerp was successvol.	
REFINE_SUCCESS_PROBALITY	Kans op Bevordering %d%%	
REFINE_WARNING2	Wil je doorgaan?	
RESTART_POPUP_GIVEUP_MIST_ISLAND	Je bent omgekomen in de Slag om de Vijf Altaren. Je zult nu terugkeren naar het dorp.
REVIVE_QUESTION	Wil je %s tot leven wekken? Aantal Prisma's der Opwekking: %d
REVIVE_SELF_QUESTION	Wil je jezelf tot leven wekken? Aantal Prisma's der Opwekking: %d
ROULETTE_REWARD_TEXT	Item ophalen
SAFEBOX_ERROR	Je hebt een verkeerde wachtwoord ingevoerd.	
SAFEBOX_NEED_CHANGE_PASSWORD	Je wachtwoord is verlopen.\nKies a.u.b. een nieuw wachtwoord.
SAFEBOX_SELL_DISABLE_SAFEITEM	Je kunt geen opgeslagen Voorwerpen verkopen.	
SAFEBOX_UNAVILABLE_PASSWORD_01	Je kunt dit wachtwoord niet gebruiken.
SAFEBOX_UNAVILABLE_PASSWORD_02	Je wachtwoord moet minimaal uit %d karakters bestaan.
SAFEBOX_UNAVILABLE_PASSWORD_03	Je hebt je huidige wachtwoord ingevuld. Kies a.u.b. een nieuw wachtwoord.
SAFEBOX_UNAVILABLE_PASSWORD_04	Je wachtwoord mag niet uit %d identieke of opeenvolgende nummers bestaan.
SAFEBOX_UNAVILABLE_PASSWORD_05	Geen speciale karakters toegestaan. Toegestane karakters: a-z, A-Z, 0-9
SAFEBOX_WRONG_PASSWORD	De wachtwoorden moeten identiek zijn.	
SCREENSHOT_SAVE1	is opgeslagen in	
SCREENSHOT_SAVE2	Screenshot Bestand	
SCREENSHOT_SAVE_FAILURE	Opslaan Screenshot mislukt.	
SECOND	Sec	
SECOND_CONFIRM_PET_FEED_QUESTION_1	Jouw item heeft %d of meer bonussen.
SECOND_CONFIRM_PET_FEED_QUESTION_2	Weet je zeker dat je het wilt voeren aan je huisdier?
SECOND_CONFIRM_SELL_ITEM_QUESTION_1	Jouw item heeft %d of meer bonussen.
SECOND_CONFIRM_SELL_ITEM_QUESTION_2	Weet je zeker dat je het wilt verkopen?
SELECT_ATTR_NOTICE	Je kunt geen Privé Warenhuis openen terwijl je Betover Voorwerp+ gebruikt.
SELECT_ATTR_NOT_OPEN	Je kunt geen Betover Voorwerp+ gebruiken als je een Privé Warenhuis open hebt.
SELECT_ATTR_NOT_SELECT	Bepaal of je bonussen wil houden of ze wil verwisselen.
SELECT_CAN_NOT_DELETE	Je kunt de Charakter niet deleten.	
SELECT_CAN_NOT_DELETE_ATTR67	Je kunt je karakter niet verwijderen\nwanneer er een bonus aan toegevoegd wordt.
SELECT_CAN_NOT_DELETE_GUILD_MEMBER	Je kunt je karakter niet verwijderen zolang ze lid zijn van een gilde.
SELECT_CAN_NOT_DELETE_HAVE_SEALED_ITEM	Je kunt je karakter niet verwijderen omdat deze zielsgebonden items bezit.
SELECT_CAN_NOT_DELETE_LAST_CHAR_SAFEBOX	Je kunt je enige karakter niet verwijderen omdat er nog steeds items in je opslag zitten.
SELECT_CAN_NOT_DELETE_LIMITE_LEVEL	Je kunt je karakter slechts tot level 69 verwijderen.
SELECT_CAN_NOT_DELETE_MARRIAGE	Je kunt geen getrouwde karakters verwijderen.
SELECT_CAN_NOT_DELETE_PRIVATE_CODE_ERROR	De verwijderingscode is ongeldig.
SELECT_CAN_NOT_DELETE_REMAIN_TIME	Je kunt dit karakter niet direct na het aanmaken weer verwijderen. Wachtperiode: %s
SELECT_CHANGED_NAME	Je hebt de naam van de karakter veranderd.	
SELECT_CHANGE_FAILURE_ALREADY_EXIST_NAME	De karakter naam bestaat al.	
SELECT_CHANGE_FAILURE_STRANGE_INDEX	Probeer opnieuw.	
SELECT_CHANGE_FAILURE_STRANGE_NAME	Dat	
SELECT_CHANGE_NAME_TITLE	Verander karakter naam.	
SELECT_DELEING	Karakter zal verwijderd worden.	
SELECT_DELETED	Verwijdering successvol.	
SELECT_DO_YOU_DELETE_REALLY	Wil je doorgaan?	
SELECT_EMPTY_SLOT	Dit is een leeg veld.	
SELECT_GM_NAME	GM	
SELECT_INPUT_CHANGING_NAME	Voer een nieuwe karakter naam in.	
SELECT_NOT_JOIN_GUILD	Geen Gilde	
SERVER_NOTIFY_CLOSED	Gesloten server: alleen accounts met VIP-status of die aangemaakt zijn voordat de server sloot mogen binnentreden.
SERVER_STATUS_CLOSE	GESLOTEN
SERVER_STATUS_NEW	NIEUW
SERVER_STATUS_SPECIAL	SPECIAAL
SHOP_BUY_INFO	Kies het Voorwerp dat je wilt kopen in het winkel venster.
SHOP_CANNOT_SELL_EQUIPMENT	Je kunt niet voorwerpen verkopen die je draagt.
SHOP_CANNOT_SELL_ITEM	Dit Voorwerp kan niet verkocht worden.
SHOP_ERROR_UNKNOWN	Onbekende Winkel fout: %s
SHOP_EXCEED_LIMIT_TODAY	Je hebt je dagelijkste limiet voor het gebruik van punten al bereikt.
SHOP_INVALID_POS	Dit Voorwerp kan hier niet gebruikt worden.
SHOP_INVENTORY_FULL	Je Inventaris is vol.
SHOP_LIMITED_DATA_LOADING	Data laden. Probeer het later opnieuw a.u.b.
SHOP_LIMITED_ITEM_REMAIN_COUNT	Resterende items: %d
SHOP_LIMITED_PURCHASE_OVER	Uitverkocht
SHOP_LIMIT_TODAY	Dagelijkse limiet: %d / %d
SHOP_MY_BATTLE_POINT	Strijdpunten: %d
SHOP_MY_MEDAL_OF_HONOR	Medaille van Heldhaftigheid: %d
SHOP_NOT_ENOUGH_10TH_COIN	Je hebt niet genoeg Jubileum Munten.
SHOP_NOT_ENOUGH_BATTLE_POINT	Je hebt niet genoeg strijdpunten.
SHOP_NOT_ENOUGH_BNW	Je hebt niet genoeg Ziener Munten.
SHOP_NOT_ENOUGH_GUILD_LEVEL	Gildelevel is te laag.
SHOP_NOT_ENOUGH_MEDAL_OF_HONOR	Onvoldoende Medailles van Heldhaftigheid.
SHOP_NOT_ENOUGH_MONEY	Niet genoeg Won of Yang
SHOP_NOT_ENOUGH_MONEY_EX	Je hebt niet genoeg Yang.
SHOP_SELL_INFO	Kies het Voorwerp dat verkocht gaat worden in je inventaris venster.
SHOP_SOLDOUT	Uitverkocht
SHOT_ERROR_UNKNOWN	Onbekende fout tijdens Lange Afstands Aanval: %s
SKILL_BLEEDING	Bloeden
SKILL_BOHO	Terugkaatsen	
SKILL_CANNOT_LEVEL_UP_ANYMORE_BY_BOOK	Je hebt ERV nodig om deze Vaardigheid te leren.	
SKILL_CANNOT_LEVEL_UP_ANYMORE_BY_STAT	Je hebt een boek nodig om deze Vaardigheid te leren.	
SKILL_CHEONGEUN	Sterk Lichaam	
SKILL_CRITICAL	Kritieke slag
SKILL_ENCHANT_POISON	Gif Toedienen	
SKILL_EUNHYEONG	Camouflage	
SKILL_FAINT	Blackout	
SKILL_FIND_TRAP	Vind Val	
SKILL_FIRE	Permanent Vuur	
SKILL_FISHMIND	Vissen bol is actief
SKILL_GAMJI	Verover	
SKILL_GEOMGYEONG	Aura van de Zwaard	
SKILL_GICHEON	Draken Hulp
SKILL_GIGONG	Chi Wenteling	
SKILL_GONGPO	Angst	
SKILL_GRADE_NAME_GRAND_MASTER	%s Grootmeester	
SKILL_GRADE_NAME_MASTER	%s Meester	
SKILL_GRADE_NAME_PERFECT_MASTER	%s Perfecte Meester	
SKILL_GROUP_ASSASSIN_1	Mes	
SKILL_GROUP_ASSASSIN_2	Boog	
SKILL_GROUP_HORSE	Ruiter Vaardigheden	
SKILL_GROUP_SHAMAN_1	Draak	
SKILL_GROUP_SHAMAN_2	Heling	
SKILL_GROUP_SURA_1	Wapen	
SKILL_GROUP_SURA_2	Magie	
SKILL_GROUP_WARRIOR_1	Lichaam	
SKILL_GROUP_WARRIOR_2	Mentaal	
SKILL_GWIGEOM	Betoverd Mes	
SKILL_GYEONGGONG	Verderlicht Lopen
SKILL_HEUKSIN	Donkere Bescherming	
SKILL_HOSIN	Zegening	
SKILL_INC_ATKSPD	Aanvals snelheid verhoogd
SKILL_INC_MOVSPD	Bewegings snelheid verhoogd
SKILL_JEOJU	Vloek	
SKILL_JEONGEOP	Heling	
SKILL_JEONGWI	Vechtroes
SKILL_JEONSINBANGEO	Volle Verdediging	
SKILL_JEONSINGONGGYEOK	Volle Aanval	
SKILL_JEUNGRYEOK	Aanval +	
SKILL_JEUNGSOK	Beweging +	
SKILL_JUMAGAP	Betoverd Pantser	
SKILL_KWAESOK	Snelheid	
SKILL_MUYEONG	Geest van de Vlam	
SKILL_NEED_EMPTY_BOTTLE	Ik heb geen Lege Fles.	
SKILL_NEED_POISON_BOTTLE	Ik heb geen Gif Fles	
SKILL_ONLY_FOR_GUILD_WAR	Je kunt deze Vaardigheid alleen tijdens een Gilde Oorlog gebruiken.	
SKILL_PABEOP	Neutraliseer Spreuk	
SKILL_POWERFUL_STRIKE	Overdonderend Aanval	
SKILL_SEOMGWANG	Bliksem Bom	
SKILL_SLEEP	Slaap	
SKILL_SLOW	Langzaam	
SKILL_STUN	Overdonderen	
SKILL_SUHO	Wachter
SKILL_SUMMON_DESCRIPTION	Kans van de Evocatie:  %d%%	
SKILL_TOOLTIP_INT	Intelligentie	
SKILL_TOOLTIP_LEVEL	Level	
SKILL_TOXICDIE	Vergiftiging	
SKILL_TOXICPOWER	Gif Aanval waarde verhoogd	
SKILL_TUSOK	Geest Slag	
SOUL_ITEM_TOOLTIP_APPLY	Effect geactiveerd
SOUL_ITEM_TOOLTIP_BLUE1	Speeltijd: %d/%d min. 
SOUL_ITEM_TOOLTIP_BLUE2	Vaardighedenschade stijgt met x%.1f bij het bereiken van de speeltijd
SOUL_ITEM_TOOLTIP_COMMON	Niet voor: PvP, Transformatie
SOUL_ITEM_TOOLTIP_RED1	Speeltijd: %d/%d min. 
SOUL_ITEM_TOOLTIP_RED2	Aanvalsschade stijgt met x%.1f bij het bereiken van de speeltijd
SOUL_ITEM_TOOLTIP_REMAIN_COUNT	Resterende aanvallen: %d
SOUL_ITEM_TOOLTIP_REMOVE_TIME	Ziel verloopt over
SOUL_ITEM_TOOLTIP_UNAPPLIED	Effect niet geactiveerd
SOUL_REFINE_FAILURE	Verbetering mislukt.
SOUL_REFINE_SUCCESS	Verbetering succesvol!
STAT_MINUS_CON	Vitaliteits Afstelling (Resterende kans: %d)
STAT_MINUS_DEX	Behendigheids Afstelling (Resterende kans: %d)
STAT_MINUS_INT	Intelligentie Afstelling (Resterende Kans: %d)	
STAT_MINUS_STR	Kracht Afstelling (Resterende Kans: %d)	
STAT_TOOLTIP_CON	Verhoogd LP en Verdediging
STAT_TOOLTIP_DEX	Verhoogd Aanval en Handigheid
STAT_TOOLTIP_INT	Verhoogd TP, magische aanvalskracht en verdediging
STAT_TOOLTIP_STR	Verhoogd Aanvals waarde en Schade
SYMBOLLIST_TITLE	Registreer Gilde Vlag	
TARGET_BUTTON_ACCEPT_FIGHT	Toestemmen	
TARGET_BUTTON_AVENGE	Wraak	
TARGET_BUTTON_BLOCK	Blokkeren
TARGET_BUTTON_BLOCK_REMOVE	Deblokkeren
TARGET_BUTTON_BUILDING_DESTROY	Vernietigen	
TARGET_BUTTON_DISMOUNT	Afstijgen
TARGET_BUTTON_EMOTION_ALLOW	Emoties	
TARGET_BUTTON_EXCHANGE	Handelen	
TARGET_BUTTON_EXCLUDE	Uitsluiten	
TARGET_BUTTON_EXIT_OBSERVER	Beëndig Toeschouwer Mode	
TARGET_BUTTON_FIGHT	Duel	
TARGET_BUTTON_FRIEND	Vriend	
TARGET_BUTTON_INVITE_GUILD	Gilde Uitnodiging	
TARGET_BUTTON_INVITE_PARTY	Groeps Uitnodiging	
TARGET_BUTTON_LEAVE_PARTY	Verlaat Groep	
TARGET_BUTTON_REQUEST_ENTER_PARTY	Aansluiten bij Groep	
TARGET_BUTTON_REVIVE	Tot leven wekken
TARGET_BUTTON_VIEW_EQUIPMENT	Pantser
TARGET_BUTTON_WHISPER	Fluisteren	
TARGET_LEVEL_BOSS	Baas	
TARGET_LEVEL_KING	Level 5.	
TARGET_LEVEL_KNIGHT	Level 3.	
TARGET_LEVEL_PAWN	Level 1.	
TARGET_LEVEL_S_KNIGHT	Level 4.	
TARGET_LEVEL_S_PAWN	Level 2.	
TARGET_TOOLTIP_ATTACK_COUNT	Totale Treffers: %d
TASKBAR_ATTACK	Aanvallen	
TASKBAR_AUTO	Automatisch Aanvallen
TASKBAR_CAMERA	Camera	
TASKBAR_EXP	Ervaring	
TASKBAR_HP	LP	
TASKBAR_MOVE	Beweeg	
TASKBAR_SKILL	Vaardigheid	
TASKBAR_SP	TP	
TASKBAR_ST	UV	
TENTH_COIN	Jubileum Munt(en)
TENTH_EVENT_ASK_EXCHANGE	Je hebt %d Jubileum Vlaggen. Wil je doorgaan?
THING_COUNT	alle	
TOOLTIP_AFFECT_ATT_GRADE_DOWN	Schade verminderen	SNA
TOOLTIP_AFFECT_CONFUSION	Je bent overdonderd.
TOOLTIP_AFFECT_CRITICAL_GRADE_DOWN	Kritieke Slagkans verminderen	SNA
TOOLTIP_AFFECT_CZ_UNLIMIT_ENTER	Merk van de Wachter	SNA
TOOLTIP_AFFECT_DEFENSEWAVE_LASER	De hydrostraal kon niet gestopt worden.
TOOLTIP_AFFECT_DEF_GRADE_DOWN	Verdediging verminderen	SNA
TOOLTIP_AFFECT_ELECTRIC_SHOCK	Bliksem
TOOLTIP_AFFECT_FISHING_GOLD_TUNA	Gouden Tonijn Bonus	SNA
TOOLTIP_AFFECT_FISHING_MOVE_SPEED_DOWN	Natte Kleding\nBewegingssnelheid -50	SNA
TOOLTIP_AFFECT_LATE_SUMMER_EVENT_BUFF	Zielen (%d/20)	SA
TOOLTIP_AFFECT_LATE_SUMMER_EVENT_PRIMIUM_BUFF	Zeldzame Zielen (%d/150)	SA
TOOLTIP_AFFECT_MI_BUFF	Bezettings-buff %s
TOOLTIP_AFFECT_MOUNT_FALL	Van rijdier vallen	SNA
TOOLTIP_AFFECT_POLYMORPH	Transformeren	SNA
TOOLTIP_AFFECT_RCAST_SPEED	Afkoelperiode verhogen	SNA
TOOLTIP_AFFECT_RED_DRAGONLAIR_BUFF	Weerstand tegen Vaardigheden Schade +15% | Weerstand tegen normale Aanvalsschade +15%
TOOLTIP_AFFECT_RESEARCHER_ELIXIR	Onderzoeker's Elixer	SNA
TOOLTIP_AFFECT_RHP_REGEN	Kan niet regenereren	SNA
TOOLTIP_AFFECT_SAFEBOX_BUFF_01	Opslagbonus\n+3% ERV	SNA
TOOLTIP_AFFECT_SAFEBOX_BUFF_02	Opslagbonus\n+20 verdediging	SNA
TOOLTIP_AFFECT_SAFEBOX_BUFF_03	Opslagbonus\n+1% levenspunten	SNA
TOOLTIP_AFFECT_SAFEBOX_BUFF_04	Opslagbonus\n+3% kracht tegen monsters	SNA
TOOLTIP_ALIGNMENT_DAMAGE_BONUS	Schade is hoger bij lagere rangpunten.	SNA
TOOLTIP_ANTI_CRITICAL_PCT	Weerstand tegen kritieke slagen +%d%%	SA
TOOLTIP_ANTI_PENETRATE_PCT	Weerstand tegen perforerende slagen +%d%%	SA
TOOLTIP_ANTI_SELL	Kan niet verkocht worden in een Warenhuis
TOOLTIP_APPLY_ACCEDRAIN_RATE	Absorberingswaarde: %d%%	SA
TOOLTIP_APPLY_ATTBONUS_ANIMAL	Sterk tegen Dieren +%d%%	SA
TOOLTIP_APPLY_ATTBONUS_ASSASSIN	Sterk tegen Ninjas +%d%%	SA
TOOLTIP_APPLY_ATTBONUS_BELL	Belverdedigingsbreuk +%d%%	SA
TOOLTIP_APPLY_ATTBONUS_BOW	Pijlverdedigingsbreuk +%d%%	SA
TOOLTIP_APPLY_ATTBONUS_CLAW	Klauwverdedigingsbreuk +%d%%	SA
TOOLTIP_APPLY_ATTBONUS_CZ	Sterk tegen Zodiac Monsters +%d%%	SA
TOOLTIP_APPLY_ATTBONUS_DAGGER	Dolkverdedigingsbreuk +%d%%	SA
TOOLTIP_APPLY_ATTBONUS_DESERT	Sterk tegen Woestijn Monsters +%d%%	SA
TOOLTIP_APPLY_ATTBONUS_DEVIL	Sterk tegen Duivel +%d%%	SA
TOOLTIP_APPLY_ATTBONUS_FAN	Waaierverdedigingsbreuk +%d%%	SA
TOOLTIP_APPLY_ATTBONUS_HUMAN	Sterk tegen Halfmensen +%d%%	SA
TOOLTIP_APPLY_ATTBONUS_INSECT	Sterk tegen Insecten +%d%%	SA
TOOLTIP_APPLY_ATTBONUS_MILGYO	Sterk tegen Mystici +%d%%	SA
TOOLTIP_APPLY_ATTBONUS_MONSTER	Sterk tegen Monster +%d%%	SA
TOOLTIP_APPLY_ATTBONUS_ORC	Sterk tegen Orks +%d%%	SA
TOOLTIP_APPLY_ATTBONUS_SHAMAN	Sterk tegen Sjamaan +%d%%	SA
TOOLTIP_APPLY_ATTBONUS_SURA	Sterk tegen Sura +%d%%	SA
TOOLTIP_APPLY_ATTBONUS_SWORD	Zwaardverdedigingsbreuk +%d%%	SA
TOOLTIP_APPLY_ATTBONUS_TWOHAND	Tweehandsverdedigingsbreuk +%d%%	SA
TOOLTIP_APPLY_ATTBONUS_UNDEAD	Sterk tegen Ondoden +%d%%	SA
TOOLTIP_APPLY_ATTBONUS_WARRIOR	Sterk tegen Krijger +%d%%	SA
TOOLTIP_APPLY_ATTBONUS_WOLFMAN	Sterk tegen Lycanen + %d%%	SA
TOOLTIP_APPLY_BLEEDING_PCT	Bloedingsaanval + %d%%	SA
TOOLTIP_APPLY_BLEEDING_REDUCE	Weerstand tegen Bloedingsaanvallen + %d%%	SA
TOOLTIP_APPLY_BLOCK	%d%% Kans om Aanvallen te blokkeren tegen het Lichaam	SA
TOOLTIP_APPLY_COMBAT_SP_RECOVER	Herstel TP in 5 seconden in een gevecht %d	SA
TOOLTIP_APPLY_CRITICAL_PCT	Kans op Kritieke Slag +%d%%	SA
TOOLTIP_APPLY_DAMAGE_SP_RECOVER	%d%% Kans om TP terug te krijgen wanneer je wordt geraakt	SA
TOOLTIP_APPLY_DODGE	Kans om Pijlen te ontwijken %d%% 	SA
TOOLTIP_APPLY_ENCHANT_DARK	Kracht van Duisternis +%d%%	SA
TOOLTIP_APPLY_ENCHANT_DARK2	Kracht van Duisternis +%d%% - +%d%%
TOOLTIP_APPLY_ENCHANT_EARTH	Kracht van Aarde +%d%%	SA
TOOLTIP_APPLY_ENCHANT_EARTH2	Kracht van Aarde +%d%% - +%d%%
TOOLTIP_APPLY_ENCHANT_ELECT	Kracht van Bliksem +%d%%	SA
TOOLTIP_APPLY_ENCHANT_ELECT2	Kracht van Bliksem +%d%% - +%d%%
TOOLTIP_APPLY_ENCHANT_FIRE	Kracht van Vuur +%d%%	SA
TOOLTIP_APPLY_ENCHANT_FIRE2	Kracht van Vuur +%d%% - +%d%%
TOOLTIP_APPLY_ENCHANT_ICE	Kracht van IJs +%d%%	SA
TOOLTIP_APPLY_ENCHANT_ICE2	Kracht van IJs +%d%% - +%d%%
TOOLTIP_APPLY_ENCHANT_WIND	Kracht van de Wind +%d%%	SA
TOOLTIP_APPLY_ENCHANT_WIND2	Kracht van de Wind +%d%% - +%d%%
TOOLTIP_APPLY_EXP_DOUBLE_BONUS	%d%% Kans op ERV Bonus	SA
TOOLTIP_APPLY_GOLD_DOUBLE_BONUS	%d%% Kans om dubbele Yang te laten vallen	SA
TOOLTIP_APPLY_IMMUNE_FALL	Immuun tegen neervallen	SNA
TOOLTIP_APPLY_IMMUNE_SLOW	Verdediging tegen langzaam maken	SNA
TOOLTIP_APPLY_IMMUNE_STUN	Verdediging tegen blackouts	SNA
TOOLTIP_APPLY_ITEM_DROP_BONUS	%d%% Kans om dubbel zo veel Voorwerpen te laten vallen	SA
TOOLTIP_APPLY_KILL_HP_RECOVER	%d%% Kans om LP te herstellen	SA
TOOLTIP_APPLY_KILL_SP_RECOVER	%d%% Kans om TP te herstellen	SA
TOOLTIP_APPLY_MANA_BURN_PCT	%d%% Kans om de TP van de vijand te nemen	SA
TOOLTIP_APPLY_MAX_HP_PCT	Max. LP +%d%%	SA
TOOLTIP_APPLY_MAX_SP_PCT	Max. TP +%d%%	SA
TOOLTIP_APPLY_NOAFFECT	Geen effect	
TOOLTIP_APPLY_NO_DEATH_PENALTY	Er zullen geen ervaringspunten verloren gaan wanneer je karakter tot leven is gewekt op de plek van zijn dood	SNA
TOOLTIP_APPLY_NO_DEATH_PENALTY_PLUS	De Draken God neemt je onder zijn beschermende vleugels. Als je opnieuw tot leven gewekt wordt aan boord, verlies je geen ervaringspunten.	SNA
TOOLTIP_APPLY_PENETRATE_PCT	%d%% Kans op Penetrerende Schoten	SA
TOOLTIP_APPLY_POISON_PCT	Vergiftigings Kans: %d%%	SA
TOOLTIP_APPLY_POISON_REDUCE	Vergif Weerstand: %d%% 	SA
TOOLTIP_APPLY_POTION_BONUS	Brouwsel %d%% effect verhoging	SA
TOOLTIP_APPLY_REFLECT_CURSE	Kans om vloek te weerkaatsen: %d%% 	SA
TOOLTIP_APPLY_REFLECT_MELEE	%d%% Kans om directe lichaam slag te weerkaatsen	SA
TOOLTIP_APPLY_RESIST_ASSASSIN	Verdedigings kans tegen Ninja aanvallen: %d%% 	SA
TOOLTIP_APPLY_RESIST_BELL	Bel Verdediging %d%% 	SA
TOOLTIP_APPLY_RESIST_CLAW	Klauwverdediging +%d%%	SA
TOOLTIP_APPLY_RESIST_DAGGER	Mes Verdediging %d%% 	SA
TOOLTIP_APPLY_RESIST_FAN	Waaier Verdediging %d%% 	SA
TOOLTIP_APPLY_RESIST_HUMAN	Weerstand tegen Halfmensen %d%%	SA
TOOLTIP_APPLY_RESIST_MOUNT_FALL	Valweerstand +%d%%	SA
TOOLTIP_APPLY_RESIST_SHAMAN	Verdedigings Kans tegen Sjamaam aanvallen: %d%% 	SA
TOOLTIP_APPLY_RESIST_SURA	Verdedigings Kans tegen Sura aanvallen: %d%% 	SA
TOOLTIP_APPLY_RESIST_SWORD	Zwaard Verdediging %d%% 	SA
TOOLTIP_APPLY_RESIST_TWOHAND	Twee-Handig Verdediging %d%% 	SA
TOOLTIP_APPLY_RESIST_WARRIOR	Verdediging Kans tegen Krijger aanvallen: %d%% 	SA
TOOLTIP_APPLY_RESIST_WIND	Wind Weerstand %d%% 	SA
TOOLTIP_APPLY_RESIST_WOLFMAN	Verdedigingskans tegen Lycaan Aanvallen + %d%%	SA
TOOLTIP_APPLY_SKILL_BOOK_BONUS	Kans om van boeken te leren verhoogd met factor 2.5	SNA
TOOLTIP_APPLY_SKILL_BOOK_NO_DELAY	Als leren faalt wordt de Gemene Geest Vloek opgeheven.	SNA
TOOLTIP_APPLY_SLOW_PCT	Langzaam maken Kans: %d%%	SA
TOOLTIP_APPLY_STEAL_HP	%d%% Schade zal geabsorbeerd worden door LP.	SA
TOOLTIP_APPLY_STEAL_SP	%d%% Schade zal geabsorbeerd worden door TP	SA
TOOLTIP_APPLY_STUN_PCT	Kans op Blackout: %d%%	SA
TOOLTIP_ARMOR	Pantser	
TOOLTIP_ARROW	Pijl	
TOOLTIP_ASSASSIN	Ninja	
TOOLTIP_ATTBONUS_STONE	+%d%% kracht tegen Metin stenen	SA
TOOLTIP_ATT_GRADE	Aanvals waarde +%d	SA
TOOLTIP_ATT_SPEED	Aanvals Snelheid +%d	SA
TOOLTIP_ATT_SPEED_SLOW	Aanvalssnelheid verminderd	SNA
TOOLTIP_AUTO_POTION_HP	Zon Elixer
TOOLTIP_AUTO_POTION_REST	Resterend: %.2f%%
TOOLTIP_AUTO_POTION_SP	Maan Elixer
TOOLTIP_AUTO_POTION_USING	Actief
TOOLTIP_AUTO_SYSTEM_PRIMIUM	Auto-Jacht	SNA
TOOLTIP_BATTLE_POTION	Strijd Zone Gevechtsdrankje	SNA
TOOLTIP_BOW_DISTANCE	Boog Bereik +%dm	SA
TOOLTIP_BUYPRICE	Prijs: %s	
TOOLTIP_CAST_SPEED	Spreuksnelheid: +%d%%	SA
TOOLTIP_CON	Vitaliteit +%d	SA
TOOLTIP_COSTUME_ATTR_BONUS	Kostuum bonus %d%%	SA
TOOLTIP_DAMAGE_HP_RECOVERY	Absorbeert %d%% schade als LP	SA
TOOLTIP_DAMAGE_SP_RECOVERY	Absorbeert %d%% schade als TP	SA
TOOLTIP_DEF_GRADE	Verdediging +%d	SA
TOOLTIP_DEX	Behendigheid +%d	SA
TOOLTIP_DRAGON_SOUL_DECK1	Lucht	SNA
TOOLTIP_DRAGON_SOUL_DECK2	Aarde	SNA
TOOLTIP_DS_SET	DSS Set Effect	SNA
TOOLTIP_EAR	Oorbel	
TOOLTIP_ENERGY	Energie %d	SA
TOOLTIP_ETC	En zo voorts	
TOOLTIP_EXP_BONUS_EVENT	ERV +%d%%	SA
TOOLTIP_FIFTH_ATTRIBUTE_BONUS	5de bonus +%d%%	SA
TOOLTIP_FIRST_ATTRIBUTE_BONUS	1ste bonus +%d%%	SA
TOOLTIP_FISHINGROD_EXP	Punten  %d / %d	
TOOLTIP_FISHINGROD_LEVEL	Level: %d	
TOOLTIP_FISHINGROD_UPGRADE1	Geef het aan de Visser
TOOLTIP_FISHINGROD_UPGRADE2	om een betere
TOOLTIP_FISHINGROD_UPGRADE3	Vis Hengel te krijgen.
TOOLTIP_FISH_LEN	Lengte: %.2fcm	
TOOLTIP_FOURTH_ATTRIBUTE_BONUS	4de bonus +%d%%	SA
TOOLTIP_GUILD_SKILL_ACCEL	Versnelling +%d	SA
TOOLTIP_GUILD_SKILL_BLESS	Zegening van de Draken God +%d	SA
TOOLTIP_GUILD_SKILL_BLOOD	Bloed van de Draken God +%d	SA
TOOLTIP_GUILD_SKILL_BUNNO	Wraak van de Draken God +%d%%	SA
TOOLTIP_GUILD_SKILL_JUMUN	Tover Hulp +%d%%	SA
TOOLTIP_GUILD_SKILL_SEONGHWI	Heilig Pantser +%d	SA
TOOLTIP_HALLOWEEN_EVENT_BUFF	+20% ERV | +5% item drops | +10% kracht tegen monsters	SNA
TOOLTIP_HELMET	Helm	
TOOLTIP_HIT_BUFF_ENCHANT_DARK	Ontvang Kracht van Duisternis gedurende %d sec. tijdens een gevecht	SA
TOOLTIP_HIT_BUFF_ENCHANT_EARTH	Ontvang Kracht van Aarde gedurende %d sec. tijdens een gevecht	SA
TOOLTIP_HIT_BUFF_ENCHANT_ELEC	Ontvang Kracht van Bliksem gedurende %d sec. tijdens een gevecht	SA
TOOLTIP_HIT_BUFF_ENCHANT_FIRE	Ontvang Kracht van Vuur gedurende %d sec. tijdens een gevecht	SA
TOOLTIP_HIT_BUFF_ENCHANT_ICE	Ontvang Kracht van IJs gedurende %d sec. tijdens een gevecht	SA
TOOLTIP_HIT_BUFF_ENCHANT_WIND	Ontvang Kracht van Wind gedurende %d sec. tijdens een gevecht	SA
TOOLTIP_HIT_BUFF_RESIST_DARK	Ontvang Duisternis Weerstand gedurende %d sec. tijdens een gevecht	SA
TOOLTIP_HIT_BUFF_RESIST_EARTH	Ontvang Aarde Weerstand gedurende %d sec. tijdens een gevecht	SA
TOOLTIP_HIT_BUFF_RESIST_ELEC	Ontvang Bliksem Weerstand gedurende %d sec. tijdens een gevecht	SA
TOOLTIP_HIT_BUFF_RESIST_FIRE	Ontvang Vuur Weerstand gedurende %d sec. tijdens een gevecht	SA
TOOLTIP_HIT_BUFF_RESIST_ICE	Ontvang IJs Weerstand gedurende %d sec. tijdens een gevecht	SA
TOOLTIP_HIT_BUFF_RESIST_WIND	Ontvang Wind Weerstand gedurende %d sec. tijdens een gevecht	SA
TOOLTIP_HP_REGEN	LP Regeneratie +%d%%	SA
TOOLTIP_INT	Intelligentie +%d	SA
TOOLTIP_ITEM_ATT_GRADE	Aanvals Waarde %d	
TOOLTIP_ITEM_ATT_POWER	Aanvals Waarde %d - %d	
TOOLTIP_ITEM_ATT_POWER_ONE_ARG	Aanvals Waarde %d	
TOOLTIP_ITEM_ATT_POWER_REFINE	Aanvals Waarde %d - %d (+%d)	
TOOLTIP_ITEM_ATT_SPEED	Aanvals Snelheid %s	
TOOLTIP_ITEM_DEF_GRADE	Verdediging %d	
TOOLTIP_ITEM_FAST	Snel	
TOOLTIP_ITEM_LIMIT_CON	Vitaliteits bovengrens: %d
TOOLTIP_ITEM_LIMIT_DEX	Behendigheids bovengrens: %d
TOOLTIP_ITEM_LIMIT_INT	Intelligentie Boven Limiet: %d	
TOOLTIP_ITEM_LIMIT_LEVEL	Van Level: %d	
TOOLTIP_ITEM_LIMIT_STR	Kracht Boven Limiet: %d	
TOOLTIP_ITEM_MAGIC_ATT_POWER	Magische Aanvals Waarde %d - %d	
TOOLTIP_ITEM_MAGIC_ATT_POWER_ONE_ARG	Magische Aanvals Waarde %d	
TOOLTIP_ITEM_MAGIC_DEF_POWER	Magische Verdediging %d	
TOOLTIP_ITEM_NORMAL	Normaal	
TOOLTIP_ITEM_SLOW	Langzaam	
TOOLTIP_ITEM_VERY_FAST	Heel snel	
TOOLTIP_ITEM_VERY_SLOW	Heel langzaam	
TOOLTIP_ITEM_WEARABLE_JOB	[ Draagbaar ]	
TOOLTIP_LOTTERY_STEP_NUMBER	%d	
TOOLTIP_LOTTO_NUMBER	Geluks Nummer: %d	
TOOLTIP_MAGIC_ATTBONUS_PER	Magische aanval +%d%%	SA
TOOLTIP_MAGIC_ATT_GRADE	Magische Aanvals Waarde +%d	SA
TOOLTIP_MAGIC_DEF_GRADE	Magische Verdediging +%d	SA
TOOLTIP_MALL_ATTBONUS	Aanvals Waarde +%d%%	SA
TOOLTIP_MALL_ATTBONUS_STATIC	Aanvalswaarde	SNA
TOOLTIP_MALL_AUTOLOOT	Een hand die automatisch gevallen Yang opraapt.	SNA
TOOLTIP_MALL_DEFBONUS	Verdediging +%d%%	SA
TOOLTIP_MALL_DEFBONUS_STATIC	Verdediging 	SNA
TOOLTIP_MALL_EXPBONUS	ERV +%d%%	SA
TOOLTIP_MALL_EXPBONUS_P_STATIC	iCafe ERV Bonus +%d%%	SA
TOOLTIP_MALL_EXPBONUS_STATIC	Verhoogt ontvangen ERV met 50%	SNA
TOOLTIP_MALL_FISH_MIND	Je kans om een zeldzame vis te vangen is verdubbeld.	SNA
TOOLTIP_MALL_GOLDBONUS	Kans om Yang buit te maken verhoogd met %d%%	SA
TOOLTIP_MALL_GOLDBONUS_STATIC	Dubbele Yang drop-kans	SNA
TOOLTIP_MALL_ITEMBONUS	Kans om items buit te maken verhoogd met %d%%	SA
TOOLTIP_MALL_ITEMBONUS_P_STATIC	iCafe Kans op buitmaken van items plus %.1f%%	SA
TOOLTIP_MALL_ITEMBONUS_STATIC	Item drop-kans verhoogt met 200%.	SNA
TOOLTIP_MALL_MARRIAGE_FAST	Liefdespunten verhogen sneller.	SNA
TOOLTIP_MALL_SAFEBOX	Je opslag krijgt 2 opslag ruimtes	SNA
TOOLTIP_MAX_HP	Max. LP +%d	SA
TOOLTIP_MAX_HP_PCT	Max. LP +%d%%	SA
TOOLTIP_MAX_SP	Max. TP +%d	SA
TOOLTIP_MAX_SP_PCT	Max. TP +%d%%	SA
TOOLTIP_MAX_STAMINA	Max. Uithoudingsvermogen +%d	SA
TOOLTIP_MELEE_MAGIC_ATTBONUS_PER	Magische/fysieke aanval +%d%%	SA
TOOLTIP_MEMORIZED_POSITION	%s(%d, %d)	
TOOLTIP_MEMORIZED_POSITION_ERROR	GPS ERROR(%d, %d)	
TOOLTIP_MORE_THEN_HP90_DAMAGE_REDUCE	Ontvangen schade wordt verminderd met %d%% als je +90%% LP hebt	SA
TOOLTIP_MOV_SPEED	Beweeg Snelheid %d%%	SA
TOOLTIP_NECK	Ketting	
TOOLTIP_NEED_ALL_SP	Benodigde TP: Max.	
TOOLTIP_NEED_GSP	Benodigde Drankengeest: %d
TOOLTIP_NEED_HP	Benodigde LP: %d	
TOOLTIP_NEED_HP_PER_SEC	LP / Sec.: %d
TOOLTIP_NEED_SKILL_POINT	Benodigde vaardigheidspunten:	
TOOLTIP_NEED_SP	Benodigde TP: %d	
TOOLTIP_NEED_SP_PER_SEC	TP / Sec.: %d
TOOLTIP_NEXT_SKILL_LEVEL_1	Volgende Level: %d (Max. %d)	
TOOLTIP_NEXT_SKILL_LEVEL_2	Volgende Level: %d (Max. %d-%d)	
TOOLTIP_NORMAL_DAMAGE_GUARD	%d%% kans om aanvalsschade te blokkeren	SA
TOOLTIP_NORMAL_HIT_DAMAGE_BONUS	Gemiddelde Schade %d%%	SA
TOOLTIP_NORMAL_HIT_DAMAGE_BONUS_BOSS_OR_MORE	+%d%% aanvalsschade tegen bazen	SA
TOOLTIP_NORMAL_HIT_DEFEND_BONUS	Gemiddelde Schade Weerstand %d%%	SA
TOOLTIP_NORMAL_HIT_DEFEND_BONUS_BOSS_OR_MORE	-%d%% aanvalsschade van bazen	SA
TOOLTIP_PARTY_INFO_GRADE_UP1	Meer dan %d Groeps leden.	
TOOLTIP_PARTY_INFO_GRADE_UP2	Aanvals Level +%d	
TOOLTIP_PARTY_INFO_GRADE_UP3	Verdedigings Level +%d	
TOOLTIP_PARTY_INFO_HEAL_18_LEVEL	Herstelet LP/TP voor alle Groepsleden voor 60 minuten.	
TOOLTIP_PARTY_INFO_HEAL_40_LEVEL	Herstelt LP/TP voor alle Groepsleden voor 30 minuten	
TOOLTIP_PARTY_INFO_RECALL_12_LEVEL	Je moet 3 minuten wachten na de dood van een groepslid.	
TOOLTIP_PARTY_INFO_RECALL_20_LEVEL	Je kunt Groepsleden die op dezelfde server zitten altijd roepen.	
TOOLTIP_PARTY_INFO_SET_ATTACKER	Aanvals Level +(Getal Groepsleden./2) Aanvaller %d kan gekozen worden.	
TOOLTIP_PARTY_INFO_SET_TANKER	Verdedigings Level +( Getal Groepsleden) Mesvechters 1 kan gekozen worden.	
TOOLTIP_PARTY_SKILL_LEVEL	Huidige Level: %d	
TOOLTIP_PARTY_TITLE_GRADE_UP	[Aanval/Verdediging geüpgrade]
TOOLTIP_PARTY_TITLE_HEAL	[herstel]
TOOLTIP_PARTY_TITLE_INFO_BONUS_EXP	Wanneer je meer dan %d Groepsleden hebt krijg je %d%% Bonus ERV.	
TOOLTIP_PARTY_TITLE_MEMBER_BONUS_EXP	[Bonus ERV]
TOOLTIP_PARTY_TITLE_RECALL	[Roep]	
TOOLTIP_PARTY_TITLE_SET_ATTACKER	[Benoem Aanvaller]	
TOOLTIP_PARTY_TITLE_SET_TANKER	[Benoem Mes Vechter]
TOOLTIP_PEPSI_EVENT	5% ERV-bonus en 5% hogere kans op buitmaken van items.	SNA
TOOLTIP_PICK_EXP	Punten: %d / %d	
TOOLTIP_PICK_LEVEL	Level: %d	
TOOLTIP_PICK_UPGRADE1	Geef het aan de Houthakker
TOOLTIP_PICK_UPGRADE2	om een
TOOLTIP_PICK_UPGRADE3	Pikhouweel.
TOOLTIP_POTION_CURE	Heel negative effecten.	
TOOLTIP_POTION_MIN	Min.	
TOOLTIP_POTION_PLUS_ATTACK_SPEED	Aanvals snelheid +%d
TOOLTIP_POTION_PLUS_ATTBONUS_MONSTER	ANV BONUS MONSTER: +%d%%
TOOLTIP_POTION_PLUS_ATT_POINT	ANV: +%d
TOOLTIP_POTION_PLUS_ATT_POINT_PER	ANV: +%d%%
TOOLTIP_POTION_PLUS_DEF_POINT	VER: +%d
TOOLTIP_POTION_PLUS_DEX_POINT	BEH: +%d
TOOLTIP_POTION_PLUS_EXP_BONUS	ERV: +%d%%
TOOLTIP_POTION_PLUS_HIT_DEFEND_POINT	SCHADE WEERSTAND: +%d%%
TOOLTIP_POTION_PLUS_HP_PERCENT	LP +%d%%
TOOLTIP_POTION_PLUS_HP_POINT	LP +%d
TOOLTIP_POTION_PLUS_MOVING_SPEED	Beweeg snelheid +%d
TOOLTIP_POTION_PLUS_RESIST_DARK	DUISTERNIS WEERSTAND: +%d%%
TOOLTIP_POTION_PLUS_RESIST_EARTH	AARDE WEERSTAND: +%d%%
TOOLTIP_POTION_PLUS_RESIST_ICE	IJS WEERSTAND: +%d%%
TOOLTIP_POTION_PLUS_RESIST_MAGIC	MAGIE WEERSTAND: +%d%%
TOOLTIP_POTION_PLUS_SP_PERCENT	TP +%d%%
TOOLTIP_POTION_PLUS_SP_POINT	TP +%d
TOOLTIP_POTION_PLUS_STR_POINT	KRA: +%d
TOOLTIP_POTION_SEC	Sec.	
TOOLTIP_POTION_TIME	Duratie:	
TOOLTIP_PVP_TOURNAMENT_ENTER	Deelnemen aan PvP Toernooi
TOOLTIP_PVP_TOURNAMENT_EXPBONUS	PvP Toernooi ERV +%d%%	SA
TOOLTIP_REQUIREMENT_21_LEVEL	Je moet Level 21 bereikt hebben.	
TOOLTIP_REQUIREMENT_41_LEVEL	Je moet Level 41 bereikt hebben.	
TOOLTIP_REQUIREMENT_LEVEL	Je moet Level %d bereikt hebben.	
TOOLTIP_REQUIREMENT_SKILL_LEVEL	%s Level %d nodig.	
TOOLTIP_REQUIREMENT_STAT_LEVEL	%s %d nodig	
TOOLTIP_RESIST_BOW	Pijlverdediging %d%%	SA
TOOLTIP_RESIST_DARK	Weerstand tegen duisternis +%d%%	SA
TOOLTIP_RESIST_EARTH	Aarde weerstand +%d%%	SA
TOOLTIP_RESIST_ELEC	Bliksem Weerstand %d%%	SA
TOOLTIP_RESIST_FIRE	Vuur Weerstand %d%%	SA
TOOLTIP_RESIST_ICE	IJsweerstand +%d%%	SA
TOOLTIP_RESIST_MAGIC	Magie Weerstand %d%%	SA
TOOLTIP_RESIST_MAGIC_REDUCTION	Magiepenetratie van %d%%	SA
TOOLTIP_REST_USABLE_COUNT	Over: %d	
TOOLTIP_SEALED	Zielsgebonden
TOOLTIP_SEASON_PVE_BUFF	Verhoogt PvE-schade met 80% gedurende 10 min.	SNA
TOOLTIP_SEASON_RANKING_BUFF	Verhoogt rangpunten met 20% gedurende 10 min.	SNA
TOOLTIP_SECOND_ATTRIBUTE_BONUS	2de bonus +%d%%	SA
TOOLTIP_SELLPRICE	Prijs: %s	
TOOLTIP_SET_ITEM	Set Bonus	SNA
TOOLTIP_SHAMAN	Sjamaan	
TOOLTIP_SHIELD	Schild	
TOOLTIP_SHOES	Shoenen	
TOOLTIP_SKILL	Vaardigheden	SNA
TOOLTIP_SKILLBOOK_NAME	Vaardigheden Boek	
TOOLTIP_SKILL_AFFECT_ATT_GRADE	Aanvals Waarde: +	
TOOLTIP_SKILL_AFFECT_ATT_POWER	Aanvals Waarde:	
TOOLTIP_SKILL_AFFECT_ATT_SPEED	Aanvals Snelheid: +	
TOOLTIP_SKILL_AFFECT_DEF_GRADE	Verdediging:	
TOOLTIP_SKILL_AFFECT_DODGE	Opponent Aanvals Waarde: -	
TOOLTIP_SKILL_AFFECT_HEAL	Herstel LP:	
TOOLTIP_SKILL_AFFECT_MOV_SPEED	Beweeg Snelheid: +	
TOOLTIP_SKILL_AFFECT_REFLECT_MELEE	Kans om fysieke aanvallen te weerkaatsen:
TOOLTIP_SKILL_AFFECT_RESIST_NORMAL	Weertand tegen Lichaam Schade:	
TOOLTIP_SKILL_COOL_TIME	Laadtijd: 
TOOLTIP_SKILL_DAMAGE_AMSEOP	Overval Schade +%d%%	SA
TOOLTIP_SKILL_DAMAGE_BIPABU	Vliegende Talisman Schade +%d%%	SA
TOOLTIP_SKILL_DAMAGE_BONUS	Vaardigheid Schade %d%%	SA
TOOLTIP_SKILL_DAMAGE_BONUS_BOSS_OR_MORE	+%d%% vaardighedenschade tegen bazen	SA
TOOLTIP_SKILL_DAMAGE_BYEURAK	Ontbied Bliksem Schade +%d%%	SA
TOOLTIP_SKILL_DAMAGE_CHAIN	Bliksem Klauw Schade +%d%%	SA
TOOLTIP_SKILL_DAMAGE_CHARYUN	Rollend Mes Schade +%d%%	SA
TOOLTIP_SKILL_DAMAGE_CHAYEOL	Verscheur Schade +%d%%	SA
TOOLTIP_SKILL_DAMAGE_GEOMPUNG	Zwaard Dreun Schade +%d%%	SA
TOOLTIP_SKILL_DAMAGE_GIGONGCHAM	Geest Slag (Z) Schade +%d%%	SA
TOOLTIP_SKILL_DAMAGE_GIGUNG	Gif Pijl Schade +%d%%	SA
TOOLTIP_SKILL_DAMAGE_GONGDAB	Wolf Stoot Schade +%d%%	SA
TOOLTIP_SKILL_DAMAGE_GUNGSIN	Snelle Aanval Schade +%d%%	SA
TOOLTIP_SKILL_DAMAGE_GYOKSAN	Duw Schade +%d%%	SA
TOOLTIP_SKILL_DAMAGE_HWAJO	Vuur Pijl Schade +%d%%	SA
TOOLTIP_SKILL_DAMAGE_HWAYEOMPOK	Vlam Slag Schade +%d%%	SA
TOOLTIP_SKILL_DAMAGE_KWANKYEOK	Pijlen Regen Schade +%d%%	SA
TOOLTIP_SKILL_DAMAGE_MAHWAN	Donkere Orb Schade +%d%%	SA
TOOLTIP_SKILL_DAMAGE_MARYUNG	Donker Slag Schade +%d%%	SA
TOOLTIP_SKILL_DAMAGE_NOEJEON	Gooi Bliksem Schade +%d%%	SA
TOOLTIP_SKILL_DAMAGE_PABEOB	Opheffing Schade +%d%%	SA
TOOLTIP_SKILL_DAMAGE_PAERYONG	Draken Brul Schade +%d%%	SA
TOOLTIP_SKILL_DAMAGE_PALBANG	Zwaard Wervel +%d%%	SA
TOOLTIP_SKILL_DAMAGE_PASWAE	Wolvenklauw Schade +%d%%	SA
TOOLTIP_SKILL_DAMAGE_SALPOONG	Wolvenadem Schade +%d%%	SA
TOOLTIP_SKILL_DAMAGE_SAMYEON	Drieweg Snede Schade +%d%%	SA
TOOLTIP_SKILL_DAMAGE_SANGONG	Gif Wolk Schade +%d%%	SA
TOOLTIP_SKILL_DAMAGE_SWAERYUNG	Vinger Slag Schade +%d%%	SA
TOOLTIP_SKILL_DAMAGE_TANHWAN	Stoten Schade +%d%%	SA
TOOLTIP_SKILL_DAMAGE_YEONSA	Herhalend Schot Schade +%d%%	SA
TOOLTIP_SKILL_DAMAGE_YONGBI	Schietende Draak Schade +%d%%	SA
TOOLTIP_SKILL_DAMAGE_YONGKWON	Draken Wervel Schade +%d%%	SA
TOOLTIP_SKILL_DEFEND_BONUS	Weerstand tegen Vaardigheden Schade %d%%	SA
TOOLTIP_SKILL_DEFEND_BONUS_BOSS_OR_MORE	-%d%% vaardighedenschade van bazen	SA
TOOLTIP_SKILL_DURATION	Duur: %d sec.
TOOLTIP_SKILL_DURATION_INCREASE_EUNHYUNG	Verborgenheid Duur +%d sec.	SA
TOOLTIP_SKILL_DURATION_INCREASE_GEOMKYUNG	Aura van het Zwaard Duur +%d sec.	SA
TOOLTIP_SKILL_DURATION_INCREASE_GYEONGGONG	Vederlicht Lopen Duur +%d sec.	SA
TOOLTIP_SKILL_DURATION_INCREASE_JEOKRANG	Bloedrode Wolf Ziel Duur +%d sec.	SA
TOOLTIP_SKILL_FORGET_BOOK_NAME	Boek der Vergetelheid	
TOOLTIP_SKILL_LEVEL	Huidige Level: %d	
TOOLTIP_SKILL_LEVEL_MASTER	Huidige Level: %d (Meester)	
TOOLTIP_SKILL_LEVEL_WITH_MAX	Huidige Level: %d (Max. %d)	
TOOLTIP_SOCKET_EMPTY	Leeg	
TOOLTIP_SOCKET_REFINABLE_ITEM	[Voorwerp met een fitting]
TOOLTIP_SP_REGEN	TP Regeneratie +%d%%	SA
TOOLTIP_STR	Kracht +%d	SA
TOOLTIP_SURA	Sura	
TOOLTIP_THIRD_ATTRIBUTE_BONUS	3de bonus +%d%%	SA
TOOLTIP_TIME_CHARGER_FIX	Tijdopladen %d sec.	SA
TOOLTIP_TIME_CHARGER_PER	Tijd opladen %d%%	SA
TOOLTIP_UNIQUE	Uniek	
TOOLTIP_UNSEAL_LEFT_TIME	Verwijdering van zielsgebonden over: %du %dm
TOOLTIP_USE_SKILL_AMSEOP_HP_ABSORB	Absorbeert %d%% LP met Hinderlaag	SA
TOOLTIP_USE_SKILL_BIPABU_NEXT_COOLTIME_DECREASE_10PER	Vliegende Talisman Afkoelperiode: -%d sec. met 10%% kans	SA
TOOLTIP_USE_SKILL_BIPABU_NEXT_COOLTIME_DECREASE_20PER	Vliegende Talisman Afkoelperiode: -%d sec. met 20%% kans	SA
TOOLTIP_USE_SKILL_BYEURAK_HP_ABSORB	Absorbeert tot %d%% LP met Ontbied Bliksem	SA
TOOLTIP_USE_SKILL_CHAIN_HP_ABSORB	Absorbeert %d%% LP met Bliksem Klauw	SA
TOOLTIP_USE_SKILL_CHARYUN_STUN	%d%% overdonderkans met Draaiend Mes	SA
TOOLTIP_USE_SKILL_CHAYEOL_CRITICAL_PCT	Verhoogde kans op kritieke aanvallen gedurende %d sec. met Verscheur	SA
TOOLTIP_USE_SKILL_CHAYEOL_HP_ABSORB	Absorbeert %d%% LP met Verscheur	SA
TOOLTIP_USE_SKILL_CHEONGRANG_CASTING_SPEED	Verhoogde spreuksnelheid gedurende %d sec. met Indigo Wolf Ziel	SA
TOOLTIP_USE_SKILL_CHEONGRANG_MOV_SPEED	Verhoogde bewegingssnelheid gedurende %d sec. met Indigo Wolf Ziel	SA
TOOLTIP_USE_SKILL_CHUNKEON_CASTING_SPEED	Verhoogde spreuksnelheid gedurende %d sec. met Sterk Lichaam	SA
TOOLTIP_USE_SKILL_GEOMPUNG_NEXT_COOLTIME_DECREASE_10PER	Zwaard Dreun Afkoelperiode: -%d sec. met 10%% kans	SA
TOOLTIP_USE_SKILL_GEOMPUNG_NEXT_COOLTIME_DECREASE_20PER	Zwaard Dreun Afkoelperiode: -%d sec. met 20%% kans	SA
TOOLTIP_USE_SKILL_GICHEON_ATT_GRADE_BONUS	Aanvalsbonus gedurende %d sec. met Draken Hulp	SA
TOOLTIP_USE_SKILL_GIGONGCHAM_STUN	%d%% overdonderkans met Geest Slag (Z)	SA
TOOLTIP_USE_SKILL_GIGUNG_ATT_GRADE_BONUS	Aanvalsbonus gedurende %d sec. met Gif Pijl	SA
TOOLTIP_USE_SKILL_GIHYEOL_ATT_GRADE_BONUS	Aanvalsbonus gedurende %d sec. met Levenskracht	SA
TOOLTIP_USE_SKILL_GONGDAB_KNOCKBACK	%d%% terugslagkans met Wolf Stoot	SA
TOOLTIP_USE_SKILL_GONGDAB_STUN	%d%% overdonderkans met Wolf Stoot	SA
TOOLTIP_USE_SKILL_GUNGSIN_NEXT_COOLTIME_DECREASE_10PER	Snelle Aanval Afkoelperiode: -%d sec. met 10%% kans	SA
TOOLTIP_USE_SKILL_GUNGSIN_NEXT_COOLTIME_DECREASE_20PER	Snelle Aanval Afkoelperiode: -%d sec. met 20%% kans	SA
TOOLTIP_USE_SKILL_GWIGEOM_DEF_BONUS	Verdedigingsbonus gedurende %d sec. met Betoverd Mes	SA
TOOLTIP_USE_SKILL_GYOKSAN_KNOCKBACK	%d%% terugslagkans met Duw	SA
TOOLTIP_USE_SKILL_HOSIN_DEF_BONUS	Verdedigingsbonus gedurende %d sec. met Zegening	SA
TOOLTIP_USE_SKILL_HWAYEOMPOK_KNOCKBACK	%d%% terugslagkans met Vlam Slag	SA
TOOLTIP_USE_SKILL_JEOKRANG_DEF_BONUS	Verdedigingsbonus gedurende %d sec. met Bloedrode Wolf Ziel	SA
TOOLTIP_USE_SKILL_JEONGEOP_ATT_GRADE_BONUS	Aanvalsbonus gedurende %d sec. met Genezen	SA
TOOLTIP_USE_SKILL_JEUNGRYEOK_DEF_BONUS	Verdedigingsbonus gedurende %d sec. met Aanval Omhoog	SA
TOOLTIP_USE_SKILL_KWANKYEOK_KNOCKBACK	%d%% terugslagkans met Pijlen Regen	SA
TOOLTIP_USE_SKILL_KWANKYEOK_NEXT_COOLTIME_DECREASE_10PER	Pijlen Regen Afkoelperiode: -%d sec. met 10%% kans	SA
TOOLTIP_USE_SKILL_KWANKYEOK_NEXT_COOLTIME_DECREASE_20PER	Pijlen Regen Afkoelperiode: -%d sec. met 20%% kans	SA
TOOLTIP_USE_SKILL_MAHWAN_STUN	%d%% overdonderkans met Donkere Orb	SA
TOOLTIP_USE_SKILL_MANASHILED_CASTING_SPEED	Verhoogde spreuksnelheid gedurende %d sec. met Donkere Bescherming	SA
TOOLTIP_USE_SKILL_MARYUNG_NEXT_COOLTIME_DECREASE_10PER	Donker Slag Afkoelperiode: -%d sec. met 10%% kans	SA
TOOLTIP_USE_SKILL_MARYUNG_NEXT_COOLTIME_DECREASE_20PER	Donker Slag Afkoelperiode: -%d sec. met 20%% kans	SA
TOOLTIP_USE_SKILL_MUYEONG_ATT_GRADE_BONUS	Aanvalsbonus gedurende %d sec. met Vlam Geest	SA
TOOLTIP_USE_SKILL_NOEGEOM_ATT_GRADE_BONUS	Aanvalsbonus gedurende %d sec. met Zwaard Orb	SA
TOOLTIP_USE_SKILL_NOEJEON_NEXT_COOLTIME_DECREASE_10PER	Bliksem Gooi Afkoelperiode: -%d sec. met 10%% kans	SA
TOOLTIP_USE_SKILL_NOEJEON_NEXT_COOLTIME_DECREASE_20PER	Bliksem Gooi Afkoelperiode: -%d sec. met 20%% kans	SA
TOOLTIP_USE_SKILL_PABEOB_STUN	%d%% overdonderkans met Opheffing	SA
TOOLTIP_USE_SKILL_PAERYONG_HP_ABSORB	Absorbeert %d%% LP met Draken Brul	SA
TOOLTIP_USE_SKILL_PALBANG_HP_ABSORB	Absorbeert %d%% LP met Zwaard Wervel	SA
TOOLTIP_USE_SKILL_PASWAE_NEXT_COOLTIME_DECREASE_10PER	Wolvenklauw Afkoelperiode: -%d sec. met 10%% kans	SA
TOOLTIP_USE_SKILL_PASWAE_NEXT_COOLTIME_DECREASE_20PER	Wolvenklauw Afkoelperiode: -%d sec. met 20%% kans	SA
TOOLTIP_USE_SKILL_PASWAE_SP_ABSORB	Absorbeert %d%% TP met Wolvenklauw	SA
TOOLTIP_USE_SKILL_SALPOONG_NEXT_COOLTIME_DECREASE_10PER	Wolvenadem Afkoelperiode: -%d sec. met 10%% kans	SA
TOOLTIP_USE_SKILL_SALPOONG_NEXT_COOLTIME_DECREASE_20PER	Wolvenadem Afkoelperiode: -%d sec. met 20%% kans	SA
TOOLTIP_USE_SKILL_SAMYEON_NEXT_COOLTIME_DECREASE_10PER	Drieweg Snede Afkoelperiode: -%d sec. met 10%% kans	SA
TOOLTIP_USE_SKILL_SAMYEON_NEXT_COOLTIME_DECREASE_20PER	Drieweg Snede Afkoelperiode: -%d sec. met 20%% kans	SA
TOOLTIP_USE_SKILL_SAMYEON_STUN	%d%% overdonderkans met Drieweg Snede	SA
TOOLTIP_USE_SKILL_SANGONG_ATT_GRADE_BONUS	Aanvalsbonus gedurende %d sec. met Gif Wolk	SA
TOOLTIP_USE_SKILL_SEOMJEON_KNOCKBACK	%d%% terugslagkans met Verraderlijk Gif	SA
TOOLTIP_USE_SKILL_SWAERYUNG_KNOCKBACK	%d%% terugslagkans met Vinger Slag	SA
TOOLTIP_USE_SKILL_TERROR_ATT_GRADE_BONUS	Aanvalsbonus gedurende %d sec. met Angst	SA
TOOLTIP_USE_SKILL_TUSOK_HP_ABSORB	Absorbeert %d%% LP met Geest Slag (K)	SA
TOOLTIP_USE_SKILL_YEONSA_HP_ABSORB	Absorbeert %d%% LP met Herhalend Schot	SA
TOOLTIP_USE_SKILL_YONGBI_HP_ABSORB	Absorbeert %d%% LP met Schietende Draak	SA
TOOLTIP_USE_SKILL_YONGKWON_NEXT_COOLTIME_DECREASE_10PER	Draken Wervel Afkoelperiode: -%d sec. met 10%% kans	SA
TOOLTIP_USE_SKILL_YONGKWON_NEXT_COOLTIME_DECREASE_20PER	Draken Wervel Afkoelperiode: -%d sec. met 20%% kans	SA
TOOLTIP_WARRIOR	Krijger	
TOOLTIP_WEAPON	Wapen	
TOOLTIP_WOLFMAN	Lycaan
TOOLTIP_WRISTLET	Armband
UI_ACCEPT	Accepteer	
UI_BOLD_FONT	Tahoma:12b
UI_CANCEL	Annuleer	
UI_CLOSE	Sluit	
UI_DEF_FONT	Tahoma:12
UI_DEF_FONT_LARGE	Tahoma:14
UI_DEF_FONT_SMALL	Tahoma:9
UI_DENY	Afwijzen	
UI_ITEM	Voorwerp	
UI_LEFT_TIME	Resterende Tijd: %d Sec.	
UI_NEXT	Doorgaan	
UI_NEXTPAGE	Volgende
UI_NOCONTENTS	Geen Inhoud	
UI_NONAME	Geen Naam	
UI_OK	OK	
UI_POS_UNKNOWN	Onbekende Plek	
UI_PREVPAGE	terug
UI_UNKNOWN	Onbekend	
UNLIMIT_ENTER_CZ_QUESTION	Je mag de Zodiac Tempel %d min. binnengaan. Wil je het gebruiken?
UPDATE_TIME	Datum
UPLOAD_MARK_CHECK_NEED_RECONNECT	De upload moet opnieuw gestart worden.	
UPLOAD_MARK_UPLOAD_NEED_RECONNECT	De upload moet opnieuw gestart worden.	
USE_ITEM_BUTTON_01	Nu terugkeren
USE_ITEM_BUTTON_02	Betreden
USE_ITEM_FAILURE_PRIVATE_SHOP	Je kunt voorwerpen niet gebruiken terwijl je privé Warenhuis open is.
USE_ITEM_POPUP_01	De Slag om de Vijf Altaren is voorbij. \n Volgende slag:
USE_ITEM_QUESTION_01	Wil je meedoen aan de Slag om de Vijf Altaren?
USE_ITEM_QUESTION_02	Wil je terugkeren naar de plek waar je gestorven bent?\nDat kost %s Yang.
USE_ITEM_QUESTION_03	Je wordt geteleporteerd naar een willekeurige locatie. Wil je binnengaan?
USE_SKILL_ERROR_UNKNOWN	Onbekend Vaardigheids Error: %s	
