ACCEPT	OK
ACCE_ABSORB	Absorção Bónus
ACCE_COMBINE	Combinação
ACCE_MAIN	Faixa 1
ACCE_RESULT	Resultado
ACCE_SERVE	Faixa 2
ATTACH_METIN_INFO	Queres usar a Pedra Espírita?
ATTACH_METIN_TITLE	Usar Pedra Espírita
ATTENDANCE_TITLE	Evento Ceifador de Bosses
ATTR_67_ADD	Adicionar Bónus
ATTR_67_ADD_TITLE	Adicionar Bónus
ATTR_67_MATERIAL_SLOT_TITLE	Lascas do Poder
ATTR_67_REGIST_SLOT_TITLE	Item Destino
ATTR_67_SUPPORT_SLOT_TITLE	Aditivo
AURA_MAIN	Roupa da Aura
AURA_SUB	Material
AUTO_AUTO_ATTACK	Ataque
AUTO_AUTO_POSITION	Poções
AUTO_AUTO_RANGE	Foco
AUTO_AUTO_SKILL	Habilidades
AUTO_CLEAR	Limpar
AUTO_END	Parar
AUTO_OFF	Off
AUTO_ON	On
AUTO_POSITION_SETTING	Poções
AUTO_SAVE	Gravar
AUTO_SETTING	Definições
AUTO_SKILL_SETTING	Habilidades
AUTO_START	Iniciar
AUTO_TITLE	Auto-Caça
BANNER_ATTENDANCE_BUTTON	Evento Ceifador de Bosses
BANNER_BLACK_AND_WHITE_BUTTON	Duelo dos Videntes
BANNER_CATCHKING_BUTTON	Apanha o Rei
BANNER_EASTER_BUTTON	PÁSCOA
BANNER_FISH_BUTTON	PUZZLE DE PESCA
BANNER_FLOWER_BUTTON	PODER DAS FLORES
BANNER_FOOTBALL_BUTTON	FUTEBOL
BANNER_HALLOWEEN_BUTTON	HALLOWEEN
BANNER_LUCKY_EVENT	ESPANCA-MONSTROS
BANNER_MINIBOSS_BUTTON	Apocalipse do Zodíaco
BANNER_MINI_GAME_FINDM	MEMO TRIO DE MONSTROS
BANNER_MONSTERBACK_BUTTON	Usar Golpes
BANNER_MYSTERY_BOX_BUTTON	EVENTO DE ESPÓLIOS I
BANNER_MYSTERY_BOX_BUTTON_2	EVENTO DE ESPÓLIOS II
BANNER_NEW_XMAS_BUTTON	NATAL
BANNER_OKEY_BUTTON	Evento Okey
BANNER_OLYMPIC_BUTTON	EVENTO DE HERÓI
BANNER_RAMADAN_BUTTON	RAMADÃO
BANNER_ROULETTE_BUTTON	Ritual do Sangue
BANNER_SOUL_BUTTON	EVENTO DA ALMA
BANNER_SUMMER_BUTTON	EVENTO DE VERÃO
BANNER_VALENTINE_BUTTON	DIA DE SÃO VALENTIM
BANNER_YUTNORI_BUTTON	Yut Nori
BATTLE_FIELD_INFO	Zona de Combate
BATTLE_FIELD_OPERATION_TIME	É possível entrar nas Zonas de Combate entre as %s:00 e as %s:00.
BATTLE_FIELD_OPERATION_TIME_ALL	Actualmente aberta a entradas.
BATTLE_FIELD_OPERATION_TIME_END	Zona de Combate ainda aberta durante %s horas.
BATTLE_FIELD_OPERATION_TIME_NA	Actualmente encerrada para entradas.
BATTLE_FIELD_OPERATION_TIME_OPEN	Aberta a entradas dentro de %s horas e durante %s horas.
BATTLE_FILED_RANK	Posição
BATTLE_FILED_RANK_EMPIRE	Reino
BATTLE_FILED_RANK_NAME	Nome
BATTLE_FILED_RANK_POINT	Pontos
BNW_GAME_UI_COM	Adversário
BNW_RANK_UI_COUNT	Doações
BNW_RANK_UI_NAME	Nome
BNW_RANK_UI_RANK	Posição
CANCEL	Cancelar
CHANGE_ATTR_SELECT	Mudar Bónus
CHANGE_PASSWORD_CONFIRM	Confirmar Nova Pass.
CHANGE_PASSWORD_NEW	Nova Palavra-passe
CHANGE_PASSWORD_OLD	Palavra-passe Antiga
CHANGE_PASSWORD_TITLE	Alterar a Palavra-passe
CHARACTER_ACTION	Emoções
CHARACTER_EMOTICON	Emoções
CHARACTER_MAIN	Personagem
CHARACTER_MUTUAL_ACTION	Emoção Partilhada
CHARACTER_NORMAL_ACTION	Emoções Normais
CHARACTER_QUEST	Missões
CHARACTER_SKILL	Habilidades
CHARACTER_SPECTIAL_ACTION	Acções Especiais
CHAT_FILTER	Filtro de chat
CHAT_FILTER_DICE	Dados
CLOSE	Fechar
COMB_APPEARANCE	Destino
COMB_ATTRIBUTE	Origem
COMB_MAIN	Destino
COMB_MATERIAL	Origem
COMB_SKILLBOOK_TILE	Trocar livros
COMB_TITLE	
COSTUME_TITLE	Disfarces
COSTUME_WINDOW_TITLE	Disfarces
CREATE_ATT_GRADE	FRÇ
CREATE_CREATE	Criar
CREATE_DEX_GRADE	DES
CREATE_HP	Vd
CREATE_LAST_POINT	Pontos
CREATE_MAN	Homem
CREATE_NAME	Nome
CREATE_NEXT	Próximo
CREATE_PREV	Voltar
CREATE_SEX	Género
CREATE_SHAPE	Forma
CREATE_SP	INT
CREATE_STAT_RESET	Reset
CREATE_WOMAN	Mulher
CUBE_INFO_TITLE	Manual de Refinamento
CUBE_RENEWAL_BELT_IMPROVE	Aumentar Probabilidade
CUBE_RENEWAL_TITLE	Refinação
CUBE_REQUIRE_MATERIAL	Materiais necessários
CUBE_REQUIRE_MATERIAL_OR	ou
CUBE_TITLE	Janela de Refinamento
CURRENT_POINT	Pontos actuais: %s
CZ_REWARD_WINDOW_TITLE	Templo do Zodíaco
DO_CHANGE_ATTR	Aplicar
DO_REFINE	Refinar
DRAGONSOUL_ACTIVATE	Activar
DRAGONSOUL_CHANGE_ATTR_WINDOW_TITLE	Mudança de Bónus de Pedras do Dragão Míticas
DRAGONSOUL_PAGE_BUTTON_1	Cru(a)
DRAGONSOUL_PAGE_BUTTON_2	Talhado(a)
DRAGONSOUL_PAGE_BUTTON_3	Raro(a)
DRAGONSOUL_PAGE_BUTTON_4	Antigo(a)
DRAGONSOUL_PAGE_BUTTON_5	Lendário(a)
DRAGONSOUL_PAGE_BUTTON_6	Mítica
DRAGONSOUL_REFINE_WINDOW_TITLE	Janela de Refinamento
DRAGONSOUL_TAP_TITLE_1	Diamante-Dragão
DRAGONSOUL_TAP_TITLE_2	Rubi-Dragão
DRAGONSOUL_TAP_TITLE_3	Jade-Dragão
DRAGONSOUL_TAP_TITLE_4	Safira-Dragão
DRAGONSOUL_TAP_TITLE_5	Granada-Dragão
DRAGONSOUL_TAP_TITLE_6	Ónix-Dragão
DRAGONSOUL_TITLE	Alquimia de Pedra do Dragão
DUTCHAUCTION_BUTTON	Ir!
DUTCHAUCTION_TITLE	Leilão Flash
EMPIRE_A	Shinsoo
EMPIRE_ALL	Tudo
EMPIRE_B	Chunjo
EMPIRE_C	Jinno
EMPIRE_EXIT	Sair
EMPIRE_NEXT	Próximo
EMPIRE_PREV	Voltar
EMPIRE_SELECT	Escolher
END_TIME	Evento activo
ENTER_BATTLE_FIELD	Entrar
EVENT_ALARM_TITLE	Vista Geral do Evento
EVENT_NAME_TITLE	Nome
EVENT_REWARD_TITLE	Recompensa
EXCHANGE_ACCEPT	OK
EXCHANGE_TITLE	Comércio
EXIT_BATTLE_FIELD	Queres mesmo sair da Zona de Combate?
EXIT_BATTLE_FIELD_ON_DEAD	Queres abandonar a Zona de Combate com %d ponto(s)?
EXPIRED_TIME	O evento terminou.
FISHING_RENEWAL_TITLE	Pescar
FRAGMENT_COMB_TITLE	Combinar Livros de Habilidades
GAMEOPTION_TITLE	Opções do jogo
GAME_EXIT_OBSERVER	Fechar Modo de Observação
GAME_GUILD_WAR_JOIN	Entrar em Guerra de Guild
GAME_HELP	Ajuda
GAME_QUEST	Tarefas
GAME_SKILL_UP	Aumentar Habilidades
GAME_STAT_UP	Aumentar Atributos
GEMSHOP_LEFTTIME	Tempo restante
GEMSHOP_TITLA	MERCADO DE GAYA
GRADE	Classe
GRADE_SELECT	Classe
GRAPHICONOFF_DROP_ITEM_APPLY	Aplicar
GRAPHICONOFF_DROP_ITEM_LEVEL	Queda de Itens
GRAPHICONOFF_DROP_ITEM_LEVEL1	1
GRAPHICONOFF_DROP_ITEM_LEVEL1_TOOLTIP	Mostrar efeito e nome
GRAPHICONOFF_DROP_ITEM_LEVEL2	2
GRAPHICONOFF_DROP_ITEM_LEVEL2_TOOLTIP	Esconder efeito
GRAPHICONOFF_DROP_ITEM_LEVEL3	3
GRAPHICONOFF_DROP_ITEM_LEVEL3_TOOLTIP	Esconder efeito e nome
GRAPHICONOFF_DROP_ITEM_LEVEL4	4
GRAPHICONOFF_DROP_ITEM_LEVEL4_TOOLTIP	Esconder itens e usar rato para mostrar nome
GRAPHICONOFF_DROP_ITEM_LEVEL5	5
GRAPHICONOFF_DROP_ITEM_LEVEL5_TOOLTIP	Esconder itens e nome
GRAPHICONOFF_EFFECT_APPLY	Aplicar
GRAPHICONOFF_EFFECT_LEVEL	Efeitos
GRAPHICONOFF_EFFECT_LEVEL1	1
GRAPHICONOFF_EFFECT_LEVEL1_TOOLTIP	Mostrar tudo
GRAPHICONOFF_EFFECT_LEVEL2	2
GRAPHICONOFF_EFFECT_LEVEL2_TOOLTIP	Apenas efeitos teus e de monstros
GRAPHICONOFF_EFFECT_LEVEL3	3
GRAPHICONOFF_EFFECT_LEVEL3_TOOLTIP	Apenas efeitos teus e de outros jogadores
GRAPHICONOFF_EFFECT_LEVEL4	4
GRAPHICONOFF_EFFECT_LEVEL4_TOOLTIP	Apenas teus
GRAPHICONOFF_EFFECT_LEVEL5	5
GRAPHICONOFF_EFFECT_LEVEL5_TOOLTIP	Esconder tudo
GRAPHICONOFF_NPC_NAME_STATUS	Nomes de NPCs
GRAPHICONOFF_NPC_NAME_STATUS_OFF	Off
GRAPHICONOFF_NPC_NAME_STATUS_OFF_TOOLTIP	Esconder nomes de NPCs
GRAPHICONOFF_NPC_NAME_STATUS_ON	On
GRAPHICONOFF_NPC_NAME_STATUS_ON_TOOLTIP	Mostrar nomes de NPCs
GRAPHICONOFF_PET_STATUS	Pets
GRAPHICONOFF_PET_STATUS_OFF	Off
GRAPHICONOFF_PET_STATUS_OFF_TOOLTIP	Esconder pets
GRAPHICONOFF_PET_STATUS_ON	On
GRAPHICONOFF_PET_STATUS_ON_TOOLTIP	Mostrar pets
GRAPHICONOFF_PRIVATE_SHOP_APPLY	Aplicar
GRAPHICONOFF_PRIVATE_SHOP_LEVEL	Lojas Privadas
GRAPHICONOFF_PRIVATE_SHOP_LEVEL1	1
GRAPHICONOFF_PRIVATE_SHOP_LEVEL1_TOOLTIP	Mostrar tudo
GRAPHICONOFF_PRIVATE_SHOP_LEVEL2	2
GRAPHICONOFF_PRIVATE_SHOP_LEVEL2_TOOLTIP	Mostrar tudo num raio grande
GRAPHICONOFF_PRIVATE_SHOP_LEVEL3	3
GRAPHICONOFF_PRIVATE_SHOP_LEVEL3_TOOLTIP	Mostrar tudo num raio médio
GRAPHICONOFF_PRIVATE_SHOP_LEVEL4	4
GRAPHICONOFF_PRIVATE_SHOP_LEVEL4_TOOLTIP	Mostrar tudo num raio pequeno
GRAPHICONOFF_PRIVATE_SHOP_LEVEL5	5
GRAPHICONOFF_PRIVATE_SHOP_LEVEL5_TOOLTIP	Mostrar tudo nas imediações
GUILDWINDOW_BASE_BUFF	Bónus de Guild
GUILD_ATTENDANCE_LOCA1	Primeira participação: 1x Medalha de Coragem
GUILD_ATTENDANCE_LOCA2	10 ou mais: 1x Medalha de Coragem
GUILD_ATTENDANCE_LOCA3	20 ou mais 2x Medalha de Coragem
GUILD_ATTENDANCE_LOCA4	30 ou mais: 4x Medalha de Coragem
GUILD_ATTENDANCE_LOCA5	40 ou mais: 6x Medalha de Coragem
GUILD_ATTENDANCE_LOCA6	50 ou mais: 8x Medalha de Coragem
GUILD_ATTENDANCE_LOCA7	60 ou mais: 10x Medalha de Coragem
GUILD_ATTENDANCE_LOCA8	70 ou mais: 12x Medalha de Coragem
GUILD_ATTENDANCE_LOCA9	Hora de início: diariamente às 5:00
GUILD_ATTENDANCE_TITLE	Recompensa de participação
GUILD_BANKINFO_CLOSE	Fechar
GUILD_BANKINFO_NAME	Membro
GUILD_BANKINFO_TITLE	Registo do Armazém da Guild
GUILD_BANKINFO_TYPE	Item/Moeda
GUILD_BANKINFO_USETYPE	Acção
GUILD_BANK_CLOSE	Fechar
GUILD_BANK_INFO	Página Loja:
GUILD_BANK_NUMBER	Bank number
GUILD_BASEINFO_BANK	Armazém da Guild
GUILD_BASEINFO_BANKLASTOUT	Última Remoção
GUILD_BASEINFO_BUILDING	Edifício de Guild
GUILD_BASEINFO_DEAL	Vender Território de Guild
GUILD_BASEINFO_FACTORY	Ferreiro de Guild
GUILD_BASEINFO_GOLDMANAGE	Transacção
GUILD_BASEINFO_GUILDLAND	Território de Guild
GUILD_BASEINFO_LANDABANDON	Dispersar Território de Guild
GUILD_BASEINFO_LANDSCAPE	Outros
GUILD_BASEINFO_LOCALE	Localização
GUILD_BASEINFO_MONEY	Saldo
GUILD_BASEINFO_MONEYBANKINFO	Informações do Banco da Guild
GUILD_BASEINFO_MONEYIN	Depósito
GUILD_BASEINFO_MONEYLASTOUT	Últ. Levantamento
GUILD_BASEINFO_MONEYOUT	Levantamento
GUILD_BASEINFO_POWER	Altar do Poder
GUILD_BASEINFO_SMEITER	Alquimista de Guild
GUILD_BASEINFO_TITLE	Informações do Território
GUILD_BASEINFO_VOTE	Votar
GUILD_BASENAME	Nome Base
GUILD_BOARD_ID	Nome
GUILD_BOARD_REFRESH	Actualizar
GUILD_BOARD_TEXT	Mensagem
GUILD_BUILDING_CATEGORY_TITLE	Unidades de Construção
GUILD_BUILDING_CHANGE	Alterar
GUILD_BUILDING_CHANGE_DELETE	Apagar
GUILD_BUILDING_CHANGE_FIX	Reconstrução da Guild
GUILD_BUILDING_CHANGE_LIST	Lista de Propriedades da Guild
GUILD_BUILDING_DIRECTION	Orientação
GUILD_BUILDING_FIX	Reconstrução
GUILD_BUILDING_GRADE	Nível
GUILD_BUILDING_INFO	Edifícios e Custos
GUILD_BUILDING_LIST_TITLE	Lista de Edifícios
GUILD_BUILDING_LOG	Tronco
GUILD_BUILDING_NAME	Nome do Edifício
GUILD_BUILDING_OPERATE	Operar
GUILD_BUILDING_PLY	Tábuas
GUILD_BUILDING_POSITION	Posição
GUILD_BUILDING_PREVIEW	Pré-visualizar
GUILD_BUILDING_PRICE	Preço
GUILD_BUILDING_REFRESH	Actualizar
GUILD_BUILDING_STONE	Pedras
GUILD_BUILDING_TITLE	Construções da Guild
GUILD_CRYSTAL	Cristal
GUILD_DEPOSIT	Depósito
GUILD_DONATE_BUTTON_OVER_TEXT	Item aleatório
GUILD_DONATE_COUNT	Doações disponíveis: %d/%d
GUILD_DONATE_GET_MEDAL_OF_HONOR	%d
GUILD_DONATE_GUILD_EXP	EXP de Guild
GUILD_DONATE_HIGH_MATERIAL	Doação Grande
GUILD_DONATE_MEDAL_OF_HONOR	Medalha de Coragem
GUILD_DONATE_MIDDLE_MATERIAL	Doação Média
GUILD_DONATE_MY_MEDAL_OF_HONOR	Minhas Medalhas de Coragem
GUILD_DONATE_NORMAL_MATERIAL	120.000 Yang
GUILD_DONATE_TAB_HIGH	Doação Grande
GUILD_DONATE_TAB_MIDDLE	Doação Média
GUILD_DONATE_TAB_NORMAL	Doação Pequena
GUILD_DONATE_TITLE	Doação de EXP
GUILD_DRAGONLAIR_RANKING	Classificações
GUILD_DRAGONLAIR_RANKING_COUNT	Posto
GUILD_DRAGONLAIR_RANKING_MEMBER	Membro
GUILD_DRAGONLAIR_RANKING_NAME	Guild
GUILD_DRAGONLAIR_RANKING_TIME	Tempo
GUILD_DROP_RESOURCE1	Aqui
GUILD_DROP_RESOURCE2	Deixar Recurso
GUILD_GEM	Gema
GUILD_GRADE_CHANGE_GRADE_NAME	Novo Nome de Estatuto
GUILD_GRADE_NUM	N.º
GUILD_GRADE_PERMISSION_BANK	Pode usar banco e armazém da Guild
GUILD_GRADE_PERMISSION_DELETE	Remover da Guild
GUILD_GRADE_PERMISSION_JOIN	Pode aceitar jogadores na guild
GUILD_GRADE_PERMISSION_NOTICE	Pode compor mensagens de Guild
GUILD_GRADE_PERMISSION_SKILL	Habilidades de Guild
GUILD_GRADE_PERMISSION_WAR	Pode seleccionar membros para se juntarem como combatentes
GUILD_GRADE_RANK	Estatuto
GUILD_GRADE_WRITE	Escrever
GUILD_INFO	Informações da Guild
GUILD_INFO_CUR_EXP	Experiência
GUILD_INFO_DECALRE_WAR	Declarar Guerra
GUILD_INFO_ENEMY_GUILD	Inimigos da Guild
GUILD_INFO_ENEMY_GUILD_EMPTY	Nenhum
GUILD_INFO_LEVEL	Nível da Guild
GUILD_INFO_MARK	Símbolo
GUILD_INFO_MASTER	Líder
GUILD_INFO_MASTER_VALUE	Líder
GUILD_INFO_MEMBER_AVG_LEVEL	Nível Médio
GUILD_INFO_MEMBER_NUM	Nº. de Membros
GUILD_INFO_NAME	Nome da Guild
GUILD_INFO_NAME_VALUE	Este é um Nome de Guild
GUILD_INFO_OFFER_EXP	Doar EXP
GUILD_INFO_REST_EXP	EXP Necessária
GUILD_INFO_UPLOAD_MARK	Enviar Ícone
GUILD_INFO_UPLOAD_SYMBOL	Enviar Bandeira
GUILD_LANDDEAL_VOTE	Vender Território de Guild
GUILD_LANDDEAL_VOTE_DEALGOLD	Preço em Yang:
GUILD_LANDDEAL_VOTE_DEALGUILDNAME	Nome da Guild:
GUILD_MARK	Ícone da Guild
GUILD_MASTER_CHANGE_TITLEBAR	Renunciar Liderança da Guild
GUILD_MEMBER_JOB	Raça
GUILD_MEMBER_KNIGHT	Combatente
GUILD_MEMBER_LEVEL	Nível
GUILD_MEMBER_NAME	Nome
GUILD_MEMBER_OUT_TITLEBAR	Remover Membro
GUILD_MEMBER_PACE_ATTENDANCE	Participação ({0}/{1})
GUILD_MEMBER_RANK	Estatuto
GUILD_MEMBER_SPECIFIC_GRAVITY	Doar
GUILD_MEMBER_VOTE_CHECK	Consultar votos
GUILD_METIN_STONE	Pedra Espírita
GUILD_MINENAL	Mineral
GUILD_MONEY	Yang
GUILD_NAME	Guild
GUILD_RESOURCE_INFO	Informação de recursos
GUILD_SKILLPAGE_LADDER	Pontos de Posição
GUILD_SKILLPAGE_RANK	Posição
GUILD_SKILL_ACTIVE	Activo
GUILD_SKIlL_HEAL_GSP	Reabastecer Poder
GUILD_SKILL_PASSIVE	Passivo
GUILD_SKILL_POWER	Energia
GUILD_SKILL_STATE	Habilidades da Guild
GUILD_SYMBOL	Bandeira da Guild
GUILD_WAR_ACCEPT	Aceitar Guerra
GUILD_WAR_ALLSCORE	Todas as Guerras
GUILD_WAR_BATTLE_TYPE	Tipo de Guerra
GUILD_WAR_CTF	Bandeira
GUILD_WAR_DECLARE	Declarar Guerra a
GUILD_WAR_ENEMY	Inimigo
GUILD_WAR_GAINSCORE	Pontos
GUILD_WAR_GAINSCORE_FIFTY	50
GUILD_WAR_GAINSCORE_HUNDRED	100
GUILD_WAR_GAINSCORE_THIRTY	30
GUILD_WAR_GAMETIME	Tempo de Combate
GUILD_WAR_GAMETIME_SIXTY	60 min.
GUILD_WAR_GAMETIME_TEN	10 min.
GUILD_WAR_GAMETIME_THIRTY	30 min.
GUILD_WAR_JOINMEMBER	Membros
GUILD_WAR_JOINMEMBER_COUNT	Membros
GUILD_WAR_JOINMEMBER_FIFTEEN	15
GUILD_WAR_JOINMEMBER_FIVE	5
GUILD_WAR_JOINMEMBER_TEN	10
GUILD_WAR_NORMAL	Campal
GUILD_WAR_REPORT	Relatório de Guerra
GUILD_WAR_REPORTLIST	Vista Geral (Batalhas: B, Vitórias: V, Derrotas: D, Empates: E)
GUILD_WAR_SCORE	Relatório de Guerra
GUILD_WAR_SKILL	Habilidades de Guild
GUILD_WAR_TYPE_DEFENSE	Batalha de Escudo
GUILD_WAR_TYPE_DIE	Batalha de Arena
GUILD_WAR_TYPE_FLAG	Capturar a Bandeira
GUILD_WAR_TYPE_NORMAL	Batalha Campal
GUILD_WAR_TYPE_TIGER	Aniquilação
GUILD_WAR_TYPE_TIME	Contra-Relógio
GUILD_WAR_WARP	Arena
GUILD_WAR_WIN	Rondas
GUILD_WAR_WIN_FIVE	5
GUILD_WAR_WIN_ONE	1
GUILD_WAR_WIN_THREE	3
GUILD_WATER	Água
GUILD_WATER_STONE	Gema
GUILD_WITHDRAW	Pegar
HELP_ATTACK	Activa ataques simples por cada clique do rato.
HELP_ATTACK_KEY	Ataque: Carrega na Barra de Espaços ou no Botão Esquerdo do Rato.
HELP_AUTO_ATTACK	Activa ataques automáticos por cada clique do rato.
HELP_CAMERA	Vista de câmara
HELP_CHANGE_PK_MODE	Alterar Modo de Ataque: Carrega no 'Ctrl' + 'B' para alterar o Modo de Ataque.
HELP_CHARACTER_BUTTON1	(Janela de Personagem, Janela de Inventário,
HELP_CHARACTER_BUTTON2	Lista de Amigos e Opções)
HELP_CHAT	Para falares com grupos específicos, usa os seguintes como prefixo nas tuas mensagens: !(chamar), #(chat de grupo) ou %(chat de guild).
HELP_CLICK_OTHER_PLAYER	Clica com o botão direito do rato noutro jogador para negociares, formares um grupo ou desafiá-lo para um duelo.
HELP_CONTROL_CAMERA_BY_MIDDLEBUTTON	Câmara Padrão: botão central do rato
HELP_CONTROL_CAMERA_BY_RIGHTBUTTON	Câmara Alternativa: atribuir ao botão esquerdo ou direito do rato
HELP_EMOTINO	Expressa as tuas emoções com as combinações de teclas <CTRL> + <1~9>.
HELP_EXP	Experiência
HELP_FURY	Loja de Itens Online
HELP_GUILD_WINDOW	Abrir Janela de Guild: Alt + G
HELP_HELP	Ajuda: H
HELP_HELP_KEY	As definições padrão são exibidas no ecrã de ajuda.
HELP_HP	Vida (VD)
HELP_KEYSETTING	Podes mudar os teus atalhos de teclado nas opções do jogo.
HELP_MESSENGER_WINDOW	Abrir a Lista de Amigos: Alt + M
HELP_MINIMAP	Mostra o mini-mapa.
HELP_MINIMAP_QUEST	Missões são exibidas como ícones a piscar no mini-mapa e no mapa grande.
HELP_MOUSE_LEFT	A função do botão Esquerdo do Rato
HELP_MOUSE_RIGHT	A função do botão Direito do Rato
HELP_MOVE_KEY	Painel: W, S, A, D e/ou as setas para mover a personagem.
HELP_OFF_QUESTSCROLL	Mostra/Esconde pergaminhos de missão com <CTRL> + Q.
HELP_OPEN_CHARACTER	Abrir Janela de Carácter: C
HELP_OPEN_CHAT	Abrir Janela de Chat: Enter
HELP_OPEN_INVENTORY	Abrir Janela de Inventário: I
HELP_OPEN_LOG	Abrir Janela de Mensagens Antigas: L
HELP_OPEN_MINIMAP	Abrir Mini Mapa: Shift + M
HELP_OPEN_QUEST	Abrir Janela de Tarefas: N
HELP_OPEN_SKILL	Abrir Janela de Habilidades: V
HELP_OPEN_WHISPER	Abrir Janela de Mensagens Privadas: Shift + Enter
HELP_OPEN_ZONEMAP	Abrir Mapa Grande: M
HELP_PICK_ITEM	Recolher Items: Teclas Z ou \ ou Botão Esquerdo do Rato.
HELP_QUICKSLOT	Campos de Acesso Rápido
HELP_SCREEN_CAPTURE	Gravar Print - Tecla 'Print Screen' para tirares uma Print. (Esta será gravada na pasta do Metin2)
HELP_SERVER	Mostra o servidor e o canal.
HELP_SHOW_ALL_NAME	Mostrar Nomes: Alt
HELP_SKILL	Aqui podes usar uma habilidade com o botão direito do rato.
HELP_SP	Mana (MN)
HELP_SYSTEM_BUTTON	Botão de Sistema
INVENTORY_PAGE_BUTTON_TOOLTIP_1	1. Inventário
INVENTORY_PAGE_BUTTON_TOOLTIP_2	2. Inventário
INVENTORY_PAGE_BUTTON_TOOLTIP_3	3º Inventário
INVENTORY_PAGE_BUTTON_TOOLTIP_4	4º Inventário
INVENTORY_TITLE	Inventário
ITEM_MALL	Item Shop
KEYCHANGE_ACTION_WINDOW	Acções
KEYCHANGE_ATTACK	Atacar
KEYCHANGE_AUTORUN	Auto-Correr
KEYCHANGE_AUTO_WINDOW	Auto-Caça
KEYCHANGE_BASEACTION	Teclas Padrão
KEYCHANGE_CAM_DOWN1	Câmara (Baixo)
KEYCHANGE_CAM_DOWN2	Câmara (Baixo)
KEYCHANGE_CAM_LEFT1	Câmara (Esquerda)
KEYCHANGE_CAM_LEFT2	Câmara (Esquerda)
KEYCHANGE_CAM_RIGHT1	Câmara (Direita)
KEYCHANGE_CAM_RIGHT2	Câmara (Direita)
KEYCHANGE_CAM_UP1	Câmara (Cima)
KEYCHANGE_CAM_UP2	Câmara (Cima)
KEYCHANGE_CAM_ZOOM_IN1	Câmara (+ Zoom)
KEYCHANGE_CAM_ZOOM_IN2	Câmara (+ Zoom)
KEYCHANGE_CAM_ZOOM_OUT1	Câmara (- Zoom)
KEYCHANGE_CAM_ZOOM_OUT2	Câmara (- Zoom)
KEYCHANGE_CANCLE	Cancelar
KEYCHANGE_CHAT_WINDOW	Registo do Chat
KEYCHANGE_CLEAR	Padrão
KEYCHANGE_DDS_WINDOW	DSS
KEYCHANGE_DOWN1	Trás
KEYCHANGE_DOWN2	Trás
KEYCHANGE_DSS1	PD [Céu]
KEYCHANGE_DSS2	PD [Terra]
KEYCHANGE_EMOTION1	Emoção (Triste)
KEYCHANGE_EMOTION2	Emoção (Yang)
KEYCHANGE_EMOTION3	Emoção (Música)
KEYCHANGE_EMOTION4	Emoção (Coração)
KEYCHANGE_EMOTION5	Emoção (Corações)
KEYCHANGE_EMOTION6	Emoção (Bomba)
KEYCHANGE_EMOTION7	Emoção (Ideia)
KEYCHANGE_EMOTION8	Emoção (Tempestade)
KEYCHANGE_EMOTION9	Emoção (Desculpa)
KEYCHANGE_GUILD_WINDOW	Guild
KEYCHANGE_HELP_WINDOW	Ajuda
KEYCHANGE_IMPOSSIBLE_CHANGE	[CTRL], [ALT] e [SHIFT] não são permitidos aqui!
KEYCHANGE_INGAMEEVENT	EVENTO
KEYCHANGE_INTERFACE	Janela
KEYCHANGE_INVENTORY_WINDOW	Inventário
KEYCHANGE_KEY_SETTING	Definições do Teclado
KEYCHANGE_LEFT1	Esquerda
KEYCHANGE_LEFT2	Esquerda
KEYCHANGE_MESSENGER_WINDOW	Amigos
KEYCHANGE_MINIMAP_MINER	Mini-Mapa (-)
KEYCHANGE_MINIMAP_PLUS	Mini-Mapa (+)
KEYCHANGE_MINIMAP_WINDOW	Mapa Grande
KEYCHANGE_MONSTER_CARD_WINDOW	Carta de Monstro
KEYCHANGE_NEXT_TARGET	Próximo Alvo
KEYCHANGE_PARTY_MATCH_WINDOW	Procura de Grupo
KEYCHANGE_PET_WINDOW	Pet
KEYCHANGE_QUEST_SCROLL_ONOFF	Ícones Missão
KEYCHANGE_QUEST_WINDOW	Missões
KEYCHANGE_QUICKSLOT1	Nível 1
KEYCHANGE_QUICKSLOT2	Nível 2
KEYCHANGE_QUICKSLOT3	Nível 3
KEYCHANGE_QUICKSLOT4	Nível 4
KEYCHANGE_RIDE	Montar
KEYCHANGE_RIDE_BYE	Dispensar Cavalo
KEYCHANGE_RIDE_HORSE	Montar
KEYCHANGE_RIDE_PEED	Alimentar Cavalo
KEYCHANGE_RIGHT1	Direita
KEYCHANGE_RIGHT2	Direita
KEYCHANGE_ROOT1	Apanhar
KEYCHANGE_ROOT2	Apanhar
KEYCHANGE_SAVE	Gravar
KEYCHANGE_SCREENSHOT	Screenshot
KEYCHANGE_SHOW_NAME	Mostrar Nomes
KEYCHANGE_SKILL_WINDOW	Habilidades
KEYCHANGE_SLOT1	Slot 1
KEYCHANGE_SLOT2	Slot 2
KEYCHANGE_SLOT3	Slot 3
KEYCHANGE_SLOT4	Slot 4
KEYCHANGE_SLOT5	Slot 5
KEYCHANGE_SLOT6	Slot 6
KEYCHANGE_SLOT7	Slot 7
KEYCHANGE_SLOT8	Slot 8
KEYCHANGE_SLOT_KET	Acessos Rápidos
KEYCHANGE_STATUS_WINDOW	Personagem
KEYCHANGE_UP1	Frente
KEYCHANGE_UP2	Frente
LANGUAGE_AE	Árabe
LANGUAGE_CZ	Checo
LANGUAGE_DE	Alemão
LANGUAGE_DK	Dinamarquês
LANGUAGE_EN	Inglês
LANGUAGE_ES	Espanhol
LANGUAGE_FR	Francês
LANGUAGE_GR	Grego
LANGUAGE_HU	Húngaro
LANGUAGE_IT	Italiano
LANGUAGE_NL	Holandês
LANGUAGE_PL	Polaco
LANGUAGE_PT	Português
LANGUAGE_RO	Romeno
LANGUAGE_RU	Russo
LANGUAGE_TR	Turco
LOAD_ERROR	O Ficheiro está com erros. Por favor instala de novo. Carrega agora no 'ESC'.
LOGIN_CONNECT	Entrar
LOGIN_CONNECTING	Estás a conectar-te ao Servidor
LOGIN_DEFAULT_SERVERADDR	Nome do servidor, Canal 1
LOGIN_EXIT	Sair
LOGIN_ID	Jogador
LOGIN_PASSWORD	Palavra-Passe
LOGIN_REGION_TITLE	Escolhe um lugar para emitir o recibo.
LOGIN_SELECT_BUTTON	Mudar
LOGIN_SELECT_EXIT	Sair
LOGIN_SELECT_OK	Entrar
LOGIN_SELECT_TITLE	Escolhe o Servidor
LUCKY_BOX_NOTICE_YANG	Taxa de Yang para nova fortuna de item
LUCKY_BOX_RECV_BUTTON	Aceitar Item
LUCKY_BOX_RECV_NAME	Conteúdos:
LUCKY_BOX_RETRY_BUTTON	Nova Fortuna de Item
LUCKY_BOX_TITLE_NAME	Cofre da Fortuna
MAILBOX_POST_ALL_DELETE_BUTTON	Apagar Tudo
MAILBOX_POST_ALL_RECEIVE	Receber Tudo
MAILBOX_POST_READ_BLOCK	Bloquear
MAILBOX_POST_READ_DELETE	Apagar
MAILBOX_POST_READ_FROM	De
MAILBOX_POST_READ_MAIN_TITLE	Mensagem
MAILBOX_POST_READ_RECV	Receber
MAILBOX_POST_READ_TITLE	Assunto
MAILBOX_POST_SEND_TITLE	Mensagem
MAILBOX_POST_WRITE_BUTTON_TEXT	Enviar
MAILBOX_POST_WRITE_CLOSE_TEXT	Fechar
MAILBOX_POST_WRITE_CONFIRM_TEXT	Confirmar Destinatário
MAILBOX_POST_WRITE_SEND_TEXT	Enviar
MAILBOX_POST_WRITE_TITLE	Assunto
MAILBOX_POST_WRITE_TO	Para
MAILBOX_TITLE	Mensagens Recebidas
MALL_PASSWORD_TITLE	Palavra-passe
MALL_TITLE	Armazém de Artigos
MARKET_TITLE	Carregar
MARKLIST_REFRESH	Actualizar
MARKLIST_TITLE	Registar uma assinatura da Guild
MC_EXCHANGE_BUTTON	Trocar
MC_MISSION_INIT_BUTTON	Reiniciar Nível de Missão
MC_MOTION_BUTTON	Movimento
MC_POLY_BUTTON	Transformar
MC_PROMOTION_BUTTON	Promover
MC_REQUEST_MISSION_BUTTON	Aceitar Missão
MC_REWARD_CARD_BUTTON	Coleccionar Carta de Monstro
MC_SHUFFLE_BUTTON	Baralhar Cartas de Missão
MC_SUMMON_BUTTON	Invocar
MC_TAB_BUTTON_CARD_MISSION	Carta de Missão
MC_TAB_BUTTON_PARTY	Colecção de Masmorras
MC_TAB_BUTTON_SOLO	Colecção de Mundo
MC_WARP_BUTTON	Teleportar
MESSAGE	Isto é uma Mensagem
MESSENGER_ADD_FRIEND	Adicionar amigo
MESSENGER_BLOCK_FRIEND	Bloquear
MESSENGER_DELETE_FRIEND	Apagar
MESSENGER_MOBILE	Enviar Mensagem
MESSENGER_OPEN_GUILD	Área da Guild
MESSENGER_TITLE	Amigos
MESSENGER_USE_GUILD_MOVE_SKILL	Usar Habilidade de Movimento da Guild
MESSENGER_WHISPER	Segredar
MINIGAME_FISH_EVENT_USE_COUNT	Quantidade:
MINIMIZE	Minimizar
MINI_BOSS_DUNGEON_DESC_BTN	Regras do Evento
MINI_BOSS_DUNGEON_TITLE_NAME	Nome
MINI_BOSS_DUNGEON_TITLE_NUM	Posição
MINI_BOSS_DUNGEON_TITLE_POINT	Pontos de Apocalipse
MINI_BOSS_DUNGEON_TOOTIP_01	Vista Geral da Masmorra
MINI_BOSS_DUNGEON_TOOTIP_02	Apocalipse para Níveis 40-80
MINI_BOSS_DUNGEON_TOOTIP_03	Apocalipse para Níveis 81+
MINI_BOSS_DUNGEON_TOOTIP_04	Entrar
MINI_BOSS_DUNGEON_TOOTIP_05	Tempo Restante
MINI_BOSS_DUNGEON_TOOTIP_06	Meus Pontos de Apocalipse
MINI_BOSS_DUNGEON_TOOTIP_07	Apocalipses Restantes
MINI_BOSS_DUNGEON_TOOTIP_08	Minha Recompensa
MINI_BOSS_TITLE	Apocalipse do Zodíaco
MINI_GAME_BLACK_AND_WHITE_DONATE	Doar
MINI_GAME_BLACK_AND_WHITE_GAME_TITLE	Duelo dos Videntes
MINI_GAME_BLACK_AND_WHITE_RANK_BUTTON	Classificações
MINI_GAME_BLACK_AND_WHITE_REWARD_TRADE	Prémios
MINI_GAME_BLACK_AND_WHITE_START_BUTTON	Iniciar
MINI_GAME_BLACK_AND_WHITE_WAITTING_TITLE	Duelo dos Videntes
MINI_GAME_CATCHKING_CHALLENGE	Aposta
MINI_GAME_CATCHKING_HELP_TEXT	Regras
MINI_GAME_CATCHKING_HIGH_SCORE	Pontuação Máxima
MINI_GAME_CATCHKING_MYNUMBER	Minha Carta
MINI_GAME_CATCHKING_POPUP_CONFIRM	Mostrar/Esconder Pop-up
MINI_GAME_CATCHKING_RETRY	Jogar de Novo
MINI_GAME_CATCHKING_REWARD	A Tua Recompensa
MINI_GAME_CATCHKING_SCORE	Pontos
MINI_GAME_CATCHKING_SELECTION_NUMBER	Carta Revelada
MINI_GAME_CATCHKING_START_TEXT	Iniciar
MINI_GAME_CATCHKING_TITLE	Apanha o Rei
MINI_GAME_FINDM_HINT_BTN	Dica
MINI_GAME_FINDM_START_BTN	Iniciar jogo
MINI_GAME_FINDM_TITLE	Memo Trio de Monstros
MINI_GAME_FINDM_TRY_COUNT_TEXT	Tentativas
MINI_GAME_FINDM_UPGRADE_BAR1	Item
MINI_GAME_FINDM_UPGRADE_BAR2	Taxa (Yang)
MINI_GAME_FINDM_UPGRADE_RECV	Receber Item
MINI_GAME_FINDM_UPGRADE_RETRY	Tentar Melhoramento
MINI_GAME_FINDM_UPGRADE_TITLE	Melhorar Recompensa
MINI_GAME_FISH_HELP_TEXT	Ajuda
MINI_GAME_FISH_START_TEXT	Iniciar
MINI_GAME_FISH_TITLE	Puzzle de Pesca
MINI_GAME_RUMI_DISCARD_TEXT	Modo Seguro
MINI_GAME_RUMI_EXIT	Terminar
MINI_GAME_RUMI_LBUTTON_DESC	Clica com o botão esquerdo para adicionares uma carta
MINI_GAME_RUMI_RBUTTON_DESC	Clica com o botão direito para descartares uma carta
MINI_GAME_RUMI_SCORE	Pontuação
MINI_GAME_RUMI_START_TEXT	Iniciar
MINI_GAME_RUMI_TITLE	Jogo de Cartas Okey do Metin2
MINI_GAME_YUTNORI_COM_TEXT	Computador
MINI_GAME_YUTNORI_PLAYER_TEXT	Jogador
MINI_GAME_YUTNORI_PROBABILITY	Probabilidade
MINI_GAME_YUTNORI_PROB_DESC	Selecciona uma pontuação de Yut para aumentares a probabilidade dela te sair.
MINI_GAME_YUTNORI_REMAIN_COUNT	Jogadas
MINI_GAME_YUTNORI_REWARD_TEXT	Recompensa
MINI_GAME_YUTNORI_SCORE	Pontuação
MINI_GAME_YUTNORI_START_TEXT	Iniciar
MINI_GAME_YUTNORI_THROW	Lançar
MINI_GAME_YUTNORI_TITLE	Yut Nori
MINI_GAME_YUTNORI_YUTSEM1	Do
MINI_GAME_YUTNORI_YUTSEM2	Gae
MINI_GAME_YUTNORI_YUTSEM3	Geol
MINI_GAME_YUTNORI_YUTSEM4	Yut
MINI_GAME_YUTNORI_YUTSEM5	Mo
MINI_GAME_YUTNORI_YUTSEM6	Back Do
MISTS_ISLAND_EMPIRE_NAME	Nome do Reino
MISTS_ISLAND_EMPIRE_SCORE	Pontuação do Reino
MISTS_ISLAND_END_TIME	Hora de Fim
MISTS_ISLAND_EXIT	Abandonar
MISTS_ISLAND_INFO_TEXT	Info de Estatuto/Estado
MISTS_ISLAND_RANK	Posição
MISTS_ISLAND_SCORE	Pontuação
MISTS_ISLAND_TITLE_RANK	Info de Estatuto/Estado
MISTS_ISLAND_TITLE_SCORE	Vista Geral
MOUSEBUTTON_ATTACK	Atacar
MOUSEBUTTON_AUTO_ATTACK	Atacar Automaticamente
MOUSEBUTTON_CAMERA	Camera
MOUSEBUTTON_SKILL	Habilidades
MUSICLIST_TITLE	Escolhas de Música
MYSHOP_DECO_CANCEL	Fechar
MYSHOP_DECO_DEFAULT	Padrão
MYSHOP_DECO_NEXT	Seguinte
MYSHOP_DECO_OK	Confirmar
MYSHOP_DECO_PREV	Voltar
MYSHOP_DECO_SELECT_MODEL	Escolhe a aparência da tua loja.
MYSHOP_DECO_SELECT_TITLE	Escolhe a aparência do teu nome.
NO	Não
OK	OK
OPPOSITES	Recusar
OPTION_ALWAYS_SHOW_NAME	Nome
OPTION_ALWAYS_SHOW_NAME_OFF	Desligado
OPTION_ALWAYS_SHOW_NAME_ON	Ligado
OPTION_BLOCK	Bloquear
OPTION_BLOCK_EXCHANGE	Trocas
OPTION_BLOCK_FRIEND	Amigo
OPTION_BLOCK_GUILD	Guild
OPTION_BLOCK_PARTY	Grupo
OPTION_BLOCK_PARTY_REQUEST	Pedidos
OPTION_BLOCK_WHISPER	Segredos
OPTION_CAMERA_DISTANCE	Visão
OPTION_CAMERA_DISTANCE_LONG	De longe
OPTION_CAMERA_DISTANCE_SHORT	De perto
OPTION_DELETE_MOBILE_BUTTON	Apagar Contacto
OPTION_EFFECT	Mostrar Dano
OPTION_ENV_EFFECT	Ambiente
OPTION_ENV_EFFECT_OFF	Off
OPTION_ENV_EFFECT_ON	On
OPTION_FOG	Nevoeiro
OPTION_FOG_DENSE	Denso
OPTION_FOG_LIGHT	Leve
OPTION_FOG_MIDDLE	Médio
OPTION_FOG_OFF	Off
OPTION_FOG_ON	On
OPTION_INPUT_MOBILE_BUTTON	Introduzir o Contacto
OPTION_KEY_SETTING	Teclado
OPTION_LANGUAGE_CHANGE	Aplicar
OPTION_LANGUAGE_SELECT	Idioma
OPTION_MOBILE	Telemóvel
OPTION_MOB_INFO	Info monstro
OPTION_MOB_INFO_AGGR	Agressivo
OPTION_MOB_INFO_LEVEL	Nível
OPTION_MUSIC	Música
OPTION_MUSIC_CHANGE	Alterar
OPTION_MUSIC_DEFAULT_THEMA	Música Standard do Metin2
OPTION_NAME_COLOR	Mostrar Cor
OPTION_NAME_COLOR_EMPIRE	Cor do Reino
OPTION_NAME_COLOR_NORMAL	Normal
OPTION_NIGHT_MODE	Noite
OPTION_NIGHT_MODE_OFF	Off
OPTION_NIGHT_MODE_ON	On
OPTION_PVPMODE	Modo PvP
OPTION_PVPMODE_FREE	Livre
OPTION_PVPMODE_FREE_TOOLTIP	Poderás atacar todos os jogadores
OPTION_PVPMODE_GUILD	Guild
OPTION_PVPMODE_GUILD_TOOLTIP	Podes atacar todos os jogadores menos os da tua Guild.
OPTION_PVPMODE_PEACE	Paz
OPTION_PVPMODE_PEACE_TOOLTIP	Não podes atacar jogadores do teu reino.
OPTION_PVPMODE_REVENGE	Hostil
OPTION_PVPMODE_REVENGE_TOOLTIP	Só poderás atacar aqueles que tenham mau Karma igualmente.
OPTION_SALESTEXT	Nome da loja
OPTION_SALESTEXT_VIEW_OFF	Esconder
OPTION_SALESTEXT_VIEW_ON	Mostrar
OPTION_SETTING	Abrir
OPTION_SNOW_MODE	Queda de Neve
OPTION_SNOW_MODE_OFF	Off
OPTION_SNOW_MODE_ON	On
OPTION_SNOW_TEXTURE_MODE	Neve
OPTION_SNOW_TEXTURE_MODE_OFF	Off
OPTION_SNOW_TEXTURE_MODE_ON	On
OPTION_SOUND	Som
OPTION_TARGET_BOARD	Menu do Alvo
OPTION_TARGET_BOARD_NO_VIEW	Fechar
OPTION_TARGET_BOARD_VIEW	Mostrar
OPTION_TITLE	Opções
OPTION_VIEW_CHAT	Linha de Chat
OPTION_VIEW_CHAT_OFF	Esconder
OPTION_VIEW_CHAT_ON	Mostrar
PARTY_MATCH_TEXT_DUNGEON_NAME	Masmorra
PARTY_MATCH_TEXT_DUNGEON_SELECT	Seleccionar Masmorra
PARTY_MATCH_TEXT_ENTREE_LEVEL	Nível: %d
PARTY_MATCH_TEXT_LEVEL_LIMIT	Nível Requerido
PARTY_MATCH_TEXT_REQUEST_MATCH	Procurar
PARTY_MATCH_TEXT_REQUEST_MATCH_CANCEL	Cancelar
PARTY_MATCH_TEXT_REQUIRED_ITEMS	Item Requerido
PARTY_MEMBER_INFO_NAME	Nome do grupo
PASSWORD_DESC_1	Escreve a tua password
PASSWORD_DESC_2	para abrir o armazém.
PASSWORD_DESC_3	Já alteraste a tua palavra-passe?
PASSWORD_DESC_4	Caso não o faças, a tua palavra-passe será "000000".
PASSWORD_DESC_5	Altera a tua palavra-passe no Armazém.
PASSWORD_TITLE	Gravar Palavra-passe
PET_AGE_TEXT	Idade do Pet
PET_ATTR_CHANGE_ITEM_TEXT	Feitiço para Pets
PET_ATTR_CHANGE_TITLE	Alterar Tipo de Pet
PET_ATTR_CONFIRMATION	Alterar
PET_ATTR_DETERMINE_TITLE	Novo Tipo de Pet
PET_ATTR_OK	Fechar
PET_CHANGE_TEXT	Pet
PET_FEED_TITLE	Alimentar
PET_FFED_BUTTON_TEXT	Alimentar
PET_HATCHING_BUTTON	Eclodir
PET_HATCHING_NIK	Nome do Pet
PET_HATCHING_WINDOW_TITLE	Incubadora
PET_INFORMATION_ABILITIES	Bónus
PET_INFORMATION_AGE	Idade
PET_INFORMATION_COSTUME_BONUS	Bónus de disfarce
PET_INFORMATION_DEFENCE	Defesa
PET_INFORMATION_EVOL_BUTTON	Evoluir
PET_INFORMATION_EXP	Experiência
PET_INFORMATION_EXP_BUTTON	EXP de Item
PET_INFORMATION_HP	VD
PET_INFORMATION_LEVEL	Nível
PET_INFORMATION_LIFE	Duração
PET_INFORMATION_LIFETIME_BUTTON	Alimentar
PET_INFORMATION_LIFE_TIME	Horas
PET_INFORMATION_SKILL	Habilidade
PET_INFORMATION_SP	MN
PET_INFORMATION_TITLE	Pet
PET_NAME_CHANGE_BUTTON	Alterar
PET_NAME_CHANGE_WINDOW_TITLE	Alterar Nome
PET_REVIVE_BUTTON	Ressuscitar
PET_REVIVE_CANCEL_BUTTON	Cancelar
PET_REVIVE_MATERIAL_TITLE	Material
PET_REVIVE_REUSLT_TEXT	Resultado
PET_REVIVE_TARGET	Pet a ser ressuscitado
PET_REVIVE_TITLE	Ressuscitar pet
PICK_MONEY_TITLE	Dividir
PRIVATESHOPSEARCH_BUY	Comprar
PRIVATESHOPSEARCH_COUNT	Quantidade
PRIVATESHOPSEARCH_ITEMNAME	Nome
PRIVATESHOPSEARCH_ITEMTYPE	Itens
PRIVATESHOPSEARCH_JOB	Classe
PRIVATESHOPSEARCH_LEVEL	Nível
PRIVATESHOPSEARCH_PRICE	Preço
PRIVATESHOPSEARCH_REFINE	Nível do Item
PRIVATESHOPSEARCH_SEARCH	Pesquisar
PRIVATESHOPSEARCH_SEARCH_BAR	Pesquisa
PRIVATESHOPSEARCH_SELECT	Seleccionar
PRIVATESHOPSEARCH_SELLER	Vendedor
PRIVATE_SHOP_CLOSE_BUTTON	Fechar Loja
PRIVATE_SHOP_NAME	Nome da Loja
PRIVATE_SHOP_TITLE	Abrir uma Loja Privada
QUEST_UI_TEXT_COLLECTION	Missões do Biólogo
QUEST_UI_TEXT_DAILY	Missão Diária
QUEST_UI_TEXT_EVENT	Missões de Evento
QUEST_UI_TEXT_LEVELUP	Missão de Caça
QUEST_UI_TEXT_MAIN	Missões Principais
QUEST_UI_TEXT_SCROLL	Missões de Livro
QUEST_UI_TEXT_SUB	Missões Secundárias
QUEST_UI_TEXT_SYSTEM	Missões de Jogo
REFINE_COST	Custo Para Melhorar: 0 Yang
REFINE_ELEMENT_CHANGE_COST_TITLE	Custo
REFINE_ELEMENT_CHANGE_DARK	Trevas
REFINE_ELEMENT_CHANGE_EARTH	Terra
REFINE_ELEMENT_CHANGE_ELECT	Raios
REFINE_ELEMENT_CHANGE_FIRE	Fogo
REFINE_ELEMENT_CHANGE_ICE	Gelo
REFINE_ELEMENT_CHANGE_TITLE	Mudar elemento
REFINE_ELEMENT_CHANGE_WIND	Vento
REFINE_ELEMENT_DOWNGRADE_TITLE	Remover melhoramento
REFINE_ELEMENT_UPGRADE_TITLE	Melhorar
REFINE_INFO	Possibilidade de Melhoramento: 100%
REFINE_MONEY	Taxa de Refinamento
REFINE_SELECT	Refinamento
REFINE_TTILE	Melhoramentos
REPORT_VIOLENT_WHISPER	
RESTART_GIVEUP	Desistir
RESTART_HERE	Recomeçar Aqui
RESTART_IMMEDIATE	Reencarnação
RESTART_TOWN	Recomeçar na Cidade
ROULETTE_SPECIAL_TITLE	Recompensas (%s)
ROULETTE_SPIN_TEXT1	RODAR
ROULETTE_SPIN_TEXT2	50 Almas
ROULETTE_SPIN_TEXT3	250.000 Yang
ROULETTE_TITLE	Recompensas
SAFE_CHANGE_PASSWORD	Mudar Palavra-passe
SAFE_TITLE	Armazém
SELECT_ATTR_CHANGED	Novos
SELECT_ATTR_CURRENT	Actuais
SELECT_ATTR_SELECT	Escolher
SELECT_ATTR_TITLE	Feitiço para Itens+
SELECT_ATT_GRADE	FRÇ
SELECT_CREATE	Criar
SELECT_DELETE	Apagar
SELECT_DEX_GRADE	DES
SELECT_EMPIRE_NAME	Nome do Reino
SELECT_EXIT	Fechar
SELECT_HP	Vd
SELECT_LEVEL	Nível
SELECT_METIN_STONE_TITLE	Seleccionar Pedra Espírita
SELECT_NAME	Nome
SELECT_NO_GUILD	Sem Guild
SELECT_PLAYTIME	Tempo de jogo
SELECT_SELECT	Começar
SELECT_SP	Mn
SELECT_TITLE	Escolher Título
SHOP_BUY	Comprar
SHOP_SELL	Vender
SHOP_TITLE	Loja
SKILL_SUPPORT_TITLE	Habilidades Standard
STEP	Grau de Clareza
STEP_SELECT	Grau de Clareza
STRENGTH	Fortalecer
STRENGTH_SELECT	Nível
STRUCTURE_VIEW_MODE	Decoração
STRUCTURE_VIEW_TYPE_STRUCTURE	Esconder
SYSTEMOPTION_TITLE	Opções do Sistema
SYSTEM_CHANGE	Alterar Personagem
SYSTEM_EXIT	Sair do Jogo
SYSTEM_HELP	Ajuda
SYSTEM_LOGOUT	Sair da Conta
SYSTEM_MALL	Loja de Itens
SYSTEM_MOVE_CHANNEL	Mudar de Canal
SYSTEM_OPTION	Opções do Sistema
TASKBAR_CHARACTER	Personagem [C/V/B/N]
TASKBAR_CHAT	Janela de Chat [Enter]
TASKBAR_DISABLE	Desactivada
TASKBAR_DRAGON_SOUL	Alquimia de Pedra do Dragão
TASKBAR_EXPAND	Expandir Janela
TASKBAR_INVENTORY	Inventário [I]
TASKBAR_MESSENGER	Amigos [Alt+M]
TASKBAR_MONEY_EXPAND	Dinheiro
TASKBAR_NEXT_QUICKSLOT	Próximo Campo de Acesso Rápido [Shift+Número, Alt]
TASKBAR_PET_INFO	Info do Pet
TASKBAR_PREV_QUICKSLOT	Pré-visualizar Campo de Acesso Rápido [Shift+Número]
TASKBAR_SYSTEM	Opções[ESC]
TOTAL_RANKING	Classificações Gerais
WARP_MI_LABEL	Para o santuário atacado
WEEKLY_RANKING	Classificações Semanais
WHISPER_BAN	Bloquear
WHISPER_NAME	Segredar
WHISPER_REPORT	
WHISPER_SEND	Enviar
YES	Sim
ZONE_MAP	Mapa Grande
