ACCEPT	OK
ACCE_ABSORB	Absorption des bonus
ACCE_COMBINE	Fusion
ACCE_MAIN	Étole 1
ACCE_RESULT	Résultat
ACCE_SERVE	Étole 2
ATTACH_METIN_INFO	Utiliser la pierre d'esprit ?
ATTACH_METIN_TITLE	La pierre d'Esprit a été liée
ATTENDANCE_TITLE	Évènement du chasseur de boss
ATTR_67_ADD	Ajouter un bonus
ATTR_67_ADD_TITLE	Ajouter un bonus
ATTR_67_MATERIAL_SLOT_TITLE	Fragments
ATTR_67_REGIST_SLOT_TITLE	Objet cible
ATTR_67_SUPPORT_SLOT_TITLE	Complément
AURA_MAIN	Tenue d'aura
AURA_SUB	Matériel
AUTO_AUTO_ATTACK	Attaquer
AUTO_AUTO_POSITION	Potions
AUTO_AUTO_RANGE	Focus
AUTO_AUTO_SKILL	Compétences
AUTO_CLEAR	Vider
AUTO_END	Arrêter
AUTO_OFF	Off
AUTO_ON	On
AUTO_POSITION_SETTING	Potions
AUTO_SAVE	Sauvegarder
AUTO_SETTING	Paramètres
AUTO_SKILL_SETTING	Compétences
AUTO_START	Commencer
AUTO_TITLE	Chasse automatique
BANNER_ATTENDANCE_BUTTON	Évènement du chasseur de boss
BANNER_BLACK_AND_WHITE_BUTTON	Concours des devins
BANNER_CATCHKING_BUTTON	Chasse au roi
BANNER_EASTER_BUTTON	PÂQUES
BANNER_FISH_BUTTON	PUZZLE DU POISSON
BANNER_FLOWER_BUTTON	SAISON FLORALE
BANNER_FOOTBALL_BUTTON	FOOTBALL
BANNER_HALLOWEEN_BUTTON	HALLOWEEN
BANNER_LUCKY_EVENT	CHASSE AUX MONSTRES
BANNER_MINIBOSS_BUTTON	Apocalypse du zodiaque
BANNER_MINI_GAME_FINDM	TRIO DE MONSTRES
BANNER_MONSTERBACK_BUTTON	Utilisez vos PV
BANNER_MYSTERY_BOX_BUTTON	ÉVÈNEMENT DE BUTIN I
BANNER_MYSTERY_BOX_BUTTON_2	ÉVÈNEMENT DE BUTIN II
BANNER_NEW_XMAS_BUTTON	NOËL
BANNER_OKEY_BUTTON	Évènement Okey
BANNER_OLYMPIC_BUTTON	ÉVÈNEMENT
BANNER_RAMADAN_BUTTON	RAMADAN
BANNER_ROULETTE_BUTTON	Rituel sanglant
BANNER_SOUL_BUTTON	ÉVÈNEMENT DES ÂMES
BANNER_SUMMER_BUTTON	ÉVÈNEMENT ESTIVAL
BANNER_VALENTINE_BUTTON	SAINT-VALENTIN
BANNER_YUTNORI_BUTTON	Yutnori
BATTLE_FIELD_INFO	Zone de combat
BATTLE_FIELD_OPERATION_TIME	L'accès à la Zone de combat est possible entre %sh00 et %sh00.
BATTLE_FIELD_OPERATION_TIME_ALL	L'accès est disponible.
BATTLE_FIELD_OPERATION_TIME_END	La Zone de combat est encore ouverte pendant %sh.
BATTLE_FIELD_OPERATION_TIME_NA	L'accès n'est pas disponible.
BATTLE_FIELD_OPERATION_TIME_OPEN	L'accès est disponible dans %sh pendant %sh.
BATTLE_FILED_RANK	Rang
BATTLE_FILED_RANK_EMPIRE	Empire
BATTLE_FILED_RANK_NAME	Nom
BATTLE_FILED_RANK_POINT	Points
BNW_GAME_UI_COM	Adversaire
BNW_RANK_UI_COUNT	Chiffre de la donation
BNW_RANK_UI_NAME	Nom
BNW_RANK_UI_RANK	Rang
CANCEL	Annuler
CHANGE_ATTR_SELECT	Modifier le bonus
CHANGE_PASSWORD_CONFIRM	Confirmez-le
CHANGE_PASSWORD_NEW	Nouveau mot de passe
CHANGE_PASSWORD_OLD	Ancien mot de passe
CHANGE_PASSWORD_TITLE	Changement de mot de passe
CHARACTER_ACTION	Action
CHARACTER_EMOTICON	Emotion
CHARACTER_MAIN	Personnage
CHARACTER_MUTUAL_ACTION	Action partagée
CHARACTER_NORMAL_ACTION	Action normale
CHARACTER_QUEST	Missions
CHARACTER_SKILL	Compétence
CHARACTER_SPECTIAL_ACTION	Actions spéciales
CHAT_FILTER	Filtre de tchat
CHAT_FILTER_DICE	Dé
CLOSE	Fermer
COMB_APPEARANCE	Destinataire
COMB_ATTRIBUTE	Original
COMB_MAIN	Destinataire
COMB_MATERIAL	Original
COMB_SKILLBOOK_TILE	Échanger des livres
COMB_TITLE	
COSTUME_TITLE	Costumes
COSTUME_WINDOW_TITLE	Costumes
CREATE_ATT_GRADE	STR
CREATE_CREATE	Créer
CREATE_DEX_GRADE	DEX
CREATE_HP	PV
CREATE_LAST_POINT	Points
CREATE_MAN	Homme
CREATE_NAME	Nom
CREATE_NEXT	Suivant
CREATE_PREV	Précédent
CREATE_SEX	Genre
CREATE_SHAPE	Forme
CREATE_SP	INT
CREATE_STAT_RESET	Réinitialiser
CREATE_WOMAN	Femme
CUBE_INFO_TITLE	Manuel de raffinage
CUBE_RENEWAL_BELT_IMPROVE	Augmenter les chances
CUBE_RENEWAL_TITLE	Raffinage
CUBE_REQUIRE_MATERIAL	Matériaux nécessaires
CUBE_REQUIRE_MATERIAL_OR	ou
CUBE_TITLE	Fenêtre de raffinage
CURRENT_POINT	Score actuel : %s
CZ_REWARD_WINDOW_TITLE	Temple du zodiaque
DO_CHANGE_ATTR	Appliquer
DO_REFINE	Raffiner
DRAGONSOUL_ACTIVATE	Activer
DRAGONSOUL_CHANGE_ATTR_WINDOW_TITLE	Modification de bonus (pierre-dragon mythique)
DRAGONSOUL_PAGE_BUTTON_1	Brute
DRAGONSOUL_PAGE_BUTTON_2	Taillée
DRAGONSOUL_PAGE_BUTTON_3	Rare
DRAGONSOUL_PAGE_BUTTON_4	Antique
DRAGONSOUL_PAGE_BUTTON_5	Légendaire
DRAGONSOUL_PAGE_BUTTON_6	Mythique
DRAGONSOUL_REFINE_WINDOW_TITLE	Fenêtre de raffinage
DRAGONSOUL_TAP_TITLE_1	Diamant-dragon
DRAGONSOUL_TAP_TITLE_2	Rubis-dragon
DRAGONSOUL_TAP_TITLE_3	Jade-dragon
DRAGONSOUL_TAP_TITLE_4	Saphir-dragon
DRAGONSOUL_TAP_TITLE_5	Grenat-dragon
DRAGONSOUL_TAP_TITLE_6	Onyx-dragon
DRAGONSOUL_TITLE	Alchimie des pierres-dragons
DUTCHAUCTION_BUTTON	+
DUTCHAUCTION_TITLE	Enchère éclair
EMPIRE_A	Shinsoo
EMPIRE_ALL	Tous
EMPIRE_B	Chunjo
EMPIRE_C	Jinno
EMPIRE_EXIT	Sortie
EMPIRE_NEXT	Suivant
EMPIRE_PREV	Précédent
EMPIRE_SELECT	Choisir
END_TIME	Évènement en cours
ENTER_BATTLE_FIELD	Entrer
EVENT_ALARM_TITLE	Vue générale évènement
EVENT_NAME_TITLE	Nom
EVENT_REWARD_TITLE	Récompense
EXCHANGE_ACCEPT	OK
EXCHANGE_TITLE	Echanger
EXIT_BATTLE_FIELD	Voulez-vous vraiment quitter la Zone de combat ?
EXIT_BATTLE_FIELD_ON_DEAD	Souhaitez-vous quitter la Zone de combat avec %d points ?
EXPIRED_TIME	L'évènement est terminé.
FISHING_RENEWAL_TITLE	Pêche
FRAGMENT_COMB_TITLE	Combiner des livres de compétence
GAMEOPTION_TITLE	Options de jeu
GAME_EXIT_OBSERVER	Fin du mode observateur
GAME_GUILD_WAR_JOIN	Participer à une guerre de guilde
GAME_HELP	Aide
GAME_QUEST	Missions
GAME_SKILL_UP	Monter une compétence
GAME_STAT_UP	Monter une caractéristique
GEMSHOP_LEFTTIME	Temps restant
GEMSHOP_TITLA	BOURSE AUX GAYAS
GRADE	Classe
GRADE_SELECT	Classe
GRAPHICONOFF_DROP_ITEM_APPLY	Appliquer
GRAPHICONOFF_DROP_ITEM_LEVEL	Butin d'objets
GRAPHICONOFF_DROP_ITEM_LEVEL1	1
GRAPHICONOFF_DROP_ITEM_LEVEL1_TOOLTIP	Afficher l'effet et le nom
GRAPHICONOFF_DROP_ITEM_LEVEL2	2
GRAPHICONOFF_DROP_ITEM_LEVEL2_TOOLTIP	Masquer l'effet
GRAPHICONOFF_DROP_ITEM_LEVEL3	3
GRAPHICONOFF_DROP_ITEM_LEVEL3_TOOLTIP	Masquer l'effet et le nom
GRAPHICONOFF_DROP_ITEM_LEVEL4	4
GRAPHICONOFF_DROP_ITEM_LEVEL4_TOOLTIP	Masquer les objets et le nom par survol
GRAPHICONOFF_DROP_ITEM_LEVEL5	5
GRAPHICONOFF_DROP_ITEM_LEVEL5_TOOLTIP	Ne pas afficher les objets et noms
GRAPHICONOFF_EFFECT_APPLY	Appliquer
GRAPHICONOFF_EFFECT_LEVEL	Effets
GRAPHICONOFF_EFFECT_LEVEL1	1
GRAPHICONOFF_EFFECT_LEVEL1_TOOLTIP	Afficher tout
GRAPHICONOFF_EFFECT_LEVEL2	2
GRAPHICONOFF_EFFECT_LEVEL2_TOOLTIP	Uniquement vos effets et ceux des monstres
GRAPHICONOFF_EFFECT_LEVEL3	3
GRAPHICONOFF_EFFECT_LEVEL3_TOOLTIP	Uniquement vos effets et ceux d'autres joueurs
GRAPHICONOFF_EFFECT_LEVEL4	4
GRAPHICONOFF_EFFECT_LEVEL4_TOOLTIP	Uniquement vos effets
GRAPHICONOFF_EFFECT_LEVEL5	5
GRAPHICONOFF_EFFECT_LEVEL5_TOOLTIP	Ne rien afficher
GRAPHICONOFF_NPC_NAME_STATUS	Noms de PNJ
GRAPHICONOFF_NPC_NAME_STATUS_OFF	Inactif
GRAPHICONOFF_NPC_NAME_STATUS_OFF_TOOLTIP	Masquer les noms de PNJ
GRAPHICONOFF_NPC_NAME_STATUS_ON	Actif
GRAPHICONOFF_NPC_NAME_STATUS_ON_TOOLTIP	Afficher les noms de PNJ
GRAPHICONOFF_PET_STATUS	Familiers
GRAPHICONOFF_PET_STATUS_OFF	Inactif
GRAPHICONOFF_PET_STATUS_OFF_TOOLTIP	Masquer le familier
GRAPHICONOFF_PET_STATUS_ON	Actif
GRAPHICONOFF_PET_STATUS_ON_TOOLTIP	Afficher le familier
GRAPHICONOFF_PRIVATE_SHOP_APPLY	Appliquer
GRAPHICONOFF_PRIVATE_SHOP_LEVEL	Magasins privés
GRAPHICONOFF_PRIVATE_SHOP_LEVEL1	1
GRAPHICONOFF_PRIVATE_SHOP_LEVEL1_TOOLTIP	Afficher tout
GRAPHICONOFF_PRIVATE_SHOP_LEVEL2	2
GRAPHICONOFF_PRIVATE_SHOP_LEVEL2_TOOLTIP	Tout afficher sur un large rayon
GRAPHICONOFF_PRIVATE_SHOP_LEVEL3	3
GRAPHICONOFF_PRIVATE_SHOP_LEVEL3_TOOLTIP	Tout afficher sur un rayon moyen
GRAPHICONOFF_PRIVATE_SHOP_LEVEL4	4
GRAPHICONOFF_PRIVATE_SHOP_LEVEL4_TOOLTIP	Tout afficher sur un rayon proche
GRAPHICONOFF_PRIVATE_SHOP_LEVEL5	5
GRAPHICONOFF_PRIVATE_SHOP_LEVEL5_TOOLTIP	Tout afficher dans l'environnement immédiat
GUILDWINDOW_BASE_BUFF	Bonus de guilde
GUILD_ATTENDANCE_LOCA1	Première participation : 1x médaille de bravoure
GUILD_ATTENDANCE_LOCA2	10 ou plus : 1x médaille de bravoure
GUILD_ATTENDANCE_LOCA3	20 ou plus : 2x médaille de bravoure
GUILD_ATTENDANCE_LOCA4	30 ou plus : 4x médaille de bravoure
GUILD_ATTENDANCE_LOCA5	40 ou plus : 6x médaille de bravoure
GUILD_ATTENDANCE_LOCA6	50 ou plus : 8x médaille de bravoure
GUILD_ATTENDANCE_LOCA7	60 ou plus : 10x médaille de bravoure
GUILD_ATTENDANCE_LOCA8	70 ou plus : 12x médaille de bravoure
GUILD_ATTENDANCE_LOCA9	Début de participation : tous les jours à 5h00
GUILD_ATTENDANCE_TITLE	Récompense de participation
GUILD_BANKINFO_CLOSE	Fermer
GUILD_BANKINFO_NAME	Membre
GUILD_BANKINFO_TITLE	Historique de guilde
GUILD_BANKINFO_TYPE	Objet/devise
GUILD_BANKINFO_USETYPE	Action
GUILD_BANK_CLOSE	Fermer
GUILD_BANK_INFO	Entrepôt :
GUILD_BANK_NUMBER	N° de banque
GUILD_BASEINFO_BANK	Entrepôt de guilde
GUILD_BASEINFO_BANKLASTOUT	Dernier élément
GUILD_BASEINFO_BUILDING	Bâtiment de guilde
GUILD_BASEINFO_DEAL	Vendre le terrain de guilde
GUILD_BASEINFO_FACTORY	Forgeron de guilde
GUILD_BASEINFO_GOLDMANAGE	Transaction
GUILD_BASEINFO_GUILDLAND	Terrain de guilde
GUILD_BASEINFO_LANDABANDON	Dissoudre le terrain de guilde
GUILD_BASEINFO_LANDSCAPE	Autre
GUILD_BASEINFO_LOCALE	Emplacement
GUILD_BASEINFO_MONEY	Solde du compte
GUILD_BASEINFO_MONEYBANKINFO	Information sur la banque de guilde
GUILD_BASEINFO_MONEYIN	Versement
GUILD_BASEINFO_MONEYLASTOUT	Dernier retrait
GUILD_BASEINFO_MONEYOUT	Paiement
GUILD_BASEINFO_POWER	Autel du pouvoir
GUILD_BASEINFO_SMEITER	Alchimiste de guilde
GUILD_BASEINFO_TITLE	Informations du terrain
GUILD_BASEINFO_VOTE	Sondage
GUILD_BASENAME	Nom de base
GUILD_BOARD_ID	Nom
GUILD_BOARD_REFRESH	Rafraîchir
GUILD_BOARD_TEXT	Message
GUILD_BUILDING_CATEGORY_TITLE	Éléments de bâtiment
GUILD_BUILDING_CHANGE	Changer
GUILD_BUILDING_CHANGE_DELETE	Effacer
GUILD_BUILDING_CHANGE_FIX	Transformation de guilde
GUILD_BUILDING_CHANGE_LIST	Liste des objets de guilde
GUILD_BUILDING_DIRECTION	Orientation
GUILD_BUILDING_FIX	Transformation
GUILD_BUILDING_GRADE	Grade
GUILD_BUILDING_INFO	Bâtiments et prix indicatif
GUILD_BUILDING_LIST_TITLE	Liste des bâtiments
GUILD_BUILDING_LOG	Tronc
GUILD_BUILDING_NAME	Nom du bâtiment
GUILD_BUILDING_OPERATE	Actionner
GUILD_BUILDING_PLY	ply
GUILD_BUILDING_POSITION	Situation
GUILD_BUILDING_PREVIEW	Voir
GUILD_BUILDING_PRICE	price
GUILD_BUILDING_REFRESH	Rafraîchir
GUILD_BUILDING_STONE	stone
GUILD_BUILDING_TITLE	Bâtiment de Guilde
GUILD_CRYSTAL	Cristal
GUILD_DEPOSIT	Depôt
GUILD_DONATE_BUTTON_OVER_TEXT	Objet aléatoire
GUILD_DONATE_COUNT	Donations disponibles : %d/%d
GUILD_DONATE_GET_MEDAL_OF_HONOR	%d
GUILD_DONATE_GUILD_EXP	EXP de guilde
GUILD_DONATE_HIGH_MATERIAL	Donation élevée
GUILD_DONATE_MEDAL_OF_HONOR	Médaille de bravoure
GUILD_DONATE_MIDDLE_MATERIAL	Donation moyenne
GUILD_DONATE_MY_MEDAL_OF_HONOR	Mes médailles de bravoure
GUILD_DONATE_NORMAL_MATERIAL	120 000 Yangs
GUILD_DONATE_TAB_HIGH	Donation élevée
GUILD_DONATE_TAB_MIDDLE	Donation moyenne
GUILD_DONATE_TAB_NORMAL	Donation ordinaire
GUILD_DONATE_TITLE	Donation d'EXP
GUILD_DRAGONLAIR_RANKING	Liste des meilleurs joueurs
GUILD_DRAGONLAIR_RANKING_COUNT	Place
GUILD_DRAGONLAIR_RANKING_MEMBER	Membres
GUILD_DRAGONLAIR_RANKING_NAME	Guilde
GUILD_DRAGONLAIR_RANKING_TIME	Temps
GUILD_DROP_RESOURCE1	Ici
GUILD_DROP_RESOURCE2	Ressources obtenues
GUILD_GEM	Gemme
GUILD_GRADE_CHANGE_GRADE_NAME	Nouveau nom de grade
GUILD_GRADE_NUM	N°
GUILD_GRADE_PERMISSION_BANK	Est autorisé à utiliser la banque et l'entrepôt de guilde.
GUILD_GRADE_PERMISSION_DELETE	Bannir de la guilde
GUILD_GRADE_PERMISSION_JOIN	Est autorisé à accepter de nouveaux membres de guilde.
GUILD_GRADE_PERMISSION_NOTICE	Est autorisé à afficher des notes de guilde.
GUILD_GRADE_PERMISSION_SKILL	Compétences de guilde
GUILD_GRADE_PERMISSION_WAR	Est autorisé à choisir les combattants parmi les membres de guilde.
GUILD_GRADE_RANK	Grade
GUILD_GRADE_WRITE	Ecrire
GUILD_INFO	Information sur la Guilde
GUILD_INFO_CUR_EXP	Expérience
GUILD_INFO_DECALRE_WAR	Déclarer la guerre
GUILD_INFO_ENEMY_GUILD	Guilde ennemie
GUILD_INFO_ENEMY_GUILD_EMPTY	aucune
GUILD_INFO_LEVEL	Niveau de la Guilde
GUILD_INFO_MARK	Symbole de Guilde
GUILD_INFO_MASTER	Chef
GUILD_INFO_MASTER_VALUE	Chef
GUILD_INFO_MEMBER_AVG_LEVEL	Niveau moyen
GUILD_INFO_MEMBER_NUM	Nombre de membres
GUILD_INFO_NAME	Nom de la Guilde
GUILD_INFO_NAME_VALUE	C'est un nom de Guilde
GUILD_INFO_OFFER_EXP	Engager
GUILD_INFO_REST_EXP	Expérience requise
GUILD_INFO_UPLOAD_MARK	Télécharger symbole
GUILD_INFO_UPLOAD_SYMBOL	Télécharger drapeau
GUILD_LANDDEAL_VOTE	Vendre le terrain de guilde
GUILD_LANDDEAL_VOTE_DEALGOLD	Prix en Yangs :
GUILD_LANDDEAL_VOTE_DEALGUILDNAME	Nom de guilde :
GUILD_MARK	Symbole de Guilde
GUILD_MASTER_CHANGE_TITLEBAR	Céder la direction de la guilde
GUILD_MEMBER_JOB	Classe
GUILD_MEMBER_KNIGHT	Combattant
GUILD_MEMBER_LEVEL	Niveau
GUILD_MEMBER_NAME	Nom
GUILD_MEMBER_OUT_TITLEBAR	Supprimer membre
GUILD_MEMBER_PACE_ATTENDANCE	Participation ({0}/{1})
GUILD_MEMBER_RANK	Grade
GUILD_MEMBER_SPECIFIC_GRAVITY	Invest.
GUILD_MEMBER_VOTE_CHECK	Sondage de vérification
GUILD_METIN_STONE	Pierre d'Esprit
GUILD_MINENAL	Minerai
GUILD_MONEY	Yang
GUILD_NAME	Guilde
GUILD_RESOURCE_INFO	Information sur les ressources
GUILD_SKILLPAGE_LADDER	Points de grade
GUILD_SKILLPAGE_RANK	Rang
GUILD_SKILL_ACTIVE	Active
GUILD_SKIlL_HEAL_GSP	Récupérer un Esprit de Dragon
GUILD_SKILL_PASSIVE	Passive
GUILD_SKILL_POWER	Énergie
GUILD_SKILL_STATE	Compétences de la Guilde
GUILD_SYMBOL	Drapeau de Guilde
GUILD_WAR_ACCEPT	Accepter la déclaration de guerre
GUILD_WAR_ALLSCORE	Tous les combats
GUILD_WAR_BATTLE_TYPE	Type de bataille
GUILD_WAR_CTF	Drapeau
GUILD_WAR_DECLARE	Déclarer la guerre à une Guilde
GUILD_WAR_ENEMY	Ennemi
GUILD_WAR_GAINSCORE	Points
GUILD_WAR_GAINSCORE_FIFTY	50
GUILD_WAR_GAINSCORE_HUNDRED	100
GUILD_WAR_GAINSCORE_THIRTY	30
GUILD_WAR_GAMETIME	Durée du combat
GUILD_WAR_GAMETIME_SIXTY	60 min.
GUILD_WAR_GAMETIME_TEN	10 min.
GUILD_WAR_GAMETIME_THIRTY	30 min.
GUILD_WAR_JOINMEMBER	Membres
GUILD_WAR_JOINMEMBER_COUNT	Membres
GUILD_WAR_JOINMEMBER_FIFTEEN	15
GUILD_WAR_JOINMEMBER_FIVE	5
GUILD_WAR_JOINMEMBER_TEN	10
GUILD_WAR_NORMAL	Champ
GUILD_WAR_REPORT	Aperçu combat
GUILD_WAR_REPORTLIST	Aperçu (combats : C, victoires : V, défaites : D, nul : N)
GUILD_WAR_SCORE	Aperçu combat
GUILD_WAR_SKILL	Compétences de guilde
GUILD_WAR_TYPE_DEFENSE	Combat de bouclier
GUILD_WAR_TYPE_DIE	Combat en arène
GUILD_WAR_TYPE_FLAG	Combat de drapeau
GUILD_WAR_TYPE_NORMAL	Champ de bataille
GUILD_WAR_TYPE_TIGER	Combat à mort
GUILD_WAR_TYPE_TIME	Attaque minutée
GUILD_WAR_WARP	Arène
GUILD_WAR_WIN	Parties
GUILD_WAR_WIN_FIVE	5
GUILD_WAR_WIN_ONE	1
GUILD_WAR_WIN_THREE	3
GUILD_WATER	Eau
GUILD_WATER_STONE	Pierre d'eau
GUILD_WITHDRAW	Prendre
HELP_ATTACK	Active l'attaque unique par clic de souris.
HELP_ATTACK_KEY	Attaque : espace ou bouton gauche de la souris
HELP_AUTO_ATTACK	Active l'attaque automatique par clic de souris.
HELP_CAMERA	Changer vue caméra
HELP_CHANGE_PK_MODE	Changer de type d'attaque : changer configuration du bouton gauche de souris
HELP_CHARACTER_BUTTON1	(Fenêtre de perso, d'inventaire,
HELP_CHARACTER_BUTTON2	liste d'amis et options)
HELP_CHAT	Pour discuter avec des groupes précis, faites précéder votre texte de : !(tchat), #(tchat de groupe) ou %(tchat de guilde).
HELP_CLICK_OTHER_PLAYER	Effectuez un clic droit pour échanger avec d'autres joueurs, créer des groupes et provoquer quelqu'un en duel.
HELP_CONTROL_CAMERA_BY_MIDDLEBUTTON	Paramètres de vue caméra : bouton central de la souris.
HELP_CONTROL_CAMERA_BY_RIGHTBUTTON	Paramètres de modification de la vue caméra : appuyer sur bouton droite ou gauche de la souris.
HELP_EMOTINO	Avec les combinaisons de touches <Ctrl> + <&~ç>, vous pouvez afficher des émotions.
HELP_EXP	Expérience
HELP_FURY	Boutique intrajeu
HELP_GUILD_WINDOW	Ouvrir fenêtre de guilde : Alt + G
HELP_HELP	Afficher l'aide : H
HELP_HELP_KEY	Vous trouverez les paramètres par défaut dans l'Aide.
HELP_HP	Points de Vie (PV)
HELP_KEYSETTING	Vous pouvez configurer les touches dans les options du jeu.
HELP_MESSENGER_WINDOW	Ouvrir liste d'amis : Alt + M
HELP_MINIMAP	Affiche la mini-carte.
HELP_MINIMAP_QUEST	Les missions sur la mini-carte et la carte d'aperçu sont indiquées par un signal clignotant.
HELP_MOUSE_LEFT	Fonction du bouton gauche de la souris
HELP_MOUSE_RIGHT	Fonction du bouton droite de la souris
HELP_MOVE_KEY	Déplacements : Z, Q, S, D ou les flèches du clavier
HELP_OFF_QUESTSCROLL	Avec <Ctrl> + A, vous pouvez montrer et masquer les parchemins de quêtes.
HELP_OPEN_CHARACTER	Ouvrir fenêtre du personnage : C
HELP_OPEN_CHAT	Ouvrir le tchat : Entrée
HELP_OPEN_INVENTORY	Ouvrir l'inventaire : I
HELP_OPEN_LOG	Ouvrir historique des tchats: L
HELP_OPEN_MINIMAP	Ouvrir mini-carte : Shift + M
HELP_OPEN_QUEST	Ouvrir fenêtre de missions : N
HELP_OPEN_SKILL	Ouvrir arbre de compétences : V
HELP_OPEN_WHISPER	Mode chuchotement : Shift + Entrée
HELP_OPEN_ZONEMAP	Ouvrir carte d'aperçu : M
HELP_PICK_ITEM	Ramasser objets : w ou ² ou touche gauche de la souris
HELP_QUICKSLOT	Objets en accès rapide
HELP_SCREEN_CAPTURE	Enregistrer capture d'écran : Imprim Ecran (print scr) (enreg. dans "Metin2/screenshot")
HELP_SERVER	Affiche les serveurs et les canaux.
HELP_SHOW_ALL_NAME	Afficher les noms : Alt
HELP_SKILL	Ici, vous pouvez utiliser une compétence en faisant un clic droit.
HELP_SP	Points de mana (PM)
HELP_SYSTEM_BUTTON	Touches systèmes
INVENTORY_PAGE_BUTTON_TOOLTIP_1	1er inventaire
INVENTORY_PAGE_BUTTON_TOOLTIP_2	2e inventaire
INVENTORY_PAGE_BUTTON_TOOLTIP_3	3e inventaire
INVENTORY_PAGE_BUTTON_TOOLTIP_4	4e inventaire
INVENTORY_TITLE	Inventaire
ITEM_MALL	Boutique
KEYCHANGE_ACTION_WINDOW	Actions
KEYCHANGE_ATTACK	Attaquer
KEYCHANGE_AUTORUN	Course auto.
KEYCHANGE_AUTO_WINDOW	Chasse automatique
KEYCHANGE_BASEACTION	Paramètres de base
KEYCHANGE_CAM_DOWN1	Caméra (vers le bas)
KEYCHANGE_CAM_DOWN2	Caméra (vers le bas)
KEYCHANGE_CAM_LEFT1	Caméra (à gauche)
KEYCHANGE_CAM_LEFT2	Caméra (à gauche)
KEYCHANGE_CAM_RIGHT1	Caméra (à droite)
KEYCHANGE_CAM_RIGHT2	Caméra (à droite)
KEYCHANGE_CAM_UP1	Caméra (vers le haut)
KEYCHANGE_CAM_UP2	Caméra (vers le haut)
KEYCHANGE_CAM_ZOOM_IN1	Caméra (Zoom +)
KEYCHANGE_CAM_ZOOM_IN2	Caméra (Zoom +)
KEYCHANGE_CAM_ZOOM_OUT1	Caméra (Zoom -)
KEYCHANGE_CAM_ZOOM_OUT2	Caméra (Zoom -)
KEYCHANGE_CANCLE	Annuler
KEYCHANGE_CHAT_WINDOW	Protocole du tchat
KEYCHANGE_CLEAR	Standard
KEYCHANGE_DDS_WINDOW	DSS
KEYCHANGE_DOWN1	Reculer
KEYCHANGE_DOWN2	Reculer
KEYCHANGE_DSS1	DS [Ciel]
KEYCHANGE_DSS2	DS [Terre]
KEYCHANGE_EMOTION1	Émotion (triste)
KEYCHANGE_EMOTION2	Émotion (Yang)
KEYCHANGE_EMOTION3	Émotion (musique)
KEYCHANGE_EMOTION4	Émotion (cœur)
KEYCHANGE_EMOTION5	Émotion (petit cœur)
KEYCHANGE_EMOTION6	Émotion (bombe)
KEYCHANGE_EMOTION7	Émotion (idée)
KEYCHANGE_EMOTION8	Émotion (orage)
KEYCHANGE_EMOTION9	Émotion (pardon)
KEYCHANGE_GUILD_WINDOW	Guilde
KEYCHANGE_HELP_WINDOW	Aide
KEYCHANGE_IMPOSSIBLE_CHANGE	Ici, l'utilisation des touches [Ctrl], [Alt] et [Maj] n'est pas autorisée !
KEYCHANGE_INGAMEEVENT	ÉVÈNEMENT
KEYCHANGE_INTERFACE	Fenêtre
KEYCHANGE_INVENTORY_WINDOW	Inventaire
KEYCHANGE_KEY_SETTING	Paramètres clavier
KEYCHANGE_LEFT1	À gauche
KEYCHANGE_LEFT2	À gauche
KEYCHANGE_MESSENGER_WINDOW	Amis
KEYCHANGE_MINIMAP_MINER	Mini-carte (-)
KEYCHANGE_MINIMAP_PLUS	Mini-carte (+)
KEYCHANGE_MINIMAP_WINDOW	Carte d'aperçu
KEYCHANGE_MONSTER_CARD_WINDOW	Carte de monstre
KEYCHANGE_NEXT_TARGET	Cible suivante
KEYCHANGE_PARTY_MATCH_WINDOW	Recherche de groupe
KEYCHANGE_PET_WINDOW	Familier
KEYCHANGE_QUEST_SCROLL_ONOFF	Suivi de quête
KEYCHANGE_QUEST_WINDOW	Missions
KEYCHANGE_QUICKSLOT1	Niveau 1
KEYCHANGE_QUICKSLOT2	Niveau 2
KEYCHANGE_QUICKSLOT3	Niveau 3
KEYCHANGE_QUICKSLOT4	Niveau 4
KEYCHANGE_RIDE	Chevaucher
KEYCHANGE_RIDE_BYE	Renvoyer cheval
KEYCHANGE_RIDE_HORSE	Chevaucher
KEYCHANGE_RIDE_PEED	Nourrir cheval
KEYCHANGE_RIGHT1	À droite
KEYCHANGE_RIGHT2	À droite
KEYCHANGE_ROOT1	Ramasser
KEYCHANGE_ROOT2	Ramasser
KEYCHANGE_SAVE	Sauvegarder
KEYCHANGE_SCREENSHOT	Photo
KEYCHANGE_SHOW_NAME	Afficher nom
KEYCHANGE_SKILL_WINDOW	Compétences
KEYCHANGE_SLOT1	Emplacement 1
KEYCHANGE_SLOT2	Emplacement 2
KEYCHANGE_SLOT3	Emplacement 3
KEYCHANGE_SLOT4	Emplacement 4
KEYCHANGE_SLOT5	Emplacement 5
KEYCHANGE_SLOT6	Emplacement 6
KEYCHANGE_SLOT7	Emplacement 7
KEYCHANGE_SLOT8	Emplacement 8
KEYCHANGE_SLOT_KET	Accès rapide
KEYCHANGE_STATUS_WINDOW	Informations sur le personnage
KEYCHANGE_UP1	Avancer
KEYCHANGE_UP2	Avancer
LANGUAGE_AE	Arabe
LANGUAGE_CZ	Tchèque
LANGUAGE_DE	Allemand
LANGUAGE_DK	Danois
LANGUAGE_EN	Anglais
LANGUAGE_ES	Espagnol
LANGUAGE_FR	Français
LANGUAGE_GR	Grec
LANGUAGE_HU	Hongrois
LANGUAGE_IT	Italien
LANGUAGE_NL	Néerlandais
LANGUAGE_PL	Polonais
LANGUAGE_PT	Portugais
LANGUAGE_RO	Roumain
LANGUAGE_RU	Russe
LANGUAGE_TR	Turc
LOAD_ERROR	Le fichier est endommagé. Veuillez en installer un nouveau. Appuyez à présent sur Echapp
LOGIN_CONNECT	Se connecter
LOGIN_CONNECTING	Vous devez être connecté au serveur
LOGIN_DEFAULT_SERVERADDR	Nom du serveur, Canal 1
LOGIN_EXIT	Sortie
LOGIN_ID	Nom d'utilisateur
LOGIN_PASSWORD	Mot de passe
LOGIN_REGION_TITLE	Choisissez un emplacement pour émettre un compte
LOGIN_SELECT_BUTTON	Choisissez
LOGIN_SELECT_EXIT	Sortie
LOGIN_SELECT_OK	OK
LOGIN_SELECT_TITLE	Choisissez un serveur
LUCKY_BOX_NOTICE_YANG	Nouvelle chance d'objet (coût en Yangs)
LUCKY_BOX_RECV_BUTTON	Accepter l'objet
LUCKY_BOX_RECV_NAME	Contenu :
LUCKY_BOX_RETRY_BUTTON	Nouvelle chance d'objet
LUCKY_BOX_TITLE_NAME	Coffret bonne fortune
MAILBOX_POST_ALL_DELETE_BUTTON	Tout supprimer
MAILBOX_POST_ALL_RECEIVE	Tout accepter
MAILBOX_POST_READ_BLOCK	Bloquer
MAILBOX_POST_READ_DELETE	Supprimer
MAILBOX_POST_READ_FROM	De
MAILBOX_POST_READ_MAIN_TITLE	Message
MAILBOX_POST_READ_RECV	Accepter
MAILBOX_POST_READ_TITLE	Objet
MAILBOX_POST_SEND_TITLE	Message
MAILBOX_POST_WRITE_BUTTON_TEXT	Envoyer
MAILBOX_POST_WRITE_CLOSE_TEXT	Fermer
MAILBOX_POST_WRITE_CONFIRM_TEXT	Vérifier le destinataire
MAILBOX_POST_WRITE_SEND_TEXT	Envoyer
MAILBOX_POST_WRITE_TITLE	Objet
MAILBOX_POST_WRITE_TO	À
MAILBOX_TITLE	Boîte de réception
MALL_PASSWORD_TITLE	Mot de passe
MALL_TITLE	Entrepôt de la boutique
MARKET_TITLE	Charger
MARKLIST_REFRESH	Rafraîchir
MARKLIST_TITLE	Enregistrer le symbole de Guilde
MC_EXCHANGE_BUTTON	Échanger
MC_MISSION_INIT_BUTTON	Réinitialiser le niveau de la mission
MC_MOTION_BUTTON	Mouvement
MC_POLY_BUTTON	Transformer
MC_PROMOTION_BUTTON	Améliorer
MC_REQUEST_MISSION_BUTTON	Accepter la mission
MC_REWARD_CARD_BUTTON	Accepter la carte de monstre
MC_SHUFFLE_BUTTON	Reclasser les cartes de missions
MC_SUMMON_BUTTON	Invoquer
MC_TAB_BUTTON_CARD_MISSION	Mission de carte
MC_TAB_BUTTON_PARTY	Collection de donjons
MC_TAB_BUTTON_SOLO	Collection de champs
MC_WARP_BUTTON	Téléporter
MESSAGE	Ceci est un message
MESSENGER_ADD_FRIEND	Ajouter un(e) ami(e)
MESSENGER_BLOCK_FRIEND	Bloquer
MESSENGER_DELETE_FRIEND	Supprimer
MESSENGER_MOBILE	Envoyer un message
MESSENGER_OPEN_GUILD	Ouvrir la fenêtre de Guilde
MESSENGER_TITLE	Amis
MESSENGER_USE_GUILD_MOVE_SKILL	Utilisez la compétence de Guilde de mouvement
MESSENGER_WHISPER	Chuchoter
MINIGAME_FISH_EVENT_USE_COUNT	Quantité
MINIMIZE	Minimiser
MINI_BOSS_DUNGEON_DESC_BTN	Règles de l'évènement
MINI_BOSS_DUNGEON_TITLE_NAME	Participants
MINI_BOSS_DUNGEON_TITLE_NUM	Rang
MINI_BOSS_DUNGEON_TITLE_POINT	Points d'apocalypse
MINI_BOSS_DUNGEON_TOOTIP_01	Aperçu du donjon
MINI_BOSS_DUNGEON_TOOTIP_02	Apocalypse pour les niveaux 40 à 80
MINI_BOSS_DUNGEON_TOOTIP_03	Apocalypse à partir du niveau 81
MINI_BOSS_DUNGEON_TOOTIP_04	Entrer
MINI_BOSS_DUNGEON_TOOTIP_05	Temps restant
MINI_BOSS_DUNGEON_TOOTIP_06	Mes points d'apocalypse
MINI_BOSS_DUNGEON_TOOTIP_07	Apocalypses restantes
MINI_BOSS_DUNGEON_TOOTIP_08	Mes récompenses
MINI_BOSS_TITLE	Apocalypse du zodiaque
MINI_GAME_BLACK_AND_WHITE_DONATE	Faire un don
MINI_GAME_BLACK_AND_WHITE_GAME_TITLE	Concours des devins
MINI_GAME_BLACK_AND_WHITE_RANK_BUTTON	Classement
MINI_GAME_BLACK_AND_WHITE_REWARD_TRADE	Prix
MINI_GAME_BLACK_AND_WHITE_START_BUTTON	Commencer
MINI_GAME_BLACK_AND_WHITE_WAITTING_TITLE	Concours des devins
MINI_GAME_CATCHKING_CHALLENGE	Mise
MINI_GAME_CATCHKING_HELP_TEXT	Règles
MINI_GAME_CATCHKING_HIGH_SCORE	Meilleur score
MINI_GAME_CATCHKING_MYNUMBER	Mes cartes
MINI_GAME_CATCHKING_POPUP_CONFIRM	Pop-up activé/désactivé
MINI_GAME_CATCHKING_RETRY	Nouvelle partie
MINI_GAME_CATCHKING_REWARD	Votre gain
MINI_GAME_CATCHKING_SCORE	Points
MINI_GAME_CATCHKING_SELECTION_NUMBER	Carte dévoilée
MINI_GAME_CATCHKING_START_TEXT	Commencer
MINI_GAME_CATCHKING_TITLE	Chasse au roi
MINI_GAME_FINDM_HINT_BTN	Note
MINI_GAME_FINDM_START_BTN	Lancer le jeu
MINI_GAME_FINDM_TITLE	Trio de monstres
MINI_GAME_FINDM_TRY_COUNT_TEXT	Essais
MINI_GAME_FINDM_UPGRADE_BAR1	Objet
MINI_GAME_FINDM_UPGRADE_BAR2	Frais (Yangs)
MINI_GAME_FINDM_UPGRADE_RECV	Recevoir l'objet
MINI_GAME_FINDM_UPGRADE_RETRY	Essai d'amélioration
MINI_GAME_FINDM_UPGRADE_TITLE	Améliorer la récompense
MINI_GAME_FISH_HELP_TEXT	Aide
MINI_GAME_FISH_START_TEXT	Commencer
MINI_GAME_FISH_TITLE	Puzzle du poisson
MINI_GAME_RUMI_DISCARD_TEXT	Mode sécurisé
MINI_GAME_RUMI_EXIT	Terminer
MINI_GAME_RUMI_LBUTTON_DESC	Clic gauche pour ajouter une carte
MINI_GAME_RUMI_RBUTTON_DESC	Clic droit pour supprimer une carte
MINI_GAME_RUMI_SCORE	Points
MINI_GAME_RUMI_START_TEXT	Commencer
MINI_GAME_RUMI_TITLE	Jeu de cartes Metin2 Okey
MINI_GAME_YUTNORI_COM_TEXT	Ordinateur
MINI_GAME_YUTNORI_PLAYER_TEXT	Joueur
MINI_GAME_YUTNORI_PROBABILITY	Probabilité
MINI_GAME_YUTNORI_PROB_DESC	Sélectionnez un lancer de Yutnori pour lui conférer une plus forte probabilité.
MINI_GAME_YUTNORI_REMAIN_COUNT	Tirages
MINI_GAME_YUTNORI_REWARD_TEXT	Récompense
MINI_GAME_YUTNORI_SCORE	Nombre de points
MINI_GAME_YUTNORI_START_TEXT	Commencer
MINI_GAME_YUTNORI_THROW	Lancer
MINI_GAME_YUTNORI_TITLE	Yutnori
MINI_GAME_YUTNORI_YUTSEM1	Do
MINI_GAME_YUTNORI_YUTSEM2	Gae
MINI_GAME_YUTNORI_YUTSEM3	Geol
MINI_GAME_YUTNORI_YUTSEM4	Yut
MINI_GAME_YUTNORI_YUTSEM5	Mo
MINI_GAME_YUTNORI_YUTSEM6	Duit-do
MISTS_ISLAND_EMPIRE_NAME	Nom de l'empire
MISTS_ISLAND_EMPIRE_SCORE	Score de l'empire
MISTS_ISLAND_END_TIME	Date de fin
MISTS_ISLAND_EXIT	Quitter
MISTS_ISLAND_INFO_TEXT	Informations de statut et de rang
MISTS_ISLAND_RANK	Rang
MISTS_ISLAND_SCORE	Score
MISTS_ISLAND_TITLE_RANK	Infos de statut et de rang
MISTS_ISLAND_TITLE_SCORE	Aperçu
MOUSEBUTTON_ATTACK	Attaquer
MOUSEBUTTON_AUTO_ATTACK	Attaquer automatiquement
MOUSEBUTTON_CAMERA	Caméra
MOUSEBUTTON_SKILL	Compétences
MUSICLIST_TITLE	Choix des musiques
MYSHOP_DECO_CANCEL	Fermer
MYSHOP_DECO_DEFAULT	Standard
MYSHOP_DECO_NEXT	Suivant
MYSHOP_DECO_OK	Terminer
MYSHOP_DECO_PREV	Retour
MYSHOP_DECO_SELECT_MODEL	Sélectionnez l'apparence de votre magasin.
MYSHOP_DECO_SELECT_TITLE	Sélectionnez l'apparence de votre titre.
NO	Non
OK	OK
OPPOSITES	Refuser
OPTION_ALWAYS_SHOW_NAME	Nom
OPTION_ALWAYS_SHOW_NAME_OFF	Restreint
OPTION_ALWAYS_SHOW_NAME_ON	Toujours
OPTION_BLOCK	Bloquer
OPTION_BLOCK_EXCHANGE	Echanger
OPTION_BLOCK_FRIEND	Amis
OPTION_BLOCK_GUILD	Guilde
OPTION_BLOCK_PARTY	Groupe
OPTION_BLOCK_PARTY_REQUEST	Demander
OPTION_BLOCK_WHISPER	Chuchoter
OPTION_CAMERA_DISTANCE	Caméra
OPTION_CAMERA_DISTANCE_LONG	Loin
OPTION_CAMERA_DISTANCE_SHORT	Proche
OPTION_DELETE_MOBILE_BUTTON	Effacer le numéro de téléphone portable
OPTION_EFFECT	Infos combat
OPTION_ENV_EFFECT	Environnement
OPTION_ENV_EFFECT_OFF	Off
OPTION_ENV_EFFECT_ON	On
OPTION_FOG	Brouillard
OPTION_FOG_DENSE	Épais
OPTION_FOG_LIGHT	Léger
OPTION_FOG_MIDDLE	Moyen
OPTION_FOG_OFF	Off
OPTION_FOG_ON	On
OPTION_INPUT_MOBILE_BUTTON	Entrer le numéro de téléphone portable
OPTION_KEY_SETTING	Clavier
OPTION_LANGUAGE_CHANGE	Appliquer
OPTION_LANGUAGE_SELECT	Langue
OPTION_MOBILE	Téléphone portable
OPTION_MOB_INFO	Info-monstre
OPTION_MOB_INFO_AGGR	Agressif
OPTION_MOB_INFO_LEVEL	Niveau
OPTION_MUSIC	Musique
OPTION_MUSIC_CHANGE	Changer
OPTION_MUSIC_DEFAULT_THEMA	Musique standard de Metin2
OPTION_NAME_COLOR	Couleur
OPTION_NAME_COLOR_EMPIRE	Empire
OPTION_NAME_COLOR_NORMAL	Normal
OPTION_NIGHT_MODE	Nuit
OPTION_NIGHT_MODE_OFF	Off
OPTION_NIGHT_MODE_ON	On
OPTION_PVPMODE	Mode PvP
OPTION_PVPMODE_FREE	Libre
OPTION_PVPMODE_FREE_TOOLTIP	Vous êtes autorisé à attaquer tous les joueurs.
OPTION_PVPMODE_GUILD	Guilde
OPTION_PVPMODE_GUILD_TOOLTIP	Vous pouvez attaquer tous les joueurs exceptés les membres de votre guilde.
OPTION_PVPMODE_PEACE	Paix
OPTION_PVPMODE_PEACE_TOOLTIP	Il est interdit d'attaquer un joueur de son empire.
OPTION_PVPMODE_REVENGE	Ennemi
OPTION_PVPMODE_REVENGE_TOOLTIP	Vous ne pouvez attaquer que les joueurs ayant un autre alignement.
OPTION_SALESTEXT	Nom de la boutique
OPTION_SALESTEXT_VIEW_OFF	Cacher
OPTION_SALESTEXT_VIEW_ON	Montrer
OPTION_SETTING	Ouvrir
OPTION_SNOW_MODE	Flocons
OPTION_SNOW_MODE_OFF	Off
OPTION_SNOW_MODE_ON	On
OPTION_SNOW_TEXTURE_MODE	Neige
OPTION_SNOW_TEXTURE_MODE_OFF	Off
OPTION_SNOW_TEXTURE_MODE_ON	On
OPTION_SOUND	Bruitages
OPTION_TARGET_BOARD	Menu cible
OPTION_TARGET_BOARD_NO_VIEW	Fermer
OPTION_TARGET_BOARD_VIEW	Montrer
OPTION_TITLE	Options
OPTION_VIEW_CHAT	Discussion
OPTION_VIEW_CHAT_OFF	Cacher
OPTION_VIEW_CHAT_ON	Montrer
PARTY_MATCH_TEXT_DUNGEON_NAME	Donjon
PARTY_MATCH_TEXT_DUNGEON_SELECT	Sélectionnez le donjon
PARTY_MATCH_TEXT_ENTREE_LEVEL	Niveau : %d
PARTY_MATCH_TEXT_LEVEL_LIMIT	Niveau exigé
PARTY_MATCH_TEXT_REQUEST_MATCH	Chercher
PARTY_MATCH_TEXT_REQUEST_MATCH_CANCEL	Annuler
PARTY_MATCH_TEXT_REQUIRED_ITEMS	Objet requis
PARTY_MEMBER_INFO_NAME	Nom du membre du groupe
PASSWORD_DESC_1	Veuillez saisir votre mot de passe
PASSWORD_DESC_2	afin d'ouvrir l'entrepôt.
PASSWORD_DESC_3	Vous avez déjà changé votre mot de passe ?
PASSWORD_DESC_4	Si ce n'est pas le cas, votre mot de passe est : « 000000 ».
PASSWORD_DESC_5	Changez votre mot de passe dans l'entrepôt.
PASSWORD_TITLE	Retenir le mot de passe
PET_AGE_TEXT	Âge du familier
PET_ATTR_CHANGE_ITEM_TEXT	Enchantement de familier
PET_ATTR_CHANGE_TITLE	Changer de type de familier
PET_ATTR_CONFIRMATION	Modifier
PET_ATTR_DETERMINE_TITLE	Nouveau type de familier
PET_ATTR_OK	Fermer
PET_CHANGE_TEXT	Familier
PET_FEED_TITLE	Nourrir
PET_FFED_BUTTON_TEXT	Nourrir
PET_HATCHING_BUTTON	Couver
PET_HATCHING_NIK	Nom du familier
PET_HATCHING_WINDOW_TITLE	Couveuse
PET_INFORMATION_ABILITIES	Bonus
PET_INFORMATION_AGE	Âge
PET_INFORMATION_COSTUME_BONUS	Bonus de costume
PET_INFORMATION_DEFENCE	Défense
PET_INFORMATION_EVOL_BUTTON	Développement
PET_INFORMATION_EXP	Expérience
PET_INFORMATION_EXP_BUTTON	EXP d'objet
PET_INFORMATION_HP	PV
PET_INFORMATION_LEVEL	Niveau
PET_INFORMATION_LIFE	Durée
PET_INFORMATION_LIFETIME_BUTTON	Nourrir
PET_INFORMATION_LIFE_TIME	Heures
PET_INFORMATION_SKILL	Compétence
PET_INFORMATION_SP	PM
PET_INFORMATION_TITLE	Familier
PET_NAME_CHANGE_BUTTON	Changer
PET_NAME_CHANGE_WINDOW_TITLE	Changer le nom
PET_REVIVE_BUTTON	Ressusciter
PET_REVIVE_CANCEL_BUTTON	Annuler
PET_REVIVE_MATERIAL_TITLE	Matériel
PET_REVIVE_REUSLT_TEXT	Résultat
PET_REVIVE_TARGET	Familier à ressusciter
PET_REVIVE_TITLE	Ressusciter le familier
PICK_MONEY_TITLE	Séparer
PRIVATESHOPSEARCH_BUY	Acheter
PRIVATESHOPSEARCH_COUNT	Quantité
PRIVATESHOPSEARCH_ITEMNAME	Nom
PRIVATESHOPSEARCH_ITEMTYPE	Objets
PRIVATESHOPSEARCH_JOB	Classe
PRIVATESHOPSEARCH_LEVEL	Niveau
PRIVATESHOPSEARCH_PRICE	Prix
PRIVATESHOPSEARCH_REFINE	Niveau de l'objet
PRIVATESHOPSEARCH_SEARCH	Chercher
PRIVATESHOPSEARCH_SEARCH_BAR	Chercher
PRIVATESHOPSEARCH_SELECT	Choisir
PRIVATESHOPSEARCH_SELLER	Vendeur
PRIVATE_SHOP_CLOSE_BUTTON	Fermer magasin
PRIVATE_SHOP_NAME	Nom du magasin
PRIVATE_SHOP_TITLE	Ouvrir magasin privé
QUEST_UI_TEXT_COLLECTION	Missions biologiques
QUEST_UI_TEXT_DAILY	Quête journalière
QUEST_UI_TEXT_EVENT	Missions d'évènement
QUEST_UI_TEXT_LEVELUP	Mission de chasse
QUEST_UI_TEXT_MAIN	Quêtes principales
QUEST_UI_TEXT_SCROLL	Quêtes de livres de quêtes
QUEST_UI_TEXT_SUB	Quêtes secondaires
QUEST_UI_TEXT_SYSTEM	Missions de jeu
REFINE_COST	Coût de la progression : 0 Yang
REFINE_ELEMENT_CHANGE_COST_TITLE	Coût
REFINE_ELEMENT_CHANGE_DARK	Obscurité
REFINE_ELEMENT_CHANGE_EARTH	Terre
REFINE_ELEMENT_CHANGE_ELECT	Foudre
REFINE_ELEMENT_CHANGE_FIRE	Feu
REFINE_ELEMENT_CHANGE_ICE	Glace
REFINE_ELEMENT_CHANGE_TITLE	Changer l'élément
REFINE_ELEMENT_CHANGE_WIND	Vent
REFINE_ELEMENT_DOWNGRADE_TITLE	Rétrogradation
REFINE_ELEMENT_UPGRADE_TITLE	Amélioration
REFINE_INFO	Probabilité de réussir l'amélioration : 100%
REFINE_MONEY	Coût du raffinage
REFINE_SELECT	Raffinage
REFINE_TTILE	Augmentations
REPORT_VIOLENT_WHISPER	
RESTART_GIVEUP	Abandonner
RESTART_HERE	Recommencer ici
RESTART_IMMEDIATE	Réincarnation
RESTART_TOWN	Recommencer dans la cité
ROULETTE_SPECIAL_TITLE	Récompenses (%s)
ROULETTE_SPIN_TEXT1	TOURNER
ROULETTE_SPIN_TEXT2	50 âmes
ROULETTE_SPIN_TEXT3	250 000 Yangs
ROULETTE_TITLE	Récompenses
SAFE_CHANGE_PASSWORD	Changer le mot de passe
SAFE_TITLE	Entrepôt
SELECT_ATTR_CHANGED	Nouveau
SELECT_ATTR_CURRENT	Ancien
SELECT_ATTR_SELECT	Choisir
SELECT_ATTR_TITLE	Objet enchanté+
SELECT_ATT_GRADE	STR
SELECT_CREATE	Créer
SELECT_DELETE	Effacer
SELECT_DEX_GRADE	DEX
SELECT_EMPIRE_NAME	Nom de l'Empire
SELECT_EXIT	Fermer
SELECT_HP	PV
SELECT_LEVEL	Niveau
SELECT_METIN_STONE_TITLE	Sélectionner une pierre d'Esprit
SELECT_NAME	Nom
SELECT_NO_GUILD	Pas de Guilde
SELECT_PLAYTIME	Temps de jeu
SELECT_SELECT	Commencer
SELECT_SP	INT
SELECT_TITLE	Choisir un titre
SHOP_BUY	Acheter
SHOP_SELL	Vendre
SHOP_TITLE	Magasin
SKILL_SUPPORT_TITLE	Compétences standards
STEP	Degré de pureté
STEP_SELECT	Degré de pureté
STRENGTH	Renforcer
STRENGTH_SELECT	Niveau
STRUCTURE_VIEW_MODE	la décoration
STRUCTURE_VIEW_TYPE_STRUCTURE	Masquer
SYSTEMOPTION_TITLE	Options système
SYSTEM_CHANGE	Changer de personnage
SYSTEM_EXIT	Fin du jeu
SYSTEM_HELP	Aide
SYSTEM_LOGOUT	Déconnecter
SYSTEM_MALL	Boutique
SYSTEM_MOVE_CHANNEL	Changer de canal
SYSTEM_OPTION	Options système
TASKBAR_CHARACTER	Personnage [C/V/B/N]
TASKBAR_CHAT	Fenêtre de tchat [Enter]
TASKBAR_DISABLE	Désactivée
TASKBAR_DRAGON_SOUL	Alchimie des pierres-dragons
TASKBAR_EXPAND	Agrandir la fenêtre
TASKBAR_INVENTORY	Inventaire [I]
TASKBAR_MESSENGER	Liste d'amis [Alt+M]
TASKBAR_MONEY_EXPAND	Fortune
TASKBAR_NEXT_QUICKSLOT	Accès rapide au champ de bataille suivant [Shift+Nombre, Alt]
TASKBAR_PET_INFO	Infos sur le familier
TASKBAR_PREV_QUICKSLOT	Accès rapide au champ de bataille précédent [Shift+Nombre]
TASKBAR_SYSTEM	Options[ESC]
TOTAL_RANKING	Classement général
WARP_MI_LABEL	Au sanctuaire attaqué
WEEKLY_RANKING	Classement hebdomadaire
WHISPER_BAN	Ignorer
WHISPER_NAME	Chuchoter
WHISPER_REPORT	
WHISPER_SEND	Envoyer
YES	Oui
ZONE_MAP	Carte d'aperçu
